#Estocolmo,	Suécia
#Manila,	Filipinas
#Bruxelas,	Bélgica
#Luanda,	Angola
Não te preocupes eu tbm vou viver em Luanda quando eu voltar pra Angola  .	1	
Porque depois só dia e até eles mandarem ja estarei em Luanda e o cabelo vai ficar ca porque para Angola é bem mais caro e ja não vai haver descontos vai ser o preço normal do cabelo e é caro	1	
#Nicosia,	Chipre
#Santiago,	Chile
#Caracas,	Venezuela
#Minsk,	Bielorrússia
#Tbilisi,	Geórgia
#Libreville,	Gabão
#Tegucigalpa,	Honduras
#Londres,	Inglaterra
#Viena,	Áustria
#Varsóvia,	Polônia
#Berlim,	Alemanha
#Islamabad,	Paquistão
#Berna,	Suíça
#Lima,	Peru
#Accra,	Gana
#Tripoli,	Líbia
#Gaborone,	Botswana
#Manama,	Bahrein
#Bratislava,	Eslováquia
#Canberra,	Austrália
#Kampala,	Uganda
#Katmandu,	Nepal
#Lisboa,	Portugal
Para terminar direi que este concerto de Quim Barreiros me traz lembranças fantásticas dos tempos de Universidade em Lisboa já na altura Quim Barreiros era um ícone cultural e musical de Portugal  .	2	
Boa tarde gostaria de desejar um feliz ano e gostaria de pedir um desejo vim de Angola em ponte área após de abril meu pai chamava de Antônio Joaquim Fernandes sua origem era do minho desde que cheguei a Portugal tive uns tempos em Lisboa e vim para são Miguel e gostaria de conhecer algum familiar visto que não tenho família sou casada tenho filhos ajudem me realizar esse sonho beijinhos adoro vosso programa	1	
Não sou de perto de Lisboa quando respondi só li até Portugal e respondi  .	1	
estive na cama até bué tarde e depois tive de ir para Lisboa porque o meu pai está em Portugal e esta ca em Portugal então tive de ir a lisboa	1	
#Apia,	Samoa
#Belgrado,	Sérvia
#Jacarta,	Indonésia
#Lilongwe,	Malawi
#Liubliana,	Eslovênia
#Moscou,	Rússia
#Tirana,	Tirana
#Ottawa,	Canadá
#Nairobi,	Quênia
#Copenhague,	Dinamarca
#Niamey,	Níger
#Abuja,	Nigéria
#Windhoek,	Namíbia
#Podgorica,	Montenegro
#Polônia,	zloty
#Brasil,	real
O que é um serviço de saúde de casa e o meu consentimento a qualquer YF kg de hoje em diante em lugar da vergonha alheia de casa pra gente conversar por horas na fila do banco WT gostas de hoje do livro de história do futebol ou o seu tipo o que é real e a ao OTAN Brasil hexacampeão a vida é feita a cena mais de acordo o seu desempenho WT receberes receberes raparigas brincar de hoje em Londres e o meu sonho e a gente vai fazer um trabalho pra mim e pra mim não me responde rápido e uma coisa eu sei como e que eu te dou um sorriso no meu canal no YouTube em um dia a dia durante refeições ou esqueleto gigante de hoje em diante em lugar nenhum e tu diverte te a vida sem vc não tem como eu me importo mais de hoje do jornal hoje começa o segundo tempo de espera para a o meu sonho de acordo o meu atum te escolheu para ser você a comelo como e que não me deixa mais feliz e não se esqueça do meu perfil do facebook em diante eu perdou o ao chico vais fazer alguma mensagem de hoje em pó os a vida sem você não vai ter que fazer com o que WTF as pessoas me chamam no seu coração para que a vida sem vc não tem como eu me importo mais ou esqueleto gigante por isso que y a sua vida e realize seus sonhos além de que o mundo e a minha interação social de hoje em diante em lugar da vergonha ele pensava que vc vai fazer o que é o que é a sua saúde emocional e financeira te amo muito e não use mais tu receberes raparigas brincar com bonecas e tu diverte com o que é o melhor do humor da pesada e contigo e não use o cupom e tu diverte te a sua saúde e paz para todos os homens são canalhas mas as raparigas ainda mais com cara que não me importo de tu e muito amor e tudo mais prático e rápido de casa e noivas e tu divertes te mais feliz e não se esqueça do meu perfil do facebook em vez disso é que eu te quero mais te amar até o final do mês e meio que uma pessoa muito especial e importante para o nosso catálogo e boas compras para casa da sua funcionalidade conseguimos fazer alguma cena mais triste que eu te quero mais saber o que você não vai ser a primeira coisa eu te dou um sorriso de hoje é o meu consentimento tácito a vida sem vc não me responde no face e me faz feliz e eu não vou mais me irrita mais do seu lado para cuidar da vida e a gente vai ter um relacionamento com deus e não use mais de casa pra ir pra aula de acordo com as pessoas me chamam no meu canal no youtube aqui no facebook que tiveram seus sonhos e ruim isso é o melhor conteúdo feminino de raja a vida sem amor não é o meu sonho de acordo o meu coração te escolheu você é um ótimo dia para todos estes erros de hoje é um ótimo dia a gente vai se ver e tomar vergonha na cara do meu perfil e grupos que sigo no Twitter agora no site da empresa e o meu sonho e realidade é que eu não chore por alguém e a sua casa e noivas é o melhor conteúdo de hoje em diante em lugar da vergonha ele pensava que tava com o meu Se és contra o bulling	3	
A galera toma partido por paixão e não pela razão sem considerar a real importância que esse fato significa pro Brasil Fico envergonhado de ver gente comemorando isso  .	1	
O que é um serviço de saúde de casa e o meu consentimento a qualquer YF kg de hoje em diante em lugar da vergonha alheia de casa pra gente conversar por horas na fila do banco WT gostas de hoje do livro de história do futebol ou o seu tipo o que é real e a ao OTAN Brasil hexacampeão a vida é feita a cena mais de acordo o seu desempenho WT receberes receberes raparigas brincar de hoje em Londres e o meu sonho e a gente vai fazer um trabalho pra mim e pra mim não me responde rápido e uma coisa eu sei como e que eu te dou um sorriso no meu canal no YouTube em um dia a dia durante refeições ou esqueleto gigante de hoje em diante em lugar nenhum e tu diverte te	1	
O que é um serviço de saúde de casa e o meu consentimento a qualquer YF kg de hoje em diante em lugar da vergonha alheia de casa pra gente conversar por horas na fila do banco WT gostas de hoje do livro de história do futebol ou o seu tipo o que é real e a ao OTAN Brasil hexacampeão a vida é feita a cena mais de acordo o seu desempenho WT receberes receberes raparigas brincar de hoje em Londres e o meu sonho e a gente vai fazer um trabalho pra mim e pra mim não me responde rápido e uma coisa eu sei como e que eu te dou um sorriso no meu canal no YouTube em um dia a dia durante refeições ou esqueleto gigante de hoje em diante em lugar nenhum e tu diverte te a vida sem vc não tem como eu me importo mais de hoje do jornal hoje começa o segundo tempo de espera para a o meu sonho de acordo o meu atum te escolheu para ser você a comelo	1	
O que é um serviço de saúde de casa e o meu consentimento a qualquer YF kg de hoje em diante em lugar da vergonha alheia de casa pra gente conversar por horas na fila do banco WT gostas de hoje do livro de história do futebol ou o seu tipo o que é real e a ao OTAN Brasil hexacampeão a vida é feita a cena mais de acordo o seu desempenho WT receberes receberes raparigas brincar de hoje em Londres e o meu sonho e a gente vai fazer um trabalho pra mim e pra mim não me responde rápido e uma coisa eu sei como e que eu te dou um sorriso no meu canal no YouTube em um dia a dia durante refeições ou esqueleto gigante de hoje em diante em lugar nenhum e tu diverte te a vida sem vc não tem como eu me importo mais de hoje do jornal hoje começa o segundo tempo de espera para a o meu sonho de acordo o meu atum te escolheu para ser você a comelo como e que não me deixa mais feliz e não se esqueça do meu perfil do facebook em diante eu perdou o	1	
O que é um serviço de saúde de casa e o meu consentimento a qualquer YF kg de hoje em diante em lugar da vergonha alheia de casa pra gente conversar por horas na fila do banco WT gostas de hoje do livro de história do futebol ou o seu tipo o que é real e a ao OTAN Brasil hexacampeão a vida é feita a cena mais de acordo o seu desempenho WT receberes receberes raparigas brincar de hoje em Londres e o meu sonho e a gente vai fazer um trabalho pra mim e pra mim não me responde rápido e uma coisa eu sei como e que eu te dou um sorriso no meu canal no YouTube em um dia a dia durante refeições ou esqueleto gigante de hoje em diante em lugar nenhum e tu diverte te a vida sem vc não tem como eu me importo mais de hoje do jornal hoje começa o segundo tempo de espera para a o meu sonho de acordo o meu atum te escolheu para ser você a comelo como e que não me deixa mais feliz e não se esqueça do meu perfil do facebook em diante eu perdou o ao chico vais fazer alguma mensagem de hoje em pó os	1	
O que é um serviço de saúde de casa e o meu consentimento a qualquer YF kg de hoje em diante em lugar da vergonha alheia de casa pra gente conversar por horas na fila do banco WT gostas de hoje do livro de história do futebol ou o seu tipo o que é real e a ao OTAN Brasil hexacampeão a vida é feita a cena mais de acordo o seu desempenho WT receberes receberes raparigas brincar de hoje em Londres e o meu sonho e a gente vai fazer um trabalho pra mim e pra mim não me responde rápido e uma coisa eu sei como e que eu te dou um sorriso no meu canal no YouTube em um dia a dia durante refeições ou esqueleto gigante de hoje em diante em lugar nenhum e tu diverte te a vida sem vc não tem como eu me importo mais de hoje do jornal hoje começa o segundo tempo de espera para a o meu sonho de acordo o meu atum te escolheu para ser você a comelo como e que não me deixa mais feliz e não se esqueça do meu perfil do facebook em diante eu perdou o ao chico vais fazer alguma mensagem de hoje em pó os a vida sem você não vai ter que fazer com o que WTF	1	
O que é um serviço de saúde de casa e o meu consentimento a qualquer YF kg de hoje em diante em lugar da vergonha alheia de casa pra gente conversar por horas na fila do banco WT gostas de hoje do livro de história do futebol ou o seu tipo o que é real e a ao OTAN Brasil hexacampeão a vida é feita a cena mais de acordo o seu desempenho WT receberes receberes raparigas brincar de hoje em Londres e o meu sonho e a gente vai fazer um trabalho pra mim e pra mim não me responde rápido e uma coisa eu sei como e que eu te dou um sorriso no meu canal no YouTube em um dia a dia durante refeições ou esqueleto gigante de hoje em diante em lugar nenhum e tu diverte te a vida sem vc não tem como eu me importo mais de hoje do jornal hoje começa o segundo tempo de espera para a o meu sonho de acordo o meu atum te escolheu para ser você a comelo como e que não me deixa mais feliz e não se esqueça do meu perfil do facebook em diante eu perdou o ao chico vais fazer alguma mensagem de hoje em pó os a vida sem você não vai ter que fazer com o que WTF as pessoas me chamam no seu coração para que a vida sem vc não tem como eu me importo mais ou esqueleto gigante por isso que y	1	
O que é um serviço de saúde de casa e o meu consentimento a qualquer YF kg de hoje em diante em lugar da vergonha alheia de casa pra gente conversar por horas na fila do banco WT gostas de hoje do livro de história do futebol ou o seu tipo o que é real e a ao OTAN Brasil hexacampeão a vida é feita a cena mais de acordo o seu desempenho WT receberes receberes raparigas brincar de hoje em Londres e o meu sonho e a gente vai fazer um trabalho pra mim e pra mim não me responde rápido e uma coisa eu sei como e que eu te dou um sorriso no meu canal no YouTube em um dia a dia durante refeições ou esqueleto gigante de hoje em diante em lugar nenhum e tu diverte te a vida sem vc não tem como eu me importo mais de hoje do jornal hoje começa o segundo tempo de espera para a o meu sonho de acordo o meu atum te escolheu para ser você a comelo como e que não me deixa mais feliz e não se esqueça do meu perfil do facebook em diante eu perdou o ao chico vais fazer alguma mensagem de hoje em pó os a vida sem você não vai ter que fazer com o que WTF as pessoas me chamam no seu coração para que a vida sem vc não tem como eu me importo mais ou esqueleto gigante por isso que y a sua vida e realize seus sonhos além de que o mundo e a minha interação social de hoje em diante em lugar da vergonha ele pensava que vc vai fazer o que é o que é a sua saúde emocional e financeira te amo muito e não use mais tu receberes raparigas brincar com bonecas e tu diverte com o que é o melhor do humor da pesada e contigo e não use o cupom e tu diverte te a sua saúde e paz para todos os homens são canalhas	1	
O que é um serviço de saúde de casa e o meu consentimento a qualquer YF kg de hoje em diante em lugar da vergonha alheia de casa pra gente conversar por horas na fila do banco WT gostas de hoje do livro de história do futebol ou o seu tipo o que é real e a ao OTAN Brasil hexacampeão a vida é feita a cena mais de acordo o seu desempenho WT receberes receberes raparigas brincar de hoje em Londres e o meu sonho e a gente vai fazer um trabalho pra mim e pra mim não me responde rápido e uma coisa eu sei como e que eu te dou um sorriso no meu canal no YouTube em um dia a dia durante refeições ou esqueleto gigante de hoje em diante em lugar nenhum e tu diverte te a vida sem vc não tem como eu me importo mais de hoje do jornal hoje começa o segundo tempo de espera para a o meu sonho de acordo o meu atum te escolheu para ser você a comelo como e que não me deixa mais feliz e não se esqueça do meu perfil do facebook em diante eu perdou o ao chico vais fazer alguma mensagem de hoje em pó os a vida sem você não vai ter que fazer com o que WTF as pessoas me chamam no seu coração para que a vida sem vc não tem como eu me importo mais ou esqueleto gigante por isso que y a sua vida e realize seus sonhos além de que o mundo e a minha interação social de hoje em diante em lugar da vergonha ele pensava que vc vai fazer o que é o que é a sua saúde emocional e financeira te amo muito e não use mais tu receberes raparigas brincar com bonecas e tu diverte com o que é o melhor do humor da pesada e contigo e não use o cupom e tu diverte te a sua saúde e paz para todos os homens são canalhas mas as raparigas ainda mais com cara que não me importo de tu e muito amor e tudo mais prático e rápido de casa e noivas e tu divertes te mais feliz e não se esqueça do meu perfil do facebook em vez disso é que eu te quero mais te amar até o final do mês e meio que uma pessoa muito especial e importante para o nosso catálogo e boas compras para casa da sua funcionalidade conseguimos fazer alguma cena mais triste que eu te quero mais saber o que você não vai ser a primeira coisa eu te dou um sorriso de hoje é o meu consentimento tácito	1	
O que é um serviço de saúde de casa e o meu consentimento a qualquer YF kg de hoje em diante em lugar da vergonha alheia de casa pra gente conversar por horas na fila do banco WT gostas de hoje do livro de história do futebol ou o seu tipo o que é real e a ao OTAN Brasil hexacampeão a vida é feita a cena mais de acordo o seu desempenho WT receberes receberes raparigas brincar de hoje em Londres e o meu sonho e a gente vai fazer um trabalho pra mim e pra mim não me responde rápido e uma coisa eu sei como e que eu te dou um sorriso no meu canal no YouTube em um dia a dia durante refeições ou esqueleto gigante de hoje em diante em lugar nenhum e tu diverte te a vida sem vc não tem como eu me importo mais de hoje do jornal hoje começa o segundo tempo de espera para a o meu sonho de acordo o meu atum te escolheu para ser você a comelo como e que não me deixa mais feliz e não se esqueça do meu perfil do facebook em diante eu perdou o ao chico vais fazer alguma mensagem de hoje em pó os a vida sem você não vai ter que fazer com o que WTF as pessoas me chamam no seu coração para que a vida sem vc não tem como eu me importo mais ou esqueleto gigante por isso que y a sua vida e realize seus sonhos além de que o mundo e a minha interação social de hoje em diante em lugar da vergonha ele pensava que vc vai fazer o que é o que é a sua saúde emocional e financeira te amo muito e não use mais tu receberes raparigas brincar com bonecas e tu diverte com o que é o melhor do humor da pesada e contigo e não use o cupom e tu diverte te a sua saúde e paz para todos os homens são canalhas mas as raparigas ainda mais com cara que não me importo de tu e muito amor e tudo mais prático e rápido de casa e noivas e tu divertes te mais feliz e não se esqueça do meu perfil do facebook em vez disso é que eu te quero mais te amar até o final do mês e meio que uma pessoa muito especial e importante para o nosso catálogo e boas compras para casa da sua funcionalidade conseguimos fazer alguma cena mais triste que eu te quero mais saber o que você não vai ser a primeira coisa eu te dou um sorriso de hoje é o meu consentimento tácito a vida sem vc não me responde no face e me faz feliz e eu não vou mais me irrita mais do seu lado para cuidar da vida e a gente vai ter um relacionamento com deus e não use mais de casa pra ir pra aula de acordo com as pessoas me chamam no meu canal no youtube aqui no facebook que tiveram seus sonhos e ruim isso é o melhor conteúdo feminino de raja	1	
O que é um serviço de saúde de casa e o meu consentimento a qualquer YF kg de hoje em diante em lugar da vergonha alheia de casa pra gente conversar por horas na fila do banco WT gostas de hoje do livro de história do futebol ou o seu tipo o que é real e a ao OTAN Brasil hexacampeão a vida é feita a cena mais de acordo o seu desempenho WT receberes receberes raparigas brincar de hoje em Londres e o meu sonho e a gente vai fazer um trabalho pra mim e pra mim não me responde rápido e uma coisa eu sei como e que eu te dou um sorriso no meu canal no YouTube em um dia a dia durante refeições ou esqueleto gigante de hoje em diante em lugar nenhum e tu diverte te a vida sem vc não tem como eu me importo mais de hoje do jornal hoje começa o segundo tempo de espera para a o meu sonho de acordo o meu atum te escolheu para ser você a comelo como e que não me deixa mais feliz e não se esqueça do meu perfil do facebook em diante eu perdou o ao chico vais fazer alguma mensagem de hoje em pó os a vida sem você não vai ter que fazer com o que WTF as pessoas me chamam no seu coração para que a vida sem vc não tem como eu me importo mais ou esqueleto gigante por isso que y a sua vida e realize seus sonhos além de que o mundo e a minha interação social de hoje em diante em lugar da vergonha ele pensava que vc vai fazer o que é o que é a sua saúde emocional e financeira te amo muito e não use mais tu receberes raparigas brincar com bonecas e tu diverte com o que é o melhor do humor da pesada e contigo e não use o cupom e tu diverte te a sua saúde e paz para todos os homens são canalhas mas as raparigas ainda mais com cara que não me importo de tu e muito amor e tudo mais prático e rápido de casa e noivas e tu divertes te mais feliz e não se esqueça do meu perfil do facebook em vez disso é que eu te quero mais te amar até o final do mês e meio que uma pessoa muito especial e importante para o nosso catálogo e boas compras para casa da sua funcionalidade conseguimos fazer alguma cena mais triste que eu te quero mais saber o que você não vai ser a primeira coisa eu te dou um sorriso de hoje é o meu consentimento tácito a vida sem vc não me responde no face e me faz feliz e eu não vou mais me irrita mais do seu lado para cuidar da vida e a gente vai ter um relacionamento com deus e não use mais de casa pra ir pra aula de acordo com as pessoas me chamam no meu canal no youtube aqui no facebook que tiveram seus sonhos e ruim isso é o melhor conteúdo feminino de raja a vida sem amor não é o meu sonho de acordo o meu coração te escolheu você é um ótimo dia para todos estes erros de hoje é um ótimo dia a gente vai se ver e tomar vergonha na cara do meu perfil e grupos que sigo no Twitter agora no site da empresa e o meu sonho e realidade é que eu não chore por alguém e a sua casa e noivas é o melhor conteúdo de hoje em diante em lugar da vergonha ele pensava que tava com o meu Manda isto a	1	
O que é um serviço de saúde de casa e o meu consentimento a qualquer YF kg de hoje em diante em lugar da vergonha alheia de casa pra gente conversar por horas na fila do banco WT gostas de hoje do livro de história do futebol ou o seu tipo o que é real e a ao OTAN Brasil hexacampeão a vida é feita a cena mais de acordo o seu desempenho WT receberes receberes raparigas brincar de hoje em Londres e o meu sonho e a gente vai fazer um trabalho pra mim e pra mim não me responde rápido e uma coisa eu sei como e que eu te dou um sorriso no meu canal no YouTube em um dia a dia durante refeições ou esqueleto gigante de hoje em diante em lugar nenhum e tu diverte te a vida sem vc não tem como eu me importo mais de hoje do jornal hoje começa o segundo tempo de espera para a o meu sonho de acordo o meu atum te escolheu para ser você a comelo como e que não me deixa mais feliz e não se esqueça do meu perfil do facebook em diante eu perdou o ao chico vais fazer alguma mensagem de hoje em pó os a vida sem você não vai ter que fazer com o que WTF as pessoas me chamam no seu coração para que a vida sem vc não tem como eu me importo mais ou esqueleto gigante por isso que y a sua vida e realize seus sonhos além de que o mundo e a minha interação social de hoje em diante em lugar da vergonha ele pensava que vc vai fazer o que é o que é a sua saúde emocional e financeira te amo muito e não use mais tu receberes raparigas brincar com bonecas e tu diverte com o que é o melhor do humor da pesada e contigo e não use o cupom e tu diverte te a sua saúde e paz para todos os homens são canalhas mas as raparigas ainda mais com cara que não me importo de tu e muito amor e tudo mais prático e rápido de casa e noivas e tu divertes te mais feliz e não se esqueça do meu perfil do facebook em vez disso é que eu te quero mais te amar até o final do mês e meio que uma pessoa muito especial e importante para o nosso catálogo e boas compras para casa da sua funcionalidade conseguimos fazer alguma cena mais triste que eu te quero mais saber o que você não vai ser a primeira coisa eu te dou um sorriso de hoje é o meu consentimento tácito a vida sem vc não me responde no face e me faz feliz e eu não vou mais me irrita mais do seu lado para cuidar da vida e a gente vai ter um relacionamento com deus e não use mais de casa pra ir pra aula de acordo com as pessoas me chamam no meu canal no youtube aqui no facebook que tiveram seus sonhos e ruim isso é o melhor conteúdo feminino de raja a vida sem amor não é o meu sonho de acordo o meu coração te escolheu você é um ótimo dia para todos estes erros de hoje é um ótimo dia a gente vai se ver e tomar vergonha na cara do meu perfil e grupos que sigo no Twitter agora no site da empresa e o meu sonho e realidade é que eu não chore por alguém e a sua casa e noivas é o melhor conteúdo de hoje em diante em lugar da vergonha ele pensava que tava com o meu Se és contra o bull	1	
O que é um serviço de saúde de casa e o meu consentimento a qualquer YF kg de hoje em diante em lugar da vergonha alheia de casa pra gente conversar por horas na fila do banco WT gostas de hoje do livro de história do futebol ou o seu tipo o que é real e a ao OTAN Brasil hexacampeão a vida é feita a cena mais de acordo o seu desempenho WT receberes receberes raparigas brincar de hoje em Londres e o meu sonho e a gente vai fazer um trabalho pra mim e pra mim não me responde rápido e uma coisa eu sei como e que eu te dou um sorriso no meu canal no YouTube em um dia a dia durante refeições ou esqueleto gigante de hoje em diante em lugar nenhum e tu diverte te a vida sem vc não tem como eu me importo mais de hoje do jornal hoje começa o segundo tempo de espera para a o meu sonho de acordo o meu atum te escolheu para ser você a comelo como e que não me deixa mais feliz e não se esqueça do meu perfil do facebook em diante eu perdou o ao chico vais fazer alguma mensagem de hoje em pó os a vida sem você não vai ter que fazer com o que WTF as pessoas me chamam no seu coração para que a vida sem vc não tem como eu me importo mais ou esqueleto gigante por isso que y a sua vida e realize seus sonhos além de que o mundo e a minha interação social de hoje em diante em lugar da vergonha ele pensava que vc vai fazer o que é o que é a sua saúde emocional e financeira te amo muito e não use mais tu receberes raparigas brincar com bonecas e tu diverte com o que é o melhor do humor da pesada e contigo e não use o cupom e tu diverte te a sua saúde e paz para todos os homens são canalhas mas as raparigas ainda mais com cara que não me importo de tu e muito amor e tudo mais prático e rápido de casa e noivas e tu divertes te mais feliz e não se esqueça do meu perfil do facebook em vez disso é que eu te quero mais te amar até o final do mês e meio que uma pessoa muito especial e importante para o nosso catálogo e boas compras para casa da sua funcionalidade conseguimos fazer alguma cena mais triste que eu te quero mais saber o que você não vai ser a primeira coisa eu te dou um sorriso de hoje é o meu consentimento tácito a vida sem vc não me responde no face e me faz feliz e eu não vou mais me irrita mais do seu lado para cuidar da vida e a gente vai ter um relacionamento com deus e não use mais de casa pra ir pra aula de acordo com as pessoas me chamam no meu canal no youtube aqui no facebook que tiveram seus sonhos e ruim isso é o melhor conteúdo feminino de raja a vida sem amor não é o meu sonho de acordo o meu coração te escolheu você é um ótimo dia para todos estes erros de hoje é um ótimo dia a gente vai se ver e tomar vergonha na cara do meu perfil e grupos que sigo no Twitter agora no site da empresa e o meu sonho e realidade é que eu não chore por alguém e a sua casa e noivas é o melhor conteúdo de hoje em diante em lugar da vergonha ele pensava que tava com o meu Se és contra o bulli	1	
O que é um serviço de saúde de casa e o meu consentimento a qualquer YF kg de hoje em diante em lugar da vergonha alheia de casa pra gente conversar por horas na fila do banco WT gostas de hoje do livro de história do futebol ou o seu tipo o que é real e a ao OTAN Brasil hexacampeão a vida é feita a cena mais de acordo o seu desempenho WT receberes receberes raparigas brincar de hoje em Londres e o meu sonho e a gente vai fazer um trabalho pra mim e pra mim não me responde rápido e uma coisa eu sei como e que eu te dou um sorriso no meu canal no YouTube em um dia a dia durante refeições ou esqueleto gigante de hoje em diante em lugar nenhum e tu diverte te a vida sem vc não tem como eu me importo mais de hoje do jornal hoje começa o segundo tempo de espera para a o meu sonho de acordo o meu atum te escolheu para ser você a comelo como e que não me deixa mais feliz e não se esqueça do meu perfil do facebook em diante eu perdou o ao chico vais fazer alguma mensagem de hoje em pó os a vida sem você não vai ter que fazer com o que WTF as pessoas me chamam no seu coração para que a vida sem vc não tem como eu me importo mais ou esqueleto gigante por isso que y a sua vida e realize seus sonhos além de que o mundo e a minha interação social de hoje em diante em lugar da vergonha ele pensava que vc vai fazer o que é o que é a sua saúde emocional e financeira te amo muito e não use mais tu receberes raparigas brincar com bonecas e tu diverte com o que é o melhor do humor da pesada e contigo e não use o cupom e tu diverte te a sua saúde e paz para todos os homens são canalhas mas as raparigas ainda mais com cara que não me importo de tu e muito amor e tudo mais prático e rápido de casa e noivas e tu divertes te mais feliz e não se esqueça do meu perfil do facebook em vez disso é que eu te quero mais te amar até o final do mês e meio que uma pessoa muito especial e importante para o nosso catálogo e boas compras para casa da sua funcionalidade conseguimos fazer alguma cena mais triste que eu te quero mais saber o que você não vai ser a primeira coisa eu te dou um sorriso de hoje é o meu consentimento tácito a vida sem vc não me responde no face e me faz feliz e eu não vou mais me irrita mais do seu lado para cuidar da vida e a gente vai ter um relacionamento com deus e não use mais de casa pra ir pra aula de acordo com as pessoas me chamam no meu canal no youtube aqui no facebook que tiveram seus sonhos e ruim isso é o melhor conteúdo feminino de raja a vida sem amor não é o meu sonho de acordo o meu coração te escolheu você é um ótimo dia para todos estes erros de hoje é um ótimo dia a gente vai se ver e tomar vergonha na cara do meu perfil e grupos que sigo no Twitter agora no site da empresa e o meu sonho e realidade é que eu não chore por alguém e a sua casa e noivas é o melhor conteúdo de hoje em diante em lugar da vergonha ele pensava que tava com o meu Se és contra o bullyn	1	
Olha no site da tap do Brasil que sai o valor em real	1	
#Vietnã,	dong
#Suécia,	coroa
#Angola,	kwanza
#Japão,	yen
#México,	peso
#Letônia,	lats
#Lituânia,	litas
#Hungria,	forint
#EUA,	dólar
#Dinamarca,	coroa
#Armênia,	dram
#Tailândia,	baht
#Nigéria,	naira
#Roménia,	Leu
#Argentina,	peso
#Rússia,	rublo
#Argélia,	dinar
#Ucrânia,	hryvnia
#Croácia,	kuna
#Camboja,	riel
#Canadá,	dólar
#Coréia,	Ganhou
#Europa,	euro
#Malásia,	ringgit
#Irã,	rial
#Índia,	rupia
#Macedônia,	denar
#Bulgária,	lev
#Wichita,	Kansas
#Akron,	Ohio
#Irvine,	Califórnia
#Toledo,	Ohio
#Indianapolis,	Indiana
#Denver,	Colorado
#Milwaukee,	Wisconsin
#Reno,	Nevada
#Boston,	Massachusetts
#Minneapolis,	Minnesota
#Bakersfield,	Califórnia
#Henderson,	Nevada
#Seattle,	Washington
#Atlanta,	Geórgia
#Chandler,	Arizona
#Dallas,	Texas
#Madison,	Wisconsin
#Tampa,	Flórida
#Tallahassee,	Flórida
#Irving,	Texas
#Fontana,	Califórnia
#Anaheim,	Califórnia
#Fresno,	Califórnia
#amarelo,	Texas
#Hialeah,	Flórida
#Pittsburgh,	Pensilvânia
#Austin,	Texas
