#Tóquio,	Japão
#Helsinki,	Finlândia
#Madrid,	Espanha
Ahah nao foi bue fixe fui por Portugal ate Madrid e depois vim por Espanha até Sevilha	1	
#Paris,	França
Ainda nao sei aonde ir tou ainda perdido tenho varios convites e um para ir a Paris mas eu ainda vim agora de França	1	
#Havana,	Cuba
#Teerã,	Irã
#Cairo,	Egito
Sabes que Cairo é a capital do Egito	1	
#Islamabad,	Paquistão
#Berna,	Suíça
#Canberra,	Austrália
#Londres,	Inglaterra
#Berlim,	Alemanha
#Cabul,	Afeganistão
#Atenas,	Grécia
#Moscou,	Rússia
#Estocolmo,	Suécia
#Ottawa,	Canadá
#Roma,	Itália
#Hanói,	Vietnã
#Pequim,	China
#Bangkok,	Tailândia
E também passeios locais com guia em português em Bangkok e norte da Tailândia Chiang Mai e Chiang Rai Passeios privativos tranquilo e confortável conheça mais sobre a incrível cultura da Tailândia Nós te ajudamos Contato aatraveloficial gmail  .	1	
#Oslo,	Noruega
#Bagdá,	Iraque
#Funafuti,	Tuvalu
#Madrid,	Espanha
Ahah nao foi bue fixe fui por Portugal ate Madrid e depois vim por Espanha até Sevilha	1	
#Paris,	França
Ainda nao sei aonde ir tou ainda perdido tenho varios convites e um para ir a Paris mas eu ainda vim agora de França	1	
#Nassau,	Bahamas
#Maputo,	Moçambique
#Teerã,	Irã
#Vienciana,	Laos
#Bamako,	Mali
#Ancara,	Peru
#Vaduz,	Liechtenstein
#Asmara,	Eritréia
#Roseau,	Dominica
#Dushanbe,	Tajiquistão
#Sófia,	Bulgária
#Bucareste,	Roménia
#Tunis,	Tunísia
#Lusaka,	Zâmbia
#Quito,	Equador
#Cartum,	Sudão
#Montevidéu,	Uruguai
#Antananarivo,	Madagáscar
#Kiev,	Ucrânia
#Roma,	Itália
#Hanói,	Vietnã
#Damasco,	Síria
quando Damasco a capital da Síria foi tomada por Tiglate Pileser III  .	1	
#Oslo,	Noruega
#Vilnius,	Lituânia
#Argel,	Argélia
#Tashkent,	Uzbequistão
#Tóquio,	Japão
#Helsinki,	Finlândia
#Dublin,	Irlanda
#Chisinau,	Moldávia
#Manágua,	Nicarágua
#Paramaribo,	Suriname
#Bishkek,	Quirguistão
#Cairo,	Egito
Sabes que Cairo é a capital do Egito	1	
#Amã,	Jordânia
#Budapeste,	Hungria
#Doha,	Catar
#Astana,	Cazaquistão
#Cabul,	Afeganistão
#Monrovia,	Libéria
#Dhaka,	Bangladesh
#Mogadíscio,	Somália
#Bujumbura,	Burundi
#Valletta,	Malta
#Nouakchott,	Mauritânia
#Kingston,	Jamaica
#Beirute,	Líbano
#Pequim,	China
#Bangkok,	Tailândia
E também passeios locais com guia em português em Bangkok e norte da Tailândia Chiang Mai e Chiang Rai Passeios privativos tranquilo e confortável conheça mais sobre a incrível cultura da Tailândia Nós te ajudamos Contato aatraveloficial gmail  .	1	
#Harare,	Zimbábue
#Muscat,	Omã
#Bagdá,	Iraque
#Conakry,	Guiné
#Tallinn,	Estônia
#Georgetown,	Guiana
#Taipei,	Taiwan
#Rabat,	Marrocos
#Yerevan,	Armênia
#Havana,	Cuba
#Thimphu,	Butão
#Nuuk,	Gronelândia
#Baku,	Azerbaijão
#Kigali,	Ruanda
#Dakar,	Senegal
#Suva,	Fiji
#Belmopan,	Belize
#Banjul,	Gâmbia
#Atenas,	Grécia
#Riga,	Letônia
#Zagreb,	Croácia
#Skopje,	Macedônia
#Ashgabat,	Turquemenistão
