#honesto,	desonesto
#convincente,	inconvincente
#competitivo,	não-competitivo
#conhecido,	desconhecido
Há muita coisa nos ambientes invisíveis ao homem acontecendo o desconhecido é infinitamente maior que o conhecido  .	1	
#impressionante,	não impressionante
#possivelmente,	impossivel
#decidido,	indeciso
#consistente,	inconsistente
#ético,	antiético
#informado,	desinformado
#confortável,	desconfortável
#possível,	impossível
Eu não teria alcançado o possível se repetidas vezes não tivesse tentado o impossível  .	9	
Jesus respondeu O que é impossível para os homens é possível para Deus  .	3	
O homem não teria alcançado o possível se repetidas vezes não tivesse tentado o impossível  .	3	
e lembre se que nada é impossível e sim tudo é possível  .	3	
Amor receba de Deus tudo aquilo que vc almeja e lute para conquistar coisas novas continue crendo no impossível por que o possível cabe a vc realizar  .	2	
Comece fazendo o que é necessário depois o que é possível e de repente você estará fazendo o impossível  .	2	
Existem sonhos que por mais que pareçam impossível temos que fazer o possível para torná los reais  .	2	
Você tem orado e chorado tantopedindo a Deus uma respostaO inimigo tem entristecido o teu coraçãoTravando as portasMas você não é um derrotado é abençoadoé a menina dos olhos de DeusE as lágrimas que você chorou moveu o céuMeu irmão eu quero lhe dizer que Deus não te esqueceuestá sempre por pertoLança toda ansiedade aos pés do senhorE vamos profetizar que vai dar certoVai dar certo os sonhos e projetos que o Senhor lhe deuÉ só ficar no centro da vontade de Deus que vai dar certoVai dar certo é só colocar a sua fé em açãoQue o impossível passa a ser possível irmãoTeus sonhos se tornam concretosContinue a profetizar que vai dar certoTeus sonhos projetosPõe na mão de Deus que vai dar certoTua cura tua bênção é só orar que vai dar certoSentimento família pode confiar que vai dar certoColoca nas mãos de Deus teus sonhos e teus projetosVai dar certo	2	
A única forma de chegar ao impossível é acreditar que é possível  .	1	
E Jesus olhando para eles disse lhes Aos homens é isso impossível mas a Deus tudo é possível  .	1	
E como eu digo se complicado quer dizer impossível e impossível quer dizer não possível e ai eu já me perdi	1	
E lembre se que nada é impossível e sim tudo é possível  .	1	
Este sorriso só ctg era possível agr tem sido impossível	1	
Eu também Mais vc faz o possível E eu o impossível	1	
Eu te amo Tanto Ao seu lado sinto que tudo é possível que qualquer sonho se pode realizar que não existe obstáculo impossível de ultrapassar  .	1	
Mas no meu caso é possível e saiba que nada é impossível	1	
Nunca será fácil mais quando à vontade de ganhar é maior o impossível passar a ser possível  .	1	
O que e impossível pra vc e possível se sabe ne  .	1	
Orei o impossível Deus vai fazer pra tocar no seu coração o possível eu fiz	1	
Para acontecer o impossível é preciso acreditar no possível	1	
Pra nois quase nada e impossível mais pra aquele que mora lá no céu tudo e possível só basta ter fé e o amor no coração	1	
Pra nois quase nada e impossível mais pra aquele que mora lá no céu tudo e possível só basta ter fé e o amor no coração Bom dia pa nós	1	
Quando o impossível se levanta Deus o torna possível  .	1	
Que estudam muito adquirem conhecimento trabalham com afínco e dedicação conquistam objetivos ampliam horizontes fazem o possível e crêem no impossível e superam o que for preciso  .	1	
Vemos e nos planejamos com base no possível naquilo que aprendemos mas não podemos nos esquecer que servimos ao Deus do impossível que não	1	
#lógico,	ilógico
#eficiente,	ineficiente
#produtivo,	improdutivo
#conveniente,	inconveniente
#responsável,	irresponsável
#agradável,	desagradável
#saboroso,	desagradável
#afortunado,	infeliz
#informativo,	não informativo
#racional,	irracional
#aceitável,	inaceitável
#consciente,	inconsciente
#razoável,	não razoável
#claro,	inseguro
#certeza,	incerteza 
#provável,	improvável
#baixo,	mais baixo
#velho,	mais velho
Esse vídeo é mais velho que a palavra velho  .	1	
Estas a ver sou mais velho e não me considero velho	1	
Minhas vidas o mano mais velho ja não se quer mascarar diz que está Mt velho	1	
Posso ter amigos mais velho mas n Tao velho e nem com cara de ladrão	1	
Um velho careca q so quer saber do meu irmão mais velho	1	
Velho velho nao pareces mas pareces mais velho do que a idade que tens	1	
#velozes,	mais rápido
#pesado,	mais pesado
#justa,	mais apertado
#simples,	mais simples
#ampla,	maior
#quente,	mais quente
Eu sempre fui quente so comecei a ficar mais quente desde K a minha mae parti	1	
Fazemos assim cada um manda uma foto quente e depois vemos qual a mais quente	1	
#grande,	maior
Que minha coragem seja maior que meu medo e que minha força seja tão grande quanto minha fé  .	13	
A vontade de rir é grande mas a de chorar é maior	12	
Nenhum obstáculo será grande se a sua vontade de vencer for maior	9	
A vontade de rir e grande mais a de chorar e maior	7	
E como é grande esse amor meu filho É eterno e incondicional maior que o tempo e superior à própria vida  .	7	
foi um ano de lutas de conquista e de perdas também mas como meu pai OGUM diz que o grande pai OXALÁ nunca da o fardo maior do que nos possamos carregar  .	5	
Nenhum obstáculo será tão grande se sua vontade de vencer for maior  .	4	
Que minha coragem seja maior que o meu medo e que minha força seja tão grande quanto a minha fé	4	
A distância um dos pioresPara se começar Porque tão difícil de se lidar Será que porque euTenho medo de ela Encontrar alguém muito Que eu E se apaixonar Será por isso Que é isso que não Para de pensar Toda hora momento Não consigo parar de pensar Que do seu lado quero estar Mesmo que custeQue eu tiver Ao seu lado para sempre Quero estar Quero te abraçar xTe beijar xE valer cada segundo Que foi me dado Quero aproveitar E ao seu lado quero estar Eu não tenho Dinheiro infelizmente Para te visitar Mas se possível mesmo seja Apenas vez Darei de tudo para te encontrar Sei que a distância é muito grande Mas pode garantir me amor é maior Tenho medo das circunstâncias Tenho certeza que um dia que tem encartarei Mesmo que seja pelo laço vermelho Laço que representa esse nosso amor Mesmo que custe Tudo que eu tiver Eu  .	3	
Bom dia Nenhum obstáculo será tão grande se tua vontade de vencer for maior Desejo um dia abençoado a tds Que ele seja repleto de paz  .	3	
Eu sei mais eu nao quero Pq tenho medo de errar outra vez de ferir teus sentimentos de voltar a namora com vc e grande mais o medo de machucar os teus sentimentos e maior	3	
Que minha coragem seja maior que meu medo e que minha força seja tão grande quanto minha fé	3	
A sdd é grande mais o orgulho é maior  .	2	
A vontade de botar um pici e grande mais o medo da mae me da ums murro e maior	2	
A vontade de fazer nada é grande mas a fome é maior	2	
A vontade de rir é grande mais a de chorar é maior	2	
A vontade de te matar e grande mais a de comer esses picole e maior ainda	2	
A vontade é grande mais o pensamento é maior	2	
As vezes autocrítica ao extrema é o que pode causar solidão depressão ansiedade e diversos transtornos psicológicos por se culpar d por incrível que pareça essa é uma grande causa mas claro que não a maior e nem a única  .	2	
Deivinho tu é mais bonito sem tanto pelo no corpo com o cabelo maior e com peito grande Aiii simm  .	2	
Obrigado por esta em meu lado nos dias de tristezas nos dias de risadas e foram algumas neh Rs ja passamos por tanta coisa ja tentaram nos prejudicar ate mesmo nos fazer uma odiar a outra mas deus sabe o que faz e deus nao permitiu que nos odiamos sem ao menos nos conhecer de verdade hoje a Mayara que conheço e uma grande mulher de admiro muito e levo suas experiências de vida cm exemplo para minha você amadureceu tão rápido tao de repente que acho que ate voce mesmo nao deve saber o tipo de mulher que você se tornou o tipo de mulher que hoje admiro muito se tornou uma mulher guerreira que hoje nao tem medo de arriscar na vida e errar voce entra em qualquer situação de corpo e alma e isso me admira muito em você começamos a nos falar através de uma briga boba que depois se tornou uma grande amizade tivemos que passar pela nossa maior tristeza e nossa maior dor muitos falaram mal da gente muitos nos julgaram mais somente nos duas sabemos tudo que vivemos juntos e tudo que passamos pra hoje estamos aqui com todas as críticas e ate mesmos todos julgamentos mas enfim hoje se tornou	2	
Obrigado por esta em meu lado nos dias de tristezas nos dias de risadas e foram algumas neh Rs ja passamos por tanta coisa ja tentaram nos prejudicar ate mesmo nos fazer uma odiar a outra mas deus sabe o que faz e deus nao permitiu que nos odiamos sem ao menos nos conhecer de verdade hoje a Mayara que conheço e uma grande mulher de admiro muito e levo suas experiências de vida cm exemplo para minha você amadureceu tão rápido tao de repente que acho que ate voce mesmo nao deve saber o tipo de mulher que você se tornou o tipo de mulher que hoje admiro muito se tornou uma mulher guerreira que hoje nao tem medo de arriscar na vida e errar voce entra em qualquer situação de corpo e alma e isso me admira muito em você começamos a nos falar através de uma briga boba que depois se tornou uma grande amizade tivemos que passar pela nossa maior tristeza e nossa maior dor muitos falaram mal da gente muitos nos julgaram mais somente nos duas sabemos tudo que vivemos juntos e tudo que passamos pra hoje estamos aqui com todas as críticas e ate mesmos todos julgamentos mas enfim hoje se tornou minha maior confidente a que sabe mais das minhas merda que eu mesmo Rs ja lhe contei tanto coisa e hoje sei que posso realmente confiar em você sem medo de qualquer coisa  .	2	
Que a minha coragem seja maior que o meu medo e que minha força seja tão grande quanto a minha Fé	2	
Que a minha coragem seja maior que o meu medo e que minha força seja tão grande quanto minha fé	2	
Que minha coragem seja maior que o meu medo que minha força seja tão grande quanto minha fé BomDia  .	2	
a boca e grande mas o coração é maior	2	
diz Ezekiel num tom sombrio do que ta falando Ezekiel diz Daniel abaixando se para amarrar seu tênis esse aí era só uma distração um dos meus lacaios eu sou o problema de verdade olho para trás Ezekiel dá dois espasmos no pescoço e em questão de segundos vira outro chupa cu mas bem maior e bem mais assustador dá um rugido de leão e em seguida um grande pulo na direção do traseiro de Daniel Daniel dá um grito de agonia e em questão de segundos todo seu sangue é sugado Daniel cai pálido e imóvel eu e Maryana estávamos imóveis e então Ezekiel ou o que era pra ser o Ezekiel vem com a boca cheia de sangue em nossa direção me puxa pelos braços e dá uma mordida no meu ombro esquerdo dou um chute em sua barriga e caio ele ruge novamente porém bem mais alto e mais assustador começam a crescer espinhos em suas costas tento o acertar com o pedaço de pau mas ele pega minha arma improvisada e come arrasta seus braços gigantes em minha direção olho para cima ele era muito maior devia ter pelo menos uns m na hora que ele ia me pegar de novo ouço um disparo ele cai pra trás ao levar um tiro em sua cabeça ainda atordoado Maryana me carrega pelo ombro me coloca no banco do motorista porque ela não sabia dirigir vou dirigindo até a cidade Maryana ainda está trêmula de medo minha cabeça começa a girar Maryana eu não estou bem  .	2	
minha coragem seja maior que meu medo e que minha força seja tão grande quanto minha fé	2	
nnc senti tao segura como alguém como sinto na nossa relação amor sempre vais ser sempre a minha rainha sem castrelo és a minha maior fonte de energia tenho grande orgulhor em ter comigo estarei aqui sempre para fazer loucoras contigo pk essas sim sao as melhores loucoras da minha vida as que faso no teu lado te venero minha mais que tudo	2	
A alegria é grande mais a solidão é maior	1	
A batalha é grande mas a vitória é maior	1	
A luta é grande mais Deus é maior vemlogo	1	
A luta é grande mais a vitória é maior	1	
A maior rede de cosméticos do Brasil esta fazendo esta semana uma grande divulgação do novo Lápis Delineador e dando grátis milhares de unidades  .	1	
A minha maior portanto aquele tamanho grande da	1	
A minha maior tristeza foi em nao realizar o meu grande sonho de ser mae  .	1	
A minha é bem maior q essa ate te mandava foto mas demorava a enviar e grande	1	
A rontade de rir e grande mas a de chorar é maior	1	
A saudade é grande mas o orgulho é ainda maior  .	1	
A vontade d rir é grande mas a de chorar é maior	1	
A vontade de beijar é grande mas a distância é maior	1	
A vontade de bloquear ele é grande mas a de sentar nele de novo é maior	1	
A vontade de chora é grande mais a de rir é maior kkkkkkkkkkkkkkkkkkkkkkkkk	1	
A vontade de comenta é grande mais de falar bosta é maior	1	
A vontade de dormir é grande mas a de ficar pra falar com vc é maior	1	
A vontade de escrever é grande mas a preguiça é maior	1	
A vontade de falar é grande mas a vergonha é maior	1	
A vontade de faltar aula é grande mas o medo de reprovar é maior	1	
A vontade de fazer isso na prova é grande mas a de repetir por falta de nota é maior kkkkkkkkkkk	1	
A vontade de mandar msg e grande mas o medo de ficar no vácuo é maior	1	
#resistente,	mais difícil
#alto,	superior
#forte,	mais forte
Boa noite minha guerreira Owwwn es um amor E tu também amor Tu és bastante forte E seja qual for o impacto tu consegues sempre ser mais forte que o tal com ou sem quebras mas para isso é que eu aqui também estou vou sempre aqui estar O qe é prometido é cumprido Espero que consigas descansar mais meu amor Amoooooo te infinitos e cada vez mais beijinhos minha vida qualqer cena ligas me Shiiim banana amassada	4	
Boa noite minha guerreira Owwwn es um amor E tu também amor Tu és bastante forte E seja qual for o impacto tu consegues sempre ser mais forte que o tal	3	
Boa noite minha guerreira Owwwn es um amor E tu também amor Tu és bastante forte E seja qual for o impacto tu consegues sempre ser mais forte que o tal com ou sem quebras mas para isso é que eu aqui também estou	3	
Boa noite minha guerreira Owwwn es um amor E tu também amor Tu és bastante forte E seja qual for o impacto tu consegues sempre ser mais forte que o tal com ou sem quebras mas para isso é que eu aqui também estou vou sempre aqui estar O qe é prometido é cumprido Espero que consigas descansar mais meu amor Amoooooo te infinitos e cada vez mais	3	
Num pulsar mais forte o meu gozo veme te invade dos lábios até o teu peitoeu seguro forte seus cabelossua barba molhada me deixa ainda mais excitadaeu quase perdi o momentovocê é o jardineiro perfeito  .	3	
Marcela DM eu te amo muito e que esse ano de seja repleto de realizações para nós é exatamente assim nosso amor cheio de loucuras e maravilhas amo cada segundo que passo ao seu lado e que essa união venha a ficar mais forte cada dia mais nossa fidelidade um com o outro é muito forte quero vc a todo momento te amo	2	
Marcela DM eu te amo muito e que esse ano de seja repleto de realizações para nós é exatamente assim nosso amor cheio de loucuras e maravilhas amo cada segundo que passo ao seu lado e que essa união venha a ficar mais forte cada dia mais nossa fidelidade um com o outro é muito forte quero vc a todo momento te amo linda	2	
Tu és o meu Rei Leão aquele leãozinho forte que mas batalhas dele se tornava cada vez mais forte o mesmo digo de ti és o meu leão forte meu amor  .	2	
A cada dia que passa sinto que o amor que sinto por ti é muito forte porque o meu coração bate mais forte sempre que penso em ti	1	
Como toda garota Que não teve outra escolha Era ser forte ou ser ainda mais forte Nunca precisou contar com a sorte	1	
Deveria de ser forte o sufeciente para saber lidar com tudo e na volta seria mais forte  .	1	
Mais e uma coisa mais forte que nao sei explicar eu choro eu travo meu coração bate forte fico sem rumo  .	1	
Marcela DM eu te amo muito e que esse ano de seja repleto de realizações para nós é exatamente assim nosso amor cheio de loucuras e maravilhas amo cada segundo que passo ao seu lado e que essa união venha a ficar mais forte cada dia mais nossa fidelidade um com o outro é muito forte quero vc a todo	1	
Mas acredito que se o que senti foi forte devo vir a sentir ainda mais forte	1	
Me ensinou a ser mais forte tbm se hj eu sou forte e mais resistente as coisas é graças a você  .	1	
Meu coração chega bati mais forte pensando no dai que vou estar do seu lado e amis forte ainda quando vc fala que tanbem quer  .	1	
Muito boa tarde igreja o vento ta forte mais nós estamos muito mais forte porque quem	1	
Muito boa tarde igreja o vento ta forte mais nós estamos muito mais forte porque quem esta conosco nunca falha  .	1	
O que achas de mim uma boa miúda bonita Se me pudesses beijar agora beijavas sim Se um dia dissesse que te amava como irias reagir nao sei Amas me e impossível amar alguém por movel Tens saudades minhas sim O que fazias comigo se eu fosse a tua casa tudo depende de ti Se eu te beijasse paravás ou continuavas contiunava Peravas comigo sim Se eu te abraçasse abraçavas me mais forte ou ficavas indiferente forte Levas me para vou levar Tens de me abraçar  .	1	
Okay sabe moh mesmo nos passando por isso sabe essas brigas de familia e tals tudo não passa de testes e preparação pode machucar sim mais não pode derrubar isso só nos deixa mais forte e quero sempre estar pra poder segurar sua mão bem forte e dizer que te amo muito aquele abraço que hoje dou o nome de abraço cura dor haha mais é pois o nosso abraço não sei mais tem alguma coisa que alivia tudo e tudo que nos passa sempre tem a reconpensa você sabe disso lembre se que você não esta mais sozinha hoje você tem mais doque um melhor amigo mais doque um namorado um marido você tem o seu anjo da guarda	1	
Ops tem uns homem la forte mais que eu nem conta ks entao melhor eu trena e fica mais forte para vc chega la so olha os frango	1	
Pois essas pessoas sao burras elas deviam te apoiar nao a cortar mas a parar e a dizer ke escola forte ke consegues pk sim tu és mais forte do que mm a tua cabeça pensa	1	
Primeiro ela te joga no chão bem forte e depois vc se ergue ainda mais forte e assim continua primeiro o ruim pra depois o lado bom	1	
Sim amor melhor ontem o médico da medicina do trabalho teve lá e receitou me voltaren mais forte mas só para tomar em sos e muito forte mas passei melhor a noite  .	1	
Tu és forte tudo o que as pessoas dizem de dizem te poe mais forte nao e amor	1	
Tudo o que já passei foi Você me ensinando à ser mais forte e mais persistente para quê quando as outras situações virem eu continue forte e confiando em Ti  .	1	
mesmo que o tempo nos leve pra caminhos diferentes tenho fé que nossa amizade é mais forte e que a distância será apenas uma prova de quanto nossa amizade é forte e que distância nenhuma impede vc está com pessoas que vc gosta  .	1	
#brilhante,	mais brilhante
#barato,	mais barato
Oi Thiago Boa tarde eu precisava saber o preço de um de óleo mais um preço barato qual que é o mais barato que eu tenho	1	
Sim eu pensei comprar umas brancas sem nada super barato e ir estampar ainda mais barato	1	
Yh ta barato aqui tbm existe cenas dessas e mais barato talvez	1	
#caloroso,	mais quente
#jovem,	mais jovem
#rápido,	mais rápido
Não come muito rápido pq se vc comer rápido vc sente fome mais rápido tbm	1	
Seu cabelo e mak é mais rápido mais não sei se vai ser rápido arrumar o de maysa	1	
Vc viu rápido só não viu mais rápido que ela	1	
É muito importante que fique no grupo apenas quem tem realmente interesse no Projeto quem não for querer participar q se retire para q não nos atrapalhe porq quem foi para a reunião viu e ouviu q quanto mais rápido conseguirmos as peasoas mas rápido o Projeto será concluido e evitar certas postagens	1	
#profundo,	mais profundo
#barulhento,	mais alto
#novo,	mais novo
Mas o teu pai era mesmo bom quando era novo tenho fotos dele quando era mais novo	1	
Se eu mais novo q eu Entao e novo	1	
Ya eu sei tipo a minha ex trocou me por um puto mais novo vai sofrer de novo e depois vai voltar para mim a chorar e a pedir abraços tipo ya ela ta com o pt para ver se eme esquece tas a ver tipo eu tentei esquecer la tbm mas casa vez que olhava para outra gaja com intenção da comer via a mimha ex eu so penso nela e tipo ya tou fodido tbm	1	
#largo,	mais largo
#mau,	pior
E isso nao é uma indireta e sim diretinha e o pior o que vc faz de mau para mim dai volta tudinho para vc pense e ache uma explicação para sua infelicidade ou vai dizer que é feliz o que	2	
Lixado eu ja o parti e mau pensa pelo o lado positivo partir e pior	2	
n pareces mau apenas estas a ser sincero era pior se	2	
Ah então não ta mau assim podia ser pior ainda bem eu tou de folga vou tar de serviço na passagem de ano tem de calhar a alguém	1	
Eu tbm não quero isso que ela não quer isso é mt mau e eu acho já passei por pior pq pra mim aquilo não é assim tão mau	1	
Eu tinha chamado meu irmao para ajuda la na loja estava todos precisando dele ai ele nao foi e todos mundo ficou falando mau dele ai fiquei mau por ouvir isso e ao conversa com ele fiquei pior ainda	1	
Mas ya a minha regra é se tu és bom para mim então eu tb sou se és mau comigo então eu sou pior e por aí em diante	1	
N senti nada estava a ferver por dentro mas n dei motivos o pior foi mesmo o picar dele de mau	1	
N te fasso nenhuma bm parece que eu entrei na sua vida so pra te faZer mau como vc disse la no grupo mudei sua vida pra pior esses dias pra traz disse que eu te machuco dms e agora que eu te fasso mt raiva	1	
O pior e a febre por a tosse aguento mas a febre dá muito mau wstar	1	
O pior q eu to mau ainda  .	1	
O pior que ele fala mau de mim ele é um falso devia agradecer de eu ser boa por ele né	1	
Qual foi a pior coisa que já comeram de mau	1	
Se fôr para dar um susto ao miúdo ate que nao foi mau terem feito isso para no futuro nao ser pior	1	
Tentar ja tento a anos e nao da arriscas te a ficar pior que ele com quem achas que aprendi a ter mau feitio	1	
Tipo se fizer algo mau acontece me mim igual ou pior	1	
Ya estudar ja é mau agora estudar à pressa ainda é pior  .	1	
lugar nd mau podia ter sido pior	1	
n pareces mau apenas estas a ser sincero era pior se tivesses a mentir  .	1	
o meu mau feitio e dez vezes pior kd kero	1	
tem o lado mau também o tenho um pior q o outro mas prnt	1	
É tao mau tar no meu lugar bem pior q tar no teu	1	
#longo,	mais longo
#lento,	mais devagar
#fácil,	mais fácil
Olha sou fácil de gostar e mais fácil ainda pra disgostar	2	
Viajo pelo pêndulo do tempoÉ a mente de um poeta em movimentoAqui mais um discípulo do temploEm busca de um lugar pro sentimentoEu tenho pouco e me contentoEu sei pouco então sempre aprendoPra qualquer sinal eu tô sempre atentoE se a paz me ligar eu atendoNão é tão fácil assimMãe natureza não faz assimLugar pra viver mais fácil simTodos humilham o fraco aquiEu me perdi não me acho aquiEu não quero isso pro meu filho quando for virVou levar o menor pra crescer bem longe daqui	1	
#curto,	mais curta
#pequeno,	menor
A gnt já é pequeno e vem um canal menor e copia ai é tenso	1	
E a thali tem o rosto menor do que de um bebe e muito pequeno	1	
Já está assim pequeno Sorrio de canto ao ver o que fazia sobre o corpo do menor e apertei novamente  .	1	
Mais não é pequeno Pq já vi menor	1	
Olha meu pequeno safado quando era menor	1	
#afiado,	mais nítida
#seguro,	mais segura
#frio,	mais frio
Esta muita frio amanha esta ainda mais frio	1	
Hoje esta mais frio sai de casa as seis e meia e estou aqui cheia de frio kkkk	1	
O tele ja ta mais frio e pra ir brincar ta frio	1	
Ta nada frio na esteve bem mais frio  .	1	
Tava com frio e o teu cabelo tava meio molhado só fez eu ficar com mais frio	1	
Tou arrepiada cheia de frio e vou tirar para ficar ainda com mais frio	1	
Vc esta tao frio comigo ser fica mais frio e melhor bota uma pedra de gelo	1	
mas duvido q faça frio aff nm faz mais frio para d paranoica kkkkkkk	1	
#boa,	melhor
Bom dia genro por você ser essa pessoa as vezes no impulso fica nervoso com o tempo você mudou muito agora você esta melhor mas eu gosto de você continua assim sendo essa pessoa boa e comprenciva e um futuro bom marido pra minha filha e um pai maravilhoso pra minha neta parabéns e feliz aniversario que deus realize todos os seus sonho	16	
Eu nao sei pq mas sla sinto que vc e diferente de todos os outros vc me faz muito feliz muito mesmo eu tenho o melhor namorado do mundo melhor noivo melhor tudo pra mim nao sou boa com textos mas tipo esse e de coração te amo mesmo ta acredito que vc venha me ver um dia isso acontece tenho certeza nem que eu espere ano mas agente vai se ver so espero q seja de vdd esse nosso amor e que Deus cuide de todo nosso amor e confianca um no outro  .	10	
Para principalmente mostrar aquela barriga tanquinho e um corpo atlético não é mesmo Então qual será a dieta para ganhar massa muscular feminina melhor Você já deve saber que sem exercícios com carga musculação e boa alimentação é impossível  .	8	
Parabéns amor meses kkk poxa kkk mds é muito tempo te amo muitoooo sim para mim também é muito tempo muito mesmo bem não foi o melhor mês mas yh passar o dia dos namorados contigo foi uma boa coisa alias foi incrível yh tens razão foi mesmo uma das melhores semanas kk eu nunca vou desistir de ti deixar te ir ou até mesmo cansar de tu a sério às vezes mete raiva o facto de nao ligares ao que te digo eu ja disse que apartir daquele momento acabar contigo esta fora de ser uma possibilidade amor mesmo que eu nao tenha posse sobre os meus sentimentos eu conheço me e sei perfeitamente que isso nunca vai acontecer sério acredita em mim por favor eu nunca me vou cansar de ti eu nao vou embora amor eu nao vou embora EU NAO VOU EMBORA eu estou apaixonada por ti eu amo te mesmo muito e eu nao consigo por muito que queira me desapegar de ti a sério  .	8	
Ae mano boa sorte pra vc ai na Espanha te desejo o melhor sempre  .	5	
Gata boa noite Durma com os anjos e sonhe comigo Ou ainda melhor sonhe com os anjos e durma comigo teammoooo	5	
A forma como você pariu não importa o tempo que você amamentou não te torna mais ou menos mãe do que as outras Mãe que é mãe dá o seu melhor ao seu filho e quem deve dizer se você é uma boa mãe ou não é a sua cria O que muitos dizem que foi o erro para mim foi e é o maior orgulho  .	4	
Bom nao sou boa de texto mais Vc e a melhor amiga q alguem pode ter vc e especial aquela amiga que vc xinga briga mais ela em vez de ficar brava fica rindo	4	
Ola boa noite cida espero que esteja melhor	4	
mas antes de ir tenho de fazer o meu textinho de boa noite para a melhor pessoa e amiga do mundo para mim serás sempre a minha princesa e a melhor pessoa do mundo  .	4	
Abraçar Claro que sim sim claro Uma boa pessoa mais que uma melhor amiga  .	3	
Eu sabia que você não ia aceitar que não ia dar mais certo e tudo eu pensava que tava de boas que eu ia passar por isso normal que o meu dia tinha sido preparado pra isso ja que tava escutando e falando coisas nao tao boa o dia todo eu sabia que mesmo que eu tivesse a melhor intenção e vc visse nos meus olhos nao ia voce ja nao estava acreditando eu só queria que nesse tempo você tivesse mais comigo eu falei tudo aquilo depois mandei todas aquelas mensagens mas mesmo assim parecia que você estava me evitando sempre a gente só se falava um pedaço e pronto eu só quis que tivesse ficado um pouco a mais cmg e nao fugindo  .	3	
Oi edinho boa tarde como estao as coisas por ai Você esta melhor	3	
Quando sou boa sou ótima quando sou ruim sou melhor ainda  .	3	
Vou ctg até ao caixão q ainda falta bué te amo e sabes que sim és a melhor pessoa que conheci em te amo coisa boa	3	
A humildade não ti fais melhor que ninguém mais ti fais diferente de muitos boa pra nois	2	
Ah ea melhor coisa ngm te embassa em nada compra bebidas de boa kkkk	2	
Antes De ir dormir tenho de fazer o meu textinho de boa noite para a minha linda princesa a melhor rapariga do mundo  .	2	
Eiiii parabéns muitos anos de vida que deus abençoe vc que vc possa realizar todos os seus sonhos que vc seja cada vez mais feliz que o menino jesus possa continuar sendo o seu melhor amigo que vc seja sempre esse menino legal ih gente boa que vc e parabéns meu primo tmj	2	
Eu faço tudo o que quiseres só te digo uma cena isto ta a ser a melhor coisa de sempre com a gaja mais boa de todas oweeeeeee mais forteee	2	
Fui mesmo uma boa escolha ter te como melhor amiga	2	
Não posso falar muito porque namora e é com uns dos meus melhor amigos Mas acho uma rapariga muito fixe e divertida é uma boa amiga quando precisam dela	2	
Não posso força ninguém a gostar de mim nem tão pouco fingir que eu gosto apenas mi respeite pois melhor mi ter como boa conhecida do que como uma ótima inimiga  .	2	
Obg Adeus abençoe Nada melhor não tem ver Sabe eu tranquilo boa	2	
Oi serjinho boa noite fala pra inha da ilha de Itaparica que ela foi a melhor coisa que pode acontecer na mh vida fala pra ela que quero fica com ela pra sempre e amar ela como nunca amei garota nenhuma fala que amo muito ela e quero ela perto de mim pra sempre	2	
Oi serjinho boa noite fala pra inha da ilha de Itaparica que ela foi a melhor coisa que pode acontecer na mh vida fala pra ela que quero fica com ela pra sempre e amar ela como nunca amei garota nenhuma fala que amo muito ela e quero ela perto de mim pra sempre pode me chama de minaj  .	2	
Ola boa noite entao essa saúde vai melhor Amiga agora as coisas estão mais calmas além de ainda sofrer muito mas nao ha nada a fazer a minha filha decidiu manda lo embora na qual ele foi logo els agora esta sosinha esta em paz e nos tb agora ainda vamos ver filhos n tem por isso agora e com eles  .	2	
PS não sou boa com textos Quem faz anos hoje A melhor companhia do mundo A pessoa que eu dou tantas risadas A pessoa que está sempre a me defender A pessoa que está sempre a me bater A pessoa que está comigo desde infância A pessoa que quando quer alguma coisa tem que ter  .	2	
Parança ta boa mas pedaço ta melhor	2	
Prefiro ser mil vezes melhor bondosa do que ruim tipo sou muito boa Pq até alguns minutos eu tava brava com a kauane mas dai eu percebi que tava sendo ruim demais mas ela não sabia pois ta sabendo agora mas perdou tds as minhas amigas os tds mesmo	2	
Tem boa semana corra tudo pelo melhor  .	2	
Tu és daqueles que me fazem querer sem uma boa pessoa faz me querer ser a melhor versão de mim  .	2	
ela e super gente boa e vc tbm vcs se merece super apoioooooo melhor casal de	2	
exposição o dia jamais foi uma das melhores coisas que aconteceu na minha vida Uma menina super Gnt boa Gosto mt A melhor Sarah mi	2	
A comida era boa mas ja comi melhor kkk	1	
A comida nem tava tão boa moh era pra mim ter feito uma coisa melhor mais com vc tudo e bom pft	1	
A festa Ta boa ai e a bagunça que vai fica ta melhor ainda ne Kkkk muito lindas	1	
A festa foi boa Isaura mas se tu tivesse lá Teria sido melhor	1	
A gente fica de boa la fora é melhor	1	
A minha mae Diz estas melhor E que tenhas uma boa passagem de ano	1	
A minha tbm é boa para contorno mais n muito e melhor para pintar	1	
A minha vida foi sempre boa agora esta ainda melhor ao estar ao teu lado como namorado	1	
A tia falou que esse aqui e o melhor rapinho a pessoa fica boa	1	
Acha fer foi com maior orgulho que te chamei nao poderia existir pessoa melhor para meu filho pq sei se eu morrer estara em boa maos com a segunda mae dele te amo e muito obrigada por tudo	1	
Achas amor Nepia e melhor vê lo noutro dia hoje tb n tou assim mt boa companhia sinceramente	1	
Achas que esta boa como esta ou maior era melhor	1	
Acho melhor falar amanhã pq até la eu consigo bolar uma boa discussão	1	
Acho melhor negas para uma aluna boa	1	
Acho que e melhor eu ir dormir tenho que acontece e ja dei boa noite pra minha mina	1	
Achou que eu ia me esquecer é Jamais Perdao pelo atraso Mary você sabe que nao sou boa com textos mas vamos la vou dar o meu melhor viu priminhaaaa  .	1	
#alta,	mais alto
depois anda só a trepar tudo sem medos amda demais só está semana mudou bastante sobre tudo seja mais alto que ela ou não quase ia sobindo a secretária e e mais alta que ela onde eata a TV ja estava a meio dela	1	
#fraco,	mais fraco
só falo que tou fraco kkk oq eu sou uns dos mais fraco do clã kkkk mais um dia quem sabe mude	1	
#inteligente,	mais esperto
#legal,	resfriador
#ótimo,	maior
Ah sua maior qualidade eh um ótimo amigo	1	
#difícil,	mais difíceis
Ja andei atras de coisas mais difíceis uma macaca super difícil	1	
Moh yh é difícil mas nós temos que aguentar ja passamos por situações mais difíceis e o que é que fizemos Aguentamos um pelo outro	1	
Moh yh é difícil mas nós temos que aguentar ja passamos por situações mais difíceis e o que é que fizemos Aguentamos um pelo outro Vais ver que quinta chega depressa mohzinho Txi amoo muito	1	
#fácil,	mais fácil
Olha sou fácil de gostar e mais fácil ainda pra disgostar	2	
Viajo pelo pêndulo do tempoÉ a mente de um poeta em movimentoAqui mais um discípulo do temploEm busca de um lugar pro sentimentoEu tenho pouco e me contentoEu sei pouco então sempre aprendoPra qualquer sinal eu tô sempre atentoE se a paz me ligar eu atendoNão é tão fácil assimMãe natureza não faz assimLugar pra viver mais fácil simTodos humilham o fraco aquiEu me perdi não me acho aquiEu não quero isso pro meu filho quando for virVou levar o menor pra crescer bem longe daqui	1	
#esquisito,	mais estranho
#frio,	mais frio
Esta muita frio amanha esta ainda mais frio	1	
Hoje esta mais frio sai de casa as seis e meia e estou aqui cheia de frio kkkk	1	
O tele ja ta mais frio e pra ir brincar ta frio	1	
Ta nada frio na esteve bem mais frio  .	1	
Tava com frio e o teu cabelo tava meio molhado só fez eu ficar com mais frio	1	
Tou arrepiada cheia de frio e vou tirar para ficar ainda com mais frio	1	
Vc esta tao frio comigo ser fica mais frio e melhor bota uma pedra de gelo	1	
mas duvido q faça frio aff nm faz mais frio para d paranoica kkkkkkk	1	
#afiado,	mais afiada
#caloroso,	mais quente
#forte,	mais forte
Boa noite minha guerreira Owwwn es um amor E tu também amor Tu és bastante forte E seja qual for o impacto tu consegues sempre ser mais forte que o tal com ou sem quebras mas para isso é que eu aqui também estou vou sempre aqui estar O qe é prometido é cumprido Espero que consigas descansar mais meu amor Amoooooo te infinitos e cada vez mais beijinhos minha vida qualqer cena ligas me Shiiim banana amassada	4	
Boa noite minha guerreira Owwwn es um amor E tu também amor Tu és bastante forte E seja qual for o impacto tu consegues sempre ser mais forte que o tal	3	
Boa noite minha guerreira Owwwn es um amor E tu também amor Tu és bastante forte E seja qual for o impacto tu consegues sempre ser mais forte que o tal com ou sem quebras mas para isso é que eu aqui também estou	3	
Boa noite minha guerreira Owwwn es um amor E tu também amor Tu és bastante forte E seja qual for o impacto tu consegues sempre ser mais forte que o tal com ou sem quebras mas para isso é que eu aqui também estou vou sempre aqui estar O qe é prometido é cumprido Espero que consigas descansar mais meu amor Amoooooo te infinitos e cada vez mais	3	
Num pulsar mais forte o meu gozo veme te invade dos lábios até o teu peitoeu seguro forte seus cabelossua barba molhada me deixa ainda mais excitadaeu quase perdi o momentovocê é o jardineiro perfeito  .	3	
Marcela DM eu te amo muito e que esse ano de seja repleto de realizações para nós é exatamente assim nosso amor cheio de loucuras e maravilhas amo cada segundo que passo ao seu lado e que essa união venha a ficar mais forte cada dia mais nossa fidelidade um com o outro é muito forte quero vc a todo momento te amo	2	
Marcela DM eu te amo muito e que esse ano de seja repleto de realizações para nós é exatamente assim nosso amor cheio de loucuras e maravilhas amo cada segundo que passo ao seu lado e que essa união venha a ficar mais forte cada dia mais nossa fidelidade um com o outro é muito forte quero vc a todo momento te amo linda	2	
Tu és o meu Rei Leão aquele leãozinho forte que mas batalhas dele se tornava cada vez mais forte o mesmo digo de ti és o meu leão forte meu amor  .	2	
A cada dia que passa sinto que o amor que sinto por ti é muito forte porque o meu coração bate mais forte sempre que penso em ti	1	
Como toda garota Que não teve outra escolha Era ser forte ou ser ainda mais forte Nunca precisou contar com a sorte	1	
Deveria de ser forte o sufeciente para saber lidar com tudo e na volta seria mais forte  .	1	
Mais e uma coisa mais forte que nao sei explicar eu choro eu travo meu coração bate forte fico sem rumo  .	1	
Marcela DM eu te amo muito e que esse ano de seja repleto de realizações para nós é exatamente assim nosso amor cheio de loucuras e maravilhas amo cada segundo que passo ao seu lado e que essa união venha a ficar mais forte cada dia mais nossa fidelidade um com o outro é muito forte quero vc a todo	1	
Mas acredito que se o que senti foi forte devo vir a sentir ainda mais forte	1	
Me ensinou a ser mais forte tbm se hj eu sou forte e mais resistente as coisas é graças a você  .	1	
Meu coração chega bati mais forte pensando no dai que vou estar do seu lado e amis forte ainda quando vc fala que tanbem quer  .	1	
Muito boa tarde igreja o vento ta forte mais nós estamos muito mais forte porque quem	1	
Muito boa tarde igreja o vento ta forte mais nós estamos muito mais forte porque quem esta conosco nunca falha  .	1	
O que achas de mim uma boa miúda bonita Se me pudesses beijar agora beijavas sim Se um dia dissesse que te amava como irias reagir nao sei Amas me e impossível amar alguém por movel Tens saudades minhas sim O que fazias comigo se eu fosse a tua casa tudo depende de ti Se eu te beijasse paravás ou continuavas contiunava Peravas comigo sim Se eu te abraçasse abraçavas me mais forte ou ficavas indiferente forte Levas me para vou levar Tens de me abraçar  .	1	
Okay sabe moh mesmo nos passando por isso sabe essas brigas de familia e tals tudo não passa de testes e preparação pode machucar sim mais não pode derrubar isso só nos deixa mais forte e quero sempre estar pra poder segurar sua mão bem forte e dizer que te amo muito aquele abraço que hoje dou o nome de abraço cura dor haha mais é pois o nosso abraço não sei mais tem alguma coisa que alivia tudo e tudo que nos passa sempre tem a reconpensa você sabe disso lembre se que você não esta mais sozinha hoje você tem mais doque um melhor amigo mais doque um namorado um marido você tem o seu anjo da guarda	1	
Ops tem uns homem la forte mais que eu nem conta ks entao melhor eu trena e fica mais forte para vc chega la so olha os frango	1	
Pois essas pessoas sao burras elas deviam te apoiar nao a cortar mas a parar e a dizer ke escola forte ke consegues pk sim tu és mais forte do que mm a tua cabeça pensa	1	
Primeiro ela te joga no chão bem forte e depois vc se ergue ainda mais forte e assim continua primeiro o ruim pra depois o lado bom	1	
Sim amor melhor ontem o médico da medicina do trabalho teve lá e receitou me voltaren mais forte mas só para tomar em sos e muito forte mas passei melhor a noite  .	1	
Tu és forte tudo o que as pessoas dizem de dizem te poe mais forte nao e amor	1	
Tudo o que já passei foi Você me ensinando à ser mais forte e mais persistente para quê quando as outras situações virem eu continue forte e confiando em Ti  .	1	
mesmo que o tempo nos leve pra caminhos diferentes tenho fé que nossa amizade é mais forte e que a distância será apenas uma prova de quanto nossa amizade é forte e que distância nenhuma impede vc está com pessoas que vc gosta  .	1	
#estranho,	mais estranho
#baixo,	menor
disse rouco mordendo fraco o clitóris da menor escutando ela gemendo meu nome baixo  .	3	
Hoseok Solto um suspiro baixo sabia que se eu fosse atrás sa menor iriamos acabar brigando novamente  .	2	
disse baixo pensando que talvez a menor não escutaria o que havia dito  .	2	
disse um pouco baixo não queria brigar com a menor  .	2	
Achar algm baixo ja é ruim mas menor q eu é doido	1	
O Junior veio me trazer dinheiro aki em casa e falou que falou cm o menor e pediu por guri me pega la em baixo	1	
Pq acho q quando ele era menor nao puxava o coro pra baixo	1	
Se vou me matar de baixo de uma careta ou de um carro menor	1	
#Largo,	mais ampla
#pequeno,	menor
A gnt já é pequeno e vem um canal menor e copia ai é tenso	1	
E a thali tem o rosto menor do que de um bebe e muito pequeno	1	
Já está assim pequeno Sorrio de canto ao ver o que fazia sobre o corpo do menor e apertei novamente  .	1	
Mais não é pequeno Pq já vi menor	1	
Olha meu pequeno safado quando era menor	1	
#legal,	mais legal
Eu sou mais legal aqui e ainda assim não sou maravilhosa de legal	1	
#ótimo,	maior
Ah sua maior qualidade eh um ótimo amigo	1	
#quente,	mais quente
Eu sempre fui quente so comecei a ficar mais quente desde K a minha mae parti	1	
Fazemos assim cada um manda uma foto quente e depois vemos qual a mais quente	1	
#longo,	mais longo
#fraco,	mais fraco
só falo que tou fraco kkk oq eu sou uns dos mais fraco do clã kkkk mais um dia quem sabe mude	1	
#simples,	mais simples
#inteligente,	mais inteligente
Ele era muito inteligente nunca vi um menino mais inteligente que ele	1	
#alto,	mais alto
Mais alto ent se eu sou mais alto que tu	1	
Mas tipo ser alto também nao e bom pk tipo ca em casa eu sou o mais alto	1	
#alta,	mais alto
depois anda só a trepar tudo sem medos amda demais só está semana mudou bastante sobre tudo seja mais alto que ela ou não quase ia sobindo a secretária e e mais alta que ela onde eata a TV ja estava a meio dela	1	
#saboroso,	mais gostoso
#jovem,	mais jovens
#mau,	pior
E isso nao é uma indireta e sim diretinha e o pior o que vc faz de mau para mim dai volta tudinho para vc pense e ache uma explicação para sua infelicidade ou vai dizer que é feliz o que	2	
Lixado eu ja o parti e mau pensa pelo o lado positivo partir e pior	2	
n pareces mau apenas estas a ser sincero era pior se	2	
Ah então não ta mau assim podia ser pior ainda bem eu tou de folga vou tar de serviço na passagem de ano tem de calhar a alguém	1	
Eu tbm não quero isso que ela não quer isso é mt mau e eu acho já passei por pior pq pra mim aquilo não é assim tão mau	1	
Eu tinha chamado meu irmao para ajuda la na loja estava todos precisando dele ai ele nao foi e todos mundo ficou falando mau dele ai fiquei mau por ouvir isso e ao conversa com ele fiquei pior ainda	1	
Mas ya a minha regra é se tu és bom para mim então eu tb sou se és mau comigo então eu sou pior e por aí em diante	1	
N senti nada estava a ferver por dentro mas n dei motivos o pior foi mesmo o picar dele de mau	1	
N te fasso nenhuma bm parece que eu entrei na sua vida so pra te faZer mau como vc disse la no grupo mudei sua vida pra pior esses dias pra traz disse que eu te machuco dms e agora que eu te fasso mt raiva	1	
O pior e a febre por a tosse aguento mas a febre dá muito mau wstar	1	
O pior q eu to mau ainda  .	1	
O pior que ele fala mau de mim ele é um falso devia agradecer de eu ser boa por ele né	1	
Qual foi a pior coisa que já comeram de mau	1	
Se fôr para dar um susto ao miúdo ate que nao foi mau terem feito isso para no futuro nao ser pior	1	
Tentar ja tento a anos e nao da arriscas te a ficar pior que ele com quem achas que aprendi a ter mau feitio	1	
Tipo se fizer algo mau acontece me mim igual ou pior	1	
Ya estudar ja é mau agora estudar à pressa ainda é pior  .	1	
lugar nd mau podia ter sido pior	1	
n pareces mau apenas estas a ser sincero era pior se tivesses a mentir  .	1	
o meu mau feitio e dez vezes pior kd kero	1	
tem o lado mau também o tenho um pior q o outro mas prnt	1	
É tao mau tar no meu lugar bem pior q tar no teu	1	
#rápido,	mais rápido
Não come muito rápido pq se vc comer rápido vc sente fome mais rápido tbm	1	
Seu cabelo e mak é mais rápido mais não sei se vai ser rápido arrumar o de maysa	1	
Vc viu rápido só não viu mais rápido que ela	1	
É muito importante que fique no grupo apenas quem tem realmente interesse no Projeto quem não for querer participar q se retire para q não nos atrapalhe porq quem foi para a reunião viu e ouviu q quanto mais rápido conseguirmos as peasoas mas rápido o Projeto será concluido e evitar certas postagens	1	
#velho,	mais velho
Esse vídeo é mais velho que a palavra velho  .	1	
Estas a ver sou mais velho e não me considero velho	1	
Minhas vidas o mano mais velho ja não se quer mascarar diz que está Mt velho	1	
Posso ter amigos mais velho mas n Tao velho e nem com cara de ladrão	1	
Um velho careca q so quer saber do meu irmão mais velho	1	
Velho velho nao pareces mas pareces mais velho do que a idade que tens	1	
#velozes,	o mais rápido
#brilhante,	mais brilhante
#grande,	maior
Que minha coragem seja maior que meu medo e que minha força seja tão grande quanto minha fé  .	13	
A vontade de rir é grande mas a de chorar é maior	12	
Nenhum obstáculo será grande se a sua vontade de vencer for maior	9	
A vontade de rir e grande mais a de chorar e maior	7	
E como é grande esse amor meu filho É eterno e incondicional maior que o tempo e superior à própria vida  .	7	
foi um ano de lutas de conquista e de perdas também mas como meu pai OGUM diz que o grande pai OXALÁ nunca da o fardo maior do que nos possamos carregar  .	5	
Nenhum obstáculo será tão grande se sua vontade de vencer for maior  .	4	
Que minha coragem seja maior que o meu medo e que minha força seja tão grande quanto a minha fé	4	
A distância um dos pioresPara se começar Porque tão difícil de se lidar Será que porque euTenho medo de ela Encontrar alguém muito Que eu E se apaixonar Será por isso Que é isso que não Para de pensar Toda hora momento Não consigo parar de pensar Que do seu lado quero estar Mesmo que custeQue eu tiver Ao seu lado para sempre Quero estar Quero te abraçar xTe beijar xE valer cada segundo Que foi me dado Quero aproveitar E ao seu lado quero estar Eu não tenho Dinheiro infelizmente Para te visitar Mas se possível mesmo seja Apenas vez Darei de tudo para te encontrar Sei que a distância é muito grande Mas pode garantir me amor é maior Tenho medo das circunstâncias Tenho certeza que um dia que tem encartarei Mesmo que seja pelo laço vermelho Laço que representa esse nosso amor Mesmo que custe Tudo que eu tiver Eu  .	3	
Bom dia Nenhum obstáculo será tão grande se tua vontade de vencer for maior Desejo um dia abençoado a tds Que ele seja repleto de paz  .	3	
Eu sei mais eu nao quero Pq tenho medo de errar outra vez de ferir teus sentimentos de voltar a namora com vc e grande mais o medo de machucar os teus sentimentos e maior	3	
Que minha coragem seja maior que meu medo e que minha força seja tão grande quanto minha fé	3	
A sdd é grande mais o orgulho é maior  .	2	
A vontade de botar um pici e grande mais o medo da mae me da ums murro e maior	2	
A vontade de fazer nada é grande mas a fome é maior	2	
A vontade de rir é grande mais a de chorar é maior	2	
A vontade de te matar e grande mais a de comer esses picole e maior ainda	2	
A vontade é grande mais o pensamento é maior	2	
As vezes autocrítica ao extrema é o que pode causar solidão depressão ansiedade e diversos transtornos psicológicos por se culpar d por incrível que pareça essa é uma grande causa mas claro que não a maior e nem a única  .	2	
Deivinho tu é mais bonito sem tanto pelo no corpo com o cabelo maior e com peito grande Aiii simm  .	2	
Obrigado por esta em meu lado nos dias de tristezas nos dias de risadas e foram algumas neh Rs ja passamos por tanta coisa ja tentaram nos prejudicar ate mesmo nos fazer uma odiar a outra mas deus sabe o que faz e deus nao permitiu que nos odiamos sem ao menos nos conhecer de verdade hoje a Mayara que conheço e uma grande mulher de admiro muito e levo suas experiências de vida cm exemplo para minha você amadureceu tão rápido tao de repente que acho que ate voce mesmo nao deve saber o tipo de mulher que você se tornou o tipo de mulher que hoje admiro muito se tornou uma mulher guerreira que hoje nao tem medo de arriscar na vida e errar voce entra em qualquer situação de corpo e alma e isso me admira muito em você começamos a nos falar através de uma briga boba que depois se tornou uma grande amizade tivemos que passar pela nossa maior tristeza e nossa maior dor muitos falaram mal da gente muitos nos julgaram mais somente nos duas sabemos tudo que vivemos juntos e tudo que passamos pra hoje estamos aqui com todas as críticas e ate mesmos todos julgamentos mas enfim hoje se tornou	2	
Obrigado por esta em meu lado nos dias de tristezas nos dias de risadas e foram algumas neh Rs ja passamos por tanta coisa ja tentaram nos prejudicar ate mesmo nos fazer uma odiar a outra mas deus sabe o que faz e deus nao permitiu que nos odiamos sem ao menos nos conhecer de verdade hoje a Mayara que conheço e uma grande mulher de admiro muito e levo suas experiências de vida cm exemplo para minha você amadureceu tão rápido tao de repente que acho que ate voce mesmo nao deve saber o tipo de mulher que você se tornou o tipo de mulher que hoje admiro muito se tornou uma mulher guerreira que hoje nao tem medo de arriscar na vida e errar voce entra em qualquer situação de corpo e alma e isso me admira muito em você começamos a nos falar através de uma briga boba que depois se tornou uma grande amizade tivemos que passar pela nossa maior tristeza e nossa maior dor muitos falaram mal da gente muitos nos julgaram mais somente nos duas sabemos tudo que vivemos juntos e tudo que passamos pra hoje estamos aqui com todas as críticas e ate mesmos todos julgamentos mas enfim hoje se tornou minha maior confidente a que sabe mais das minhas merda que eu mesmo Rs ja lhe contei tanto coisa e hoje sei que posso realmente confiar em você sem medo de qualquer coisa  .	2	
Que a minha coragem seja maior que o meu medo e que minha força seja tão grande quanto a minha Fé	2	
Que a minha coragem seja maior que o meu medo e que minha força seja tão grande quanto minha fé	2	
Que minha coragem seja maior que o meu medo que minha força seja tão grande quanto minha fé BomDia  .	2	
a boca e grande mas o coração é maior	2	
diz Ezekiel num tom sombrio do que ta falando Ezekiel diz Daniel abaixando se para amarrar seu tênis esse aí era só uma distração um dos meus lacaios eu sou o problema de verdade olho para trás Ezekiel dá dois espasmos no pescoço e em questão de segundos vira outro chupa cu mas bem maior e bem mais assustador dá um rugido de leão e em seguida um grande pulo na direção do traseiro de Daniel Daniel dá um grito de agonia e em questão de segundos todo seu sangue é sugado Daniel cai pálido e imóvel eu e Maryana estávamos imóveis e então Ezekiel ou o que era pra ser o Ezekiel vem com a boca cheia de sangue em nossa direção me puxa pelos braços e dá uma mordida no meu ombro esquerdo dou um chute em sua barriga e caio ele ruge novamente porém bem mais alto e mais assustador começam a crescer espinhos em suas costas tento o acertar com o pedaço de pau mas ele pega minha arma improvisada e come arrasta seus braços gigantes em minha direção olho para cima ele era muito maior devia ter pelo menos uns m na hora que ele ia me pegar de novo ouço um disparo ele cai pra trás ao levar um tiro em sua cabeça ainda atordoado Maryana me carrega pelo ombro me coloca no banco do motorista porque ela não sabia dirigir vou dirigindo até a cidade Maryana ainda está trêmula de medo minha cabeça começa a girar Maryana eu não estou bem  .	2	
minha coragem seja maior que meu medo e que minha força seja tão grande quanto minha fé	2	
nnc senti tao segura como alguém como sinto na nossa relação amor sempre vais ser sempre a minha rainha sem castrelo és a minha maior fonte de energia tenho grande orgulhor em ter comigo estarei aqui sempre para fazer loucoras contigo pk essas sim sao as melhores loucoras da minha vida as que faso no teu lado te venero minha mais que tudo	2	
A alegria é grande mais a solidão é maior	1	
A batalha é grande mas a vitória é maior	1	
A luta é grande mais Deus é maior vemlogo	1	
A luta é grande mais a vitória é maior	1	
A maior rede de cosméticos do Brasil esta fazendo esta semana uma grande divulgação do novo Lápis Delineador e dando grátis milhares de unidades  .	1	
A minha maior portanto aquele tamanho grande da	1	
A minha maior tristeza foi em nao realizar o meu grande sonho de ser mae  .	1	
A minha é bem maior q essa ate te mandava foto mas demorava a enviar e grande	1	
A rontade de rir e grande mas a de chorar é maior	1	
A saudade é grande mas o orgulho é ainda maior  .	1	
A vontade d rir é grande mas a de chorar é maior	1	
A vontade de beijar é grande mas a distância é maior	1	
A vontade de bloquear ele é grande mas a de sentar nele de novo é maior	1	
A vontade de chora é grande mais a de rir é maior kkkkkkkkkkkkkkkkkkkkkkkkk	1	
A vontade de comenta é grande mais de falar bosta é maior	1	
A vontade de dormir é grande mas a de ficar pra falar com vc é maior	1	
A vontade de escrever é grande mas a preguiça é maior	1	
A vontade de falar é grande mas a vergonha é maior	1	
A vontade de faltar aula é grande mas o medo de reprovar é maior	1	
A vontade de fazer isso na prova é grande mas a de repetir por falta de nota é maior kkkkkkkkkkk	1	
A vontade de mandar msg e grande mas o medo de ficar no vácuo é maior	1	
#ampla,	maior
#lento,	mais lento
#curto,	mais curto
Meu cabelo ja e curto so vou botar ele mais curto	1	
Mudei td pra fica cm tigo parei de sai agr vejo pouco minjas amiga parei de usa short curto do geito q usava e era mais curto q isso q tu chama de curto e tu tbm so reclama	1	
O meu cabelo e curto e eu ia la ainda fica mais curto	1	
Sim mas ele tá curto vais cortar mt mais curto	1	
#boa,	melhor
Bom dia genro por você ser essa pessoa as vezes no impulso fica nervoso com o tempo você mudou muito agora você esta melhor mas eu gosto de você continua assim sendo essa pessoa boa e comprenciva e um futuro bom marido pra minha filha e um pai maravilhoso pra minha neta parabéns e feliz aniversario que deus realize todos os seus sonho	16	
Eu nao sei pq mas sla sinto que vc e diferente de todos os outros vc me faz muito feliz muito mesmo eu tenho o melhor namorado do mundo melhor noivo melhor tudo pra mim nao sou boa com textos mas tipo esse e de coração te amo mesmo ta acredito que vc venha me ver um dia isso acontece tenho certeza nem que eu espere ano mas agente vai se ver so espero q seja de vdd esse nosso amor e que Deus cuide de todo nosso amor e confianca um no outro  .	10	
Para principalmente mostrar aquela barriga tanquinho e um corpo atlético não é mesmo Então qual será a dieta para ganhar massa muscular feminina melhor Você já deve saber que sem exercícios com carga musculação e boa alimentação é impossível  .	8	
Parabéns amor meses kkk poxa kkk mds é muito tempo te amo muitoooo sim para mim também é muito tempo muito mesmo bem não foi o melhor mês mas yh passar o dia dos namorados contigo foi uma boa coisa alias foi incrível yh tens razão foi mesmo uma das melhores semanas kk eu nunca vou desistir de ti deixar te ir ou até mesmo cansar de tu a sério às vezes mete raiva o facto de nao ligares ao que te digo eu ja disse que apartir daquele momento acabar contigo esta fora de ser uma possibilidade amor mesmo que eu nao tenha posse sobre os meus sentimentos eu conheço me e sei perfeitamente que isso nunca vai acontecer sério acredita em mim por favor eu nunca me vou cansar de ti eu nao vou embora amor eu nao vou embora EU NAO VOU EMBORA eu estou apaixonada por ti eu amo te mesmo muito e eu nao consigo por muito que queira me desapegar de ti a sério  .	8	
Ae mano boa sorte pra vc ai na Espanha te desejo o melhor sempre  .	5	
Gata boa noite Durma com os anjos e sonhe comigo Ou ainda melhor sonhe com os anjos e durma comigo teammoooo	5	
A forma como você pariu não importa o tempo que você amamentou não te torna mais ou menos mãe do que as outras Mãe que é mãe dá o seu melhor ao seu filho e quem deve dizer se você é uma boa mãe ou não é a sua cria O que muitos dizem que foi o erro para mim foi e é o maior orgulho  .	4	
Bom nao sou boa de texto mais Vc e a melhor amiga q alguem pode ter vc e especial aquela amiga que vc xinga briga mais ela em vez de ficar brava fica rindo	4	
Ola boa noite cida espero que esteja melhor	4	
mas antes de ir tenho de fazer o meu textinho de boa noite para a melhor pessoa e amiga do mundo para mim serás sempre a minha princesa e a melhor pessoa do mundo  .	4	
Abraçar Claro que sim sim claro Uma boa pessoa mais que uma melhor amiga  .	3	
Eu sabia que você não ia aceitar que não ia dar mais certo e tudo eu pensava que tava de boas que eu ia passar por isso normal que o meu dia tinha sido preparado pra isso ja que tava escutando e falando coisas nao tao boa o dia todo eu sabia que mesmo que eu tivesse a melhor intenção e vc visse nos meus olhos nao ia voce ja nao estava acreditando eu só queria que nesse tempo você tivesse mais comigo eu falei tudo aquilo depois mandei todas aquelas mensagens mas mesmo assim parecia que você estava me evitando sempre a gente só se falava um pedaço e pronto eu só quis que tivesse ficado um pouco a mais cmg e nao fugindo  .	3	
Oi edinho boa tarde como estao as coisas por ai Você esta melhor	3	
Quando sou boa sou ótima quando sou ruim sou melhor ainda  .	3	
Vou ctg até ao caixão q ainda falta bué te amo e sabes que sim és a melhor pessoa que conheci em te amo coisa boa	3	
A humildade não ti fais melhor que ninguém mais ti fais diferente de muitos boa pra nois	2	
Ah ea melhor coisa ngm te embassa em nada compra bebidas de boa kkkk	2	
Antes De ir dormir tenho de fazer o meu textinho de boa noite para a minha linda princesa a melhor rapariga do mundo  .	2	
Eiiii parabéns muitos anos de vida que deus abençoe vc que vc possa realizar todos os seus sonhos que vc seja cada vez mais feliz que o menino jesus possa continuar sendo o seu melhor amigo que vc seja sempre esse menino legal ih gente boa que vc e parabéns meu primo tmj	2	
Eu faço tudo o que quiseres só te digo uma cena isto ta a ser a melhor coisa de sempre com a gaja mais boa de todas oweeeeeee mais forteee	2	
Fui mesmo uma boa escolha ter te como melhor amiga	2	
Não posso falar muito porque namora e é com uns dos meus melhor amigos Mas acho uma rapariga muito fixe e divertida é uma boa amiga quando precisam dela	2	
Não posso força ninguém a gostar de mim nem tão pouco fingir que eu gosto apenas mi respeite pois melhor mi ter como boa conhecida do que como uma ótima inimiga  .	2	
Obg Adeus abençoe Nada melhor não tem ver Sabe eu tranquilo boa	2	
Oi serjinho boa noite fala pra inha da ilha de Itaparica que ela foi a melhor coisa que pode acontecer na mh vida fala pra ela que quero fica com ela pra sempre e amar ela como nunca amei garota nenhuma fala que amo muito ela e quero ela perto de mim pra sempre	2	
Oi serjinho boa noite fala pra inha da ilha de Itaparica que ela foi a melhor coisa que pode acontecer na mh vida fala pra ela que quero fica com ela pra sempre e amar ela como nunca amei garota nenhuma fala que amo muito ela e quero ela perto de mim pra sempre pode me chama de minaj  .	2	
Ola boa noite entao essa saúde vai melhor Amiga agora as coisas estão mais calmas além de ainda sofrer muito mas nao ha nada a fazer a minha filha decidiu manda lo embora na qual ele foi logo els agora esta sosinha esta em paz e nos tb agora ainda vamos ver filhos n tem por isso agora e com eles  .	2	
PS não sou boa com textos Quem faz anos hoje A melhor companhia do mundo A pessoa que eu dou tantas risadas A pessoa que está sempre a me defender A pessoa que está sempre a me bater A pessoa que está comigo desde infância A pessoa que quando quer alguma coisa tem que ter  .	2	
Parança ta boa mas pedaço ta melhor	2	
Prefiro ser mil vezes melhor bondosa do que ruim tipo sou muito boa Pq até alguns minutos eu tava brava com a kauane mas dai eu percebi que tava sendo ruim demais mas ela não sabia pois ta sabendo agora mas perdou tds as minhas amigas os tds mesmo	2	
Tem boa semana corra tudo pelo melhor  .	2	
Tu és daqueles que me fazem querer sem uma boa pessoa faz me querer ser a melhor versão de mim  .	2	
ela e super gente boa e vc tbm vcs se merece super apoioooooo melhor casal de	2	
exposição o dia jamais foi uma das melhores coisas que aconteceu na minha vida Uma menina super Gnt boa Gosto mt A melhor Sarah mi	2	
A comida era boa mas ja comi melhor kkk	1	
A comida nem tava tão boa moh era pra mim ter feito uma coisa melhor mais com vc tudo e bom pft	1	
A festa Ta boa ai e a bagunça que vai fica ta melhor ainda ne Kkkk muito lindas	1	
A festa foi boa Isaura mas se tu tivesse lá Teria sido melhor	1	
A gente fica de boa la fora é melhor	1	
A minha mae Diz estas melhor E que tenhas uma boa passagem de ano	1	
A minha tbm é boa para contorno mais n muito e melhor para pintar	1	
A minha vida foi sempre boa agora esta ainda melhor ao estar ao teu lado como namorado	1	
A tia falou que esse aqui e o melhor rapinho a pessoa fica boa	1	
Acha fer foi com maior orgulho que te chamei nao poderia existir pessoa melhor para meu filho pq sei se eu morrer estara em boa maos com a segunda mae dele te amo e muito obrigada por tudo	1	
Achas amor Nepia e melhor vê lo noutro dia hoje tb n tou assim mt boa companhia sinceramente	1	
Achas que esta boa como esta ou maior era melhor	1	
Acho melhor falar amanhã pq até la eu consigo bolar uma boa discussão	1	
Acho melhor negas para uma aluna boa	1	
Acho que e melhor eu ir dormir tenho que acontece e ja dei boa noite pra minha mina	1	
Achou que eu ia me esquecer é Jamais Perdao pelo atraso Mary você sabe que nao sou boa com textos mas vamos la vou dar o meu melhor viu priminhaaaa  .	1	
#Sombrio,	mais escuro
#sortudo,	mais sortudas
