#doce,	mais doce
É o sentimento mais doce e belo e como é doce e aconchegante poder sentir seu corpo e do fundo dos seus olhos a sua alma  .	2	
Tipo se vc gosta mais doce coloca mais suspiro se vc gosta menos doce coloca mais morango	1	
#Tailândia,	Tailandês
#Índia,	Indiano
#Portugal,	Português
#Bielorrússia,	Bielorrusso
#Suécia,	Sueco
#Espanha,	Espanhol
#México,	Mexicano
#Brasil,	Brasileiro
Na próxima edição do principal torneio de clubes da América do Sul o Brasil terá ao todo oito representantes contando as vagas que são dadas através do Campeonato Brasileiro além da que é dada para o campeão da Copa do Brasil e também o Grêmio atual campeão da Libertadores  .	4	
Boa tarde nação Na próxima edição do principal torneio de clubes da América do Sul o Brasil terá ao todo oito representantes contando as vagas que são dadas através do Campeonato Brasileiro além da que é dada para o campeão da Copa do Brasil e também o Grêmio atual campeão da Libertadores  .	1	
Complementando o São José ficou com a vaga da Copa do Brasil mas abriu mão da vaga para disputar a Série D do Brasileiro por isso o Aimoré herdou a vaga  .	1	
Nos jogamos a copa a liberdadires copa do Brasil Sul americana além e óbvio do Brasileiro  .	1	
RESPEITO TAMBÉM DEVE EXISTIR NO TRÂNSITO Ulisses FreitasParaciclistaBicampeão da Copa Brasil Tricampeão do RK Brasileiro / /	1	
#China,	Chinês
#Peru,	Peruano
#Argentina,	Argentino
#Coréia,	Coreano
#Egito,	Egípcio
#Ucrânia,	Ucraniano
#Austrália,	Australiano
#Rússia,	Russo
#Japão,	Japonês
#Camboja,	Cambojano
#Grécia,	Grego
#Países Baixos,	Holandês
#Inglaterra,	Inglês
#Polônia,	Polonês
#Irlanda,	Irlandês
#Eslováquia,	Eslovaco
#Albânia,	Albanês
#Chile,	Chileno
#Alemanha,	Alemão
#Áustria,	Austríaco
#Itália,	Italiano
#Noruega,	Norueguês
#Suíça,	Suíço
#Malta,	Maltês
#Israel,	Israelense
#Moldávia,	Moldovan
#Colômbia,	Colombiano
#Bulgária,	Búlgaro
#Macedônia,	Macedônio
#Croácia,	Croata
#Dinamarca,	Dinamarquês
#Islândia,	Islandês
#França,	Francês
#cor,	cores
Criança me lembra cor amor arco íris rosas doce de brigadeiro tintas das cores vermelha laranja azul amarelo  .	3	
Ele tem varias cores vc só me diz qe cor vc qr	2	
Ai sao varias cores esses da promoção ou só uma cor	1	
Antigamente as eram de cor normal hoje em dia são das cores do Palmeir	1	
As cores do papel crepom podia ser dessa cor	1	
E por kanto fica N terá de outras cores Eu sou mulher mas na gosto d cor d rosa	1	
E sempre de duas cores nunca de uma cor so  .	1	
Eii gata ele diss q nao vai ter nem uma vermelha ela se atrapalhou na cor rsrsr ai pedi outras cores quand chegar vc olha ai ja passei pedidos foi ao ate as	1	
Elas sao fabricadas nas cores preta azul marinho verde lodo bege roso Bb na cor do jeans Azul bic	1	
Ele falou que o do mlk pode ser a msm cor desse ai se não tiver pra vc mandar as cores que tem pra ele escolher Blz	1	
Ja q vc ta me mandado de duas cores quero tds da mesma cor	1	
Kit Margaridas mm cores dourada prata branca furta cor azul rosa pink vermelhaTotal  .	1	
Legal para meu quarto vai ter essas cores todas mas para cozinha pode ser uma cor que gostes	1	
Meu amor se vc nao sabe tem varias cores de mestruacao kd cor tem signifaco	1	
Nao tem outras cores Onde ta d branco ser outra cor	1	
No lugar da roupa da madrinha quero colocar uma Paleta com as cores ai cada uma escolhe a cor	1	
O bernas não é pk a cor é o azul normal o Gonçalo tbm não é pk as cores é vermelho	1	
Os copos serão nessas cores me mandem no meu pv a cor q cada um de vcs quer pfv ainda hoje	1	
Quero comprar umas sapatilhas na Gonçalves umas aire force mas tem quatro cores do msm modelo e eu nao sei que cor trago  .	1	
Quero trocar as cores do arco íris pela cor dos teus olhos  .	1	
Sim bom sabe sexo que ai tem mais cores ou você que essa cor mesmo	1	
Veja ai direitinho as outras cores e modelos q lhe mandei por q da outea vez veio uma cor trocada	1	
com uma só cor ou só com duas cores  .	1	
#sonho,	sonhos
Nunca renuncie a um sonho mesmo que ele pareça impossível pois quando os sonhos morrem eles apodrecem dentro de nós  .	10	
Volte a sonhar Se por um tempo a dor te fez parar Volte a sonhar Deus ainda realiza sonhos Volte a sonharDeus ainda realiza sonhosDeus ainda realiza sonho	5	
As bolas de papel na cabeça os inúmeros diários para se corrigir as críticas as noites mal dormidas Tudo isso não foi o suficiente para te fazer desistir do teu maior sonho tornar possíveis os sonhos do mundo  .	3	
Então Ta olha ai nois dnovo Cm mais um mês de namoro Nao eh o namoro dos sonhos mais eh o meu sonho que esta cm a gente entao parabéns pra nos ne  .	2	
Mlds realizei meu sonho que dizer um dos meu sonhos	2	
Que em seu coração a melodia da beleza do amor da delicadeza e da alegria cante e te inspire Feliz aniversário amor Que você venha ser feliz cada dia q ser passa só tenho q agradece a Deus por ter colocado uma pessoa tão especial na minha vida te amooo neguinha que todos os seus sonhos venha ser realiza e que nesse sonhos eu esteja junto TAMBÉM para nós conquista todos os nossos sonho pretinha completo em tá ficando velha em mas não desanime pos isso significa que você já tem mas experiência no mundo ne  .	2	
Que todos os seus sonhos se transformem em realidade O meu maior sonho já se realizou que era ter uma filha tão especial como você Feliz Aniversário é o desejo da sua mãe que ama muito você RelacionadasVocê é minha alegriaQuando você nasceu filha uma alegria imensa tomou conta de mim  .	2	
Tudo q eu queria agora era realizar meus sonhos antes de ser tarde e nao poder visitar esse sonho	2	
Você só não está nos meus sonhos porque eu não sonho tão alto assim	2	
sonho meu amor de irmos dormir agora bem grudadinhos meu amor bem agarradinhos meu amor e do jeitinho que meu marido sempre demonstra minha vida vamos agora imaginar meu amor juntinhos meu amor a noite inteira que estamos dormindo desse jeitinho meu amor pois se Deus quiser logo em breve vamos está realizando esse nosso sonho meu amor assim como os infinitos outros sonhos que temos meu amor minha vida amor da minha vida meu tudo	2	
Ah sim veeey eu sonho com vc direto só que tem uns sonhos que eu não tenho coragem de te contar lkk	1	
Amote imenso querida es a mulher dos meus sonhos e o meu sonho de mulher  .	1	
Beijocas amo te muito amei os sonhos pois tu ja és uma sonho bom	1	
Boa noite princesa linda e maluquinha do meu coração tem uma boa noite com sonhos muito alegres e nada de pesadelos espero que tenhas um sonho estrelas e que acordes preparada para a tua ficha de matemática  .	1	
Boa noite sonho cor de rosa ok é sonhos azuis	1	
Contigo sonho pesadelos com ele sao sonhos	1	
De acordo com psicólogos esse tipo de sonho acontece porque nosso cérebro usa esses sonhos para prestar atenção a algo que ignoramos durante nossas vidas diárias  .	1	
De um sonho pra realidade Mds q medo dos seus sonhos	1	
Digo do colar que significa os sonhos e que realizei o mey sonho	1	
Em quanto uns tem o sonho de ser jogador de futebol etc eu tenho o sonhos de fazer oq quase ninguém da minha família realizou seguir a profissão do meu avô e	1	
Espero que durmas muito bem num sonho cor de rosa num sonho aonde os teus sonhos tornam se realidade onde tudo é possível  .	1	
Espero que não tenhas nenhum pesadelo porque tu não mereces nada disso do mereces ter só sonhos bonitos e perfeitos mas se algum dia tiveres um pesadelo Ou um sonho menos Bom podes sempre desabafar e falar comigo que para ti eu estou sempre disponível es e sempre serás a minha princesa a única que eu verdadeiramente me preocupo eu gosto muito de ti e espero nunca de perder  .	1	
Estas a ser bue fudido estraga te me o sonho de seer social olha q nao se deve estragar oa sonhos de uma criança  .	1	
Eu n sonho um deus como eu realiza sonhos	1	
Isto ate ja me incomoda sonho com ele e ele tmb parece nos sonhos nao é normal	1	
Já faz um tempo que eu mudeiEu não sou mais quem te falouQue o sonho sempre tem um fimE que viver de sonhos não foi bom pra mimNão me esqueci de nada e de ninguémEu vou mudar também	1	
Quando a vida amassa seus sonhos apenas levante e desamasse pq o sonho é uma coisa q vc nunca deve desistir	1	
Que em seu coração a melodia da beleza do amor da delicadeza e da alegria cante e te inspire Feliz aniversário amor Que você venha ser feliz cada dia q ser passa só tenho q agradece a Deus por ter colocado uma pessoa tão especial na minha vida te amooo neguinha que todos os seus sonhos venha ser realiza e que nesse sonhos eu esteja junto TAMBÉM para nós conquista todos os nossos sonho pretinha completo	1	
Que em seu coração a melodia da beleza do amor da delicadeza e da alegria cante e te inspire Feliz aniversário amor Que você venha ser feliz cada dia q ser passa só tenho q agradece a Deus por ter colocado uma pessoa tão especial na minha vida te amooo que todos os seus sonhos venha ser realiza e que nesse sonhos eu esteja junto TAMBÉM para nós conquista todos os nossos sonho amor completo em tá ficando velha em mas não desanime pos isso significa que você já tem mas experiência no mundo ne  .	1	
Que sonhos Alguma vez existiu algum sonho sem ser meu Beijinhos nao te aborrecas mais	1	
Que todos os seus sonhos se transformem em realidade O meu maior sonho já se realizou que era ter uma filha tão especial como você Feliz Aniversário é o desejo da sua mãe do coração que ama muito você Lúcia Lima	1	
Que todos os seus sonhos se transformem em realidade O meu maior sonho já se realizou que era ter uma filha tão especial como você Feliz Aniversário é o desejo da sua mãe que ama muito você	1	
Que todos os seus sonhos se transformem em realidade O meu maior sonho já se realizou que era ter uma filha tão especial como você Feliz Aniversário é o desejo da sua mãe que ama muito você Mensagens de Aniversário para Filha RelacionadasVocê é minha alegriaQuando você nasceu filha uma alegria imensa tomou conta de mim  .	1	
Que todos os seus sonhos se transformem em realidade O meu maior sonho já se realizou que era ter uma filha tão especial como você Feliz Aniversário é o desejo da sua mãe que ama muito você RelacionadasVocê é minha alegria	1	
Que todos os seus sonhos se transformem em realidade O meu maior sonho já se realizou que era ter uma filha tão especial como você Feliz Aniversário é o desejo da sua mãe que ama muito você Te amo vc só me orgulho te amo minha filha	1	
SEJA O DONO DO SEU DESTINO Não deixem para amanhã o sonho que você pode realizar hoje Hoje é o melhor dia Agora é a melhor hora Não deixe que digam e decidam qual é o melhor sonho e o melhor futuro para você Você sabe o que é melhor para você Seja você o dono do seu destino Busque a realização dos seus sonhos obstáculo são desafios que torna o sonho mais gostoso de ser conquistado  .	1	
Se teu sonho parece impossível agradece a Deus pois dos sonhos mais impossíveis nascem as vitórias mais belas	1	
Sim nossa esses sonhos são d pq tipo são algumas coisas são só possíveis de fato no sonho kkkk	1	
Tava tendo uns sonhos aqui nao era bem um sonho ne e sim tava voltando ao passado e analisando coisas que nao percebi antes	1	
Tds os sonhos que ja tive com vc nao um sonho bagunçado parece see real mas quando eu acordo não me lembro bem mais fico com a sensação	1	
Tipo sonhos com cenas i apartir do sonho vejo a dificuldade que irei passar i acredita ate hj acertei	1	
Torne seus sonhos em metas e depois que realizar esse sonho	1	
esse é o meu grande sonho nunca desistas dos teus sonhos por causa das pessoas minha ex tmbm queria que desistisse do meu sonho mas nao desisti por causa dela	1	
eu tenho muito dificultade para lembrar os sonhos Eu não sei se sonho ou não  .	1	
que desabrochou numa estrelae que veio até nós num lindo sonho E ainda bem que são amor porque flores estrelas ou sonhos mais cedo ou mais tarde terminam  .	1	
quero lhi pedir desculpa por tudo que Aconteceu na nossa vidas dos meus erros nao que esteja voltado ao passado mais nos estamos perto de outro ano Entao quero tudo mudado como pra vc e pra mim fiquei sim com raiva de vc por causa do nene mais esquece eu desejo tudo de bom pra vc quero que esse ano seja um ano de renovo que esse ano vc possa conquista seu sonhos nunca disista do sei grande sonho de tocar pra fora de te seu lugar  .	1	
só tu meu amor para me deixares sem palavras a sorrir e a chorar ao mesmo tempo eu é q agradeço por td meu amor por seres quem és se tu não és uma pessoa fácil eu muito menos eu sei disso mas quando se trata de ti o ciúme vem logo ao de cima e de cabeça quente digo e faço coisas que não devia eu sei q errar é humano mas quando fico mais calma é q sei q sou estupida cntg e tu não mereces q seja assim se o amor for mesmo verdadeiro essas tempestades nunca irao nos meter abaixo Sim meu amor isso é o que mais quero na minha vida estar cntg a minha vida toda eu vc os nossos filhos e os nossos gatinhos esse dia irá chegar sim é o que pretendo realizar um dia e sim este é outro sonho q quero realizar cntg tenho vários sonhos e tu sbs q sim mas o mais importante é estar ao teu lado és o homem da minha vida meu bb lindo Amo te mt mt mt mt mt mt meu nego perfeito beijão enorme meu anjo	1	
É a segunda vez que eu sonho com o Lucas e nesses dois sonhos ele tbm me abraça SLK kk	1	
#manga,	mangas
Tambm nao curto as cenas das mangas mas olha e se desses uma camisola de manga curta	1	
Traga umas a mangas verdes amor quelo manga	1	
#elefante,	elefantes
#macaco,	macacos
#águia,	águias
#mão,	mãos
Somente quem vê a mão de Deus em todas as coisas pode colocar todas as coisas em suas mãos  .	8	
Sempre estarei aqui para segurar sua mão quando você ameaçar cair e se minhas mãos não conseguirem te segurar por muito tempo encontro forças de onde eu puder para te levantar  .	4	
Sempre estarei aqui para segurar a tua mão quando tu ameaçares cair e se minhas mãos não conseguirem te segurar por muito tempo encontro forças de onde eu puder para te levantar  .	3	
Quero as suas asas abraçando meu corpo e me fazendo esquecer que a vida já foi tão dura a ponto de eu me perder no mais infinito breu de mim mesmo sentir o toque suave das suas mãos sobre as minhas pálpebras enquanto desce sua mão por minhas lágrimas e sussurra no meu ouvido algo que vai direto ao meu coração e me faz ter novamente a fé em que sempre acreditei  .	2	
Arfo coloco uma das minhas mãos em sua nuca e com a outra coloca a mesma em cima da mão do maior  .	1	
Atsushi Caos Tiro as mãos dela do meu ombro e seguro a mão dela Fica tranquila  .	1	
Cada vez que eu olho pra vc cada vez que eu coloco a sua mão entre as minhas mãos percebo que tenho comigo a mais doce das princesas a mais bela de todas as Cinderelas  .	1	
Como eu queria dobrar aquela esquininha com você de mãos dadas com os pêlos penteados de lado da sua mão  .	1	
Desculpa la nao ter falado ctg qdo a tua veio me dar o tlm eu tava a limpar o fogão tava com as mãos molhadas e dps qdo ia falar ctg a tua mão trilhou o gato na porta	1	
Ele perguntou se vc tava namorando E vc perguntou se ele queria pegar vc e dopis disso vc falou num sei oq q ele tava consando sua mão querendo fazer alguma coisa isso qr dizer q vc tavam de mãos dadas E depois vc pediu nud pra ele e vc mandou q tem a msg apagada ai	1	
Entre becos e vielasEntre a paz e o perigoVocê ali sorrindoDe mãos dadas comigoA gente se abraçaMinha mão no seu cabelo eu ponhoMas adivinha eu acordei era só um sonho Tenho até medo de dormir pra não lembrar	1	
Foi através daquela dança sim em meio a música e aos movimentos que senti Tua mão tocar minha face Enquanto meus olhos fechados estavam e minhas mãos envolvidas na melodia senti Tu dançares comigo  .	1	
Isso deixei nas mãos de Deus pq eu mesma larguei de mão Eu não vou adoecer por alguém q nem merece ser um problema para mim	1	
Ixxxii amiga minha mãos to doendo mt tb lavei todas cuecas na mão hj	1	
Limpar bem as mãos ao pegar nela e manter a mão dela bem limpa pq ela pode levar na boca	1	
Oh binha eu só to com dois G em mãos e num sei se na mão de minha colega tem	1	
Olha eu cansei de por minha mão por isso quero as mãos de Deus	1	
Prepara mãos vamos necessitar de mão de obra barata para a apanha  .	1	
Quando nos aproximarmos de Deus satanás estará por todos os lados tentando nos trazer de volta para seus jogos por que um dia estávamos sendo brinquedos na mão dele mas hoje ele que está sendo brinquedo em nossas mãos e é aí onde temos que se agarrar com Deus e procurar nos Santificar cada vez mais pois satanás nunca Desiste nós seremos levados ao deserto para sermos tentados por satanás como Jesus foi mas em meio a luta em meio a prova	1	
Que a mão ensanguentada de Jesus mãos feridas de Nosso Senhor Jesus Cristo percorra por todo o corpo do Lucinho levando a cura total do seu cérebro todo desinchaço toda hemorragia tudo aquilo quem estiver no corpo dele que seja removida com o poder da Cura da mão de Nosso Senhor Jesus Cristo que o sangue de Jesus percorra por todo soro que estiver passando pelo corpo dele lavando todos os órgãos dele que ele acorde sobre o poder de Jesus perfeito em nome de Jesus eu creio e já	1	
Quero calo nas mãos de tanto ficar de mão dada	1	
Somente quem vê a mão de Deus em todas as coisas pode colocar todas as coisas em suas mãos	1	
Ver ele me pedindo a mão para andar de mãos dadas com ele foi fofo	1	
jimin vejo partes aterrorizantes e logo ponho a mão no rosto e logo me encolho todo kookie Já passou pergunto Com as mãos Ainda no rosto	1	
pego sua mão e sigo a piscina de mãos dadas	1	
sentia suas mãos em minha cintura coloco a mão do lado de seu corpo para não deixar meu peso todo em você e a outra vai em seu rosto o acariciando perdendo alguns segundos o observando até que acordo e tento sair de cima de você  .	1	
É claro e babar né fiota Eu não vou andar com mãos dadas não é com a mão na bunda	1	
#garrafa,	garrafas
As nossas bebidas as garrafas que usamos no minimo e euros a garrafa	1	
Segue a lista pacote com fraldas prato com salgados Liliane pacote com fraldas garrafas de refrigerantes Dayane pacote com fraldas pacote com lenços umedecidos garrafa de refrigerante Judite pacote com fraldas prato com salgados pacote com fraldas garrafas de refrigerantes Maria pacote com fraldas pacote	1	
Segue a lista pacote com fraldas prato com salgados Liliane pacote com fraldas garrafas de refrigerantes Dayane pacote com fraldas pacote com lenços umedecidos garrafa de refrigerante Judite pacote com fraldas prato com salgados pacote com fraldas garrafas de refrigerantes Maria pacote com fraldas pacote com lenços umedecidos garrafa de refrigerante Nalva pacote com fraldas prato com salgados pacote com fraldas garrafas de refrigerantes pacote com fraldas pacote com lenços umedecidos garrafa de refrigerante Vera Lúcia pacote com fraldas prato com salgados pacote com fraldas garrafas de refrigerantes pacote com fraldas pacote com lenços umedecidos garrafa de refrigerante pacote com fraldas prato com salgados pacote com fraldas garrafas de refrigerantes pacote com fraldas pacote com lenços umedecidos garrafa de refrigerante pacote com fraldas prato com salgados pacote com fraldas garrafas de refrigerantes pacote com fraldas pacote com lenços umedecidos garrafa de refrigerante pacote com fraldas prato com salgados pacote com fraldas garrafas de refrigerantes pacote com fraldas pacote com lenços umedecidos garrafa de refrigerante pacote com fraldas prato com salgados pacote com fraldas garrafas de refrigerantes pacote com fraldas pacote com lenços umedecidos garrafa de refrigerante pacote com fraldas prato com salgados pacote com fraldas garrafas de refrigerantes pacote com fraldas pacote com lenços umedecidos garrafa de refrigerante pacote com fraldas prato com salgados pacote com fraldas garrafas de refrigerantes pacote com fraldas pacote com lenços umedecidos garrafa de refrigerante Carol	1	
Segue a lista pacote com fraldas prato com salgados pacote com fraldas garrafas de refrigerantes Dayane pacote com fraldas pacote com lenços umedecidos garrafa de refrigerante pacote com fraldas prato com salgados pacote com fraldas garrafas de refrigerantes pacote com fraldas pacote com lenços umedecidos garrafa de refrigerante pacote com fraldas prato com salgados pacote com fraldas garrafas de refrigerantes pacote com fraldas pacote com lenços umedecidos garrafa de refrigerante pacote com fraldas prato com salgados pacote com fraldas garrafas de refrigerantes pacote com fraldas pacote com lenços umedecidos garrafa de refrigerante pacote com fraldas prato com salgados pacote com fraldas garrafas de refrigerantes pacote com fraldas pacote com lenços umedecidos garrafa de refrigerante pacote com fraldas prato com salgados pacote com fraldas garrafas de refrigerantes pacote com fraldas pacote com lenços umedecidos garrafa de refrigerante pacote com fraldas prato com salgados pacote com fraldas garrafas de refrigerantes pacote com fraldas pacote com lenços umedecidos garrafa de refrigerante pacote com fraldas prato com salgados pacote com fraldas garrafas de refrigerantes pacote com fraldas pacote com lenços umedecidos garrafa de refrigerante pacote com fraldas prato com salgados pacote com fraldas garrafas de refrigerantes pacote com fraldas pacote com lenços umedecidos garrafa de refrigerante pacote com fraldas prato com salgados pacote com fraldas garrafas de refrigerantes pacote com fraldas pacote com lenços umedecidos garrafa de refrigerante pacote com fraldas prato com salgados pacote com fraldas garrafas de refrigerantes pacote com fraldas pacote com lenços umedecidos garrafa de refrigerante pacote com fraldas prato com salgados pacote com fraldas garrafas de refrigerantes pacote com fraldas pacote com lenços umedecidos garrafa de refrigerante pacote com fraldas prato com salgados Solange	1	
Segue a lista pacote com fraldas prato com salgados pacote com fraldas garrafas de refrigerantes Dayane pacote com fraldas pacote com lenços umedecidos garrafa de refrigerante pacote com fraldas prato com salgados pacote com fraldas garrafas de refrigerantes pacote com fraldas pacote com lenços umedecidos garrafa de refrigerante pacote com fraldas prato com salgados pacote com fraldas garrafas de refrigerantes pacote com fraldas pacote com lenços umedecidos garrafa de refrigerante pacote com fraldas prato com salgados pacote com fraldas garrafas de refrigerantes pacote com fraldas pacote com lenços umedecidos garrafa de refrigerante pacote com fraldas prato com salgados pacote com fraldas garrafas de refrigerantes pacote com fraldas pacote com lenços umedecidos garrafa de refrigerante pacote com fraldas prato com salgados pacote com fraldas garrafas de refrigerantes pacote com fraldas pacote com lenços umedecidos garrafa de refrigerante pacote com fraldas prato com salgados pacote com fraldas garrafas de refrigerantes pacote com fraldas pacote com lenços umedecidos garrafa de refrigerante pacote com fraldas prato com salgados pacote com fraldas garrafas de refrigerantes pacote com fraldas pacote com lenços umedecidos garrafa de refrigerante pacote com fraldas prato com salgados pacote com fraldas garrafas de refrigerantes pacote com fraldas pacote com lenços umedecidos garrafa de refrigerante pacote com fraldas prato com salgados pacote com fraldas garrafas de refrigerantes pacote com fraldas pacote com lenços umedecidos garrafa de refrigerante pacote com fraldas prato com salgados pacote com fraldas garrafas de refrigerantes pacote com fraldas pacote com lenços umedecidos garrafa de refrigerante pacote com fraldas prato com salgados pacote com fraldas garrafas de refrigerantes pacote com fraldas pacote com lenços umedecidos garrafa de refrigerante pacote com fraldas prato com salgados pacote com fraldas garrafas de refrigerantes pacote com fraldas pacote com lenços umedecidos garrafa de refrigerante Dyana pacote com fraldas prato com salgados pacote com fraldas garrafas de refrigerantes Iara	1	
coloque kg de terra em cada garrafa e pressione para que fique relativamente compactada a terra deve ficar abaixo do nível do corte feito em cada garrafa Corte a parte inferior das outras três garrafas de plástico transparentes e faça furos em suas laterais para amarrar um arame em cada  .	1	
#mulher,	mulheres
Uma mulher pergunta a um mestre chines Mestre por que um homem que faz sexo com varias mulheres é chamado de campeao e Uma mulher que faz sexo com varios homens é chamada de vagabunda E o mestre responde filha  .	6	
A amizade entre homem e mulher é mais verdadeira que uma amizade entre mulheres e a nossa é a prova disso meu anjo Apesar de tudo tamos mais fortes que nunca Amote muito silvarasga	4	
Defender os Direitos das mulheres não é querer que a mulher deixe de ser mãe de ser dona de casa muito menos não desejar do homem gentileza e cavalheirismo  .	3	
Feliz dia da mulher para todas as mulheres maes esposas donas de casa	3	
oh mulher cuidate ok ah mulheres mais bonita e gostosas doque tu tu tas maluca eu mesma no digo que so gostosa bonita linda no gosto de me achar como tu	3	
A amizade entre homem e mulher é mais verdadeira que uma amizade entre mulheres e a nossa é a prova disso meu anjo Apesar de tudo tamos mais fortes que nunca	2	
A amizade entre homem e mulher é mais verdadeira que uma amizade entre mulheres e a nossa é a prova disso meu anjo Apesar de tudo tamos mais fortes que nunca Amote muito	2	
A amizade entre homem e mulher é mais verdadeira que uma amizade entre mulheres e a nossa é a prova disso meu anjo Apesar de tudo tamos mais fortes que nunca Amote muito sil	2	
Feliz dia da mulher para todas as mulheres do grupo  .	2	
Na inteligencia da maioria dos homens e de algumas mulheres nao tem nocao uma mulher transexual gostar de outra mulher  .	2	
Parabéns à todas as mulheres pelo dia de março dia internacional das mulheres em especial a minha mãe que é meu grande exemplo de mulher de mãe de amiga de companheira e representa toda a força de superaçao nos desafios que a vida nos impõe  .	2	
muita cura e aprendizados compartilhados em cada carta que lee Gratidão mulher semente flor e fruto Abraço você e a cada uma das mulheres de	2	
A amizade entre homem e mulher é mais verdadeira que uma amizade entre mulheres e a nossa é a prova disso meu anjo Apesar de tudo tamos mais fortes que nunca Amote muito silvar	1	
A minha mulher e a mais linda das todas as mulheres	1	
A mulher da minha vida feliz dia das mulheres mae te amo muito meu maior tesouro  .	1	
A todas as mulheres do grupo feliz dia da mulher hoje é um dia de realizações desejo tudo de bom vcs são mais guerreiras vcs é o motivo de nos homens estarem sempre sorrindo e as mulheres da minha vida um grande e enorme abraço MULHERES DA MINHA VIDA minhas irmãs minhas mães minhas sobrinhas primas minhas alunas e minha mãe que Deus a tenha e minha namorada que me aguenta quando estou com ela	1	
A todas as mulheres do grupo feliz dia da mulher hoje é um dia de realizações desejo tudo de bom vcs são mais guerreiras vcs é o motivo de nos homens estarem sempre sorrindo e as mulheres da minha vida um grande e enorme abraço MULHERES DA MINHA VIDA minhas irmãs minhas mães minhas sobrinhas primas minhas alunas e minha mãe que Deus a tenha e minha namorada que me aguenta quando estou com ela e as minhas colegas da faculdade pois tenho um enorme carinho por cada uma delas	1	
A todas as mulheres do grupo feliz dia da mulher hoje é um dia de realizações desejo tudo de bom vcs são mais guerreiras vcs é o motivo de nos homens estarem sempre sorrindo e as mulheres da minha vida um grande e enorme abraço MULHERES DA MINHA VIDA minhas irmãs minhas mães minhas sobrinhas primas minhas alunas e minha mãe que Deus a tenha e minha namorada que me aguenta quando estou com ela e as minhas colegas da faculdade pois tenho um enorme carinho por cada uma delas  .	1	
A todas as mulheres guerreiras do meu zap um feliz dia da mulher	1	
Além de ser umas mulheres lindas do da mulher bonita kkkk	1	
Amizade entre mulheres e difícil pq ne como dizem mulher e complicada mas Cleiciane tinha todos e muitos problemas e nem sempre eu tava perto eu me dediquei essas últimas semanas a ela pq ela tava indo pra longe e como ela ja mal falava as coisas de longe e que nao vai msm mas esse tempo todo eu nao conseguia parar de pensar em vc em como você tava o que tava fzd se tava bem se tava com raiva de mim ou chateado e sem ver a hr de a gente voltar a se falar normal pq tava doendo dms longe de vc dms msm e mais ainda quando vc tava sendo frio tentando manter uma distancia mas eu sabia que nao era pra desistir de vc nao era pra desistir da gente to muito triste por tudo isso com sdd pq Cleiciane foi hj de vdd e preocupada se to com catapora ou n	1	
Aquele que conheceu apenas a sua mulher e a amou sabe mais de mulheres do que aquele que conheceu mil  .	1	
As mulheres trazem comida e homem bebidas ou entao homem e mulher	1	
Assas eu como mulher que gosto de mulheres	1	
Boa noite abençoada Para todas nós mulheres sabemos que somos guerreiras somos corajosas choramos e logo enxugamos nossa lágrima e partimos para o ataque não temos tempo quente nem frio somos uma leoa enquanto não conseguimos alcançar nosso sonho não páramos de lutar pelos nossos objetivo Boa noite mulheres poderosas dizem que a mulher e sexo flagil Que mentira absurda super mulheres valorosas Boa noite abençoada Para todas vocês um grande homem Para ser um homem tem sempre uma Esposa valorosa beijos meninas	1	
Bom dia feliz dias das mulheres pra vc sua guerreira trabalhadora dedicada atenciosa e uma grande e linda mulher	1	
Chegou a mulher que queria de a bunda vezes no mesmo dia e agr tem quatro mulheres no banheiro uma ta fazendo o teste de gravidez elas tão correndo pq o corno ta batando no cara	1	
Claro que interessa em vez de andares a procura de outras mulheres devias satisfazer a mulher que tens em casa nao e	1	
Desculpa vou dizer a verdade so uma mulher e gosto de mulheres	1	
Desejo a todas as mulheres um feliz dia da mulher claro que todos os dia é o dia de vcs mais mesmo desejo bombons chocolate flores e um dia cheio de alegria	1	
Desejo a todas as mulheres um feliz dia da mulher claro que todos os dia é o dia de vcs mais mesmo desejo bombons chocolate flores e um dia cheio de alegria vocês merecem  .	1	
E Feliz dia da mulher para todas as mulheres do mundo k somos mães mulheres e Donas de casa e continuamos aqui firmes é fortes  .	1	
E eu nao quero perder a mulher da minha vida Pk mulheres como tu tao escaças	1	
E expressente proibido entrar em pv de mulheres sem pedir dentro do grupo de houver de algum homem entrar direto no pv de alguma mulher podem falar aqui no grupo que serao retirados do grupo na hora ok mulheres	1	
E vc e mas uma mulher da minha vida tenho mulheres e princesa amor todas	1	
Ei mas tu ja pesquisou sobre isso pesquisa mulher no YouTube relatos de mulheres talvez tem algum relato que te ajude  .	1	
Ela é a cheia de graça é bendita entre todas as mulheres da terra é a mulher vestida de sol tendo a lua debaixo de seus pés e uma coroa de doze estrelas ela é a humilde escrava do Senhor ela é a mãe de Deus ela é a nossa mãe ela é simplesmente MARIA Obrigado meu Deus por nos ter dado uma mãe tão maravilhosa  .	1	
Eu não gosto de tds as mulheres não tem como mas se vou xingar uma mulher eu me policio em não reproduzir coisas machistas contra elas  .	1	
Eu não posso dizer que sou a mulher mais feliz do mundo porque quero acreditar que outras mulheres têm a mesma sorte de viver um amor como o meu  .	1	
Eu por exemplo nasci com orgãos femininos me identifico como Gender Fluid não fico muito no papel feminino me visto como quero odeio sexismo eu fico entre os dois porém me sinto bem com o meu corpo e me identifico como mulher e minha orientação sexual é bissexual gosto de homens e mulheres de pessoas falo  .	1	
Eu sei que não es amigo pois é mas ele nao quer ir pk ele diz que tem mulher e filha e nao vou fazer noitadas com os amigos e deixando as mulheres em casa porra ele deu me uma boa explinta	1	
Evento especialmente para as mulheres comemorar neste dia a dádiva de ser mulher  .	1	
Faço com duas mulheres e um homem mais mulher eu não fico	1	
Feliz dia da mulher a todas as mulheres do mundo	1	
Feliz dia da mulher para nós filha ke somos mulheres guerreiras lutadoras e felizes do nosso jeitinho	1	
Feliz dia da mulher para todas as mulheres Beijinhos	1	
Feliz dia da mulher para todas as mulheres do meu facebook e um dia das mulheres especial para as mulheres da minha vida a minha filha a minha mãe e também a minha mana Karla Almeida amo vos muito  .	1	
Feliz dia das mulheres pra mim vc é a melhor mulher do mundo	1	
Feliz dia das mulheres pra senhora tia que é uma mulher maravilhosa	1	
Feliz dia internacional da mulher amor te amo vc e julia sao as mulheres da minha vida amo vcs todos	1	
#melão,	melões
#nuvem,	nuvens
#leão,	leões
#rato,	ratos
Os ratos estavam armados até os dentes hein O que os ratos fazem hein movimentar uma equipe de policiais isso é só pra rato ninja kkk	2	
#porco,	porcos
Pois mas ha gajos mais porcos do que o próprio porco	1	
#asno,	burros
#máquina,	máquinas
#estrada,	estradas
Demorou vc chegar ai a estrada ta ruim Meu pai falou q as estradas tao ruin	1	
andam nas mesmas estradas que nós empatam o transito e não entendem nada do código da estrada além que a informação escrita na berma da estrada não a entendem  .	1	
#rato,	ratos
Os ratos estavam armados até os dentes hein O que os ratos fazem hein movimentar uma equipe de policiais isso é só pra rato ninja kkk	2	
#cebola,	cebolas
#serpente,	cobras
#carro,	carros
Oi boa tarde vi a loja de carro no face gostei dos carros eu tenho um	3	
Pois e entao eu chateada porque nao conseguia meter meu bebê e a chover estava me a borrifar para os outros carros bati lhes com a porta para aprenderem a estacionar o carro	2	
tava dando uma pausa do trabalho dai meu pai tava vendo um programa sobre carros e pa nois tava conversando sobre o carro dai eu e ele começamos a rir pq tinha cara enorme dentro do carro relativamente pequenokkkkjjkkkso eu e ele pra rir de umas merda besta assim	2	
A Prefeitura esta pedindo a placa dos carros e nomes dos funcionários que vem pra Arraial de carro  .	1	
Ainda nao havia o segundo carro da casa agora que na carros na casa ainda nao recebi nenhuma proposta	1	
Depois diz o nome do carro se eu receber um siludar de carros experimento esse	1	
Depois tivemos a falar dos outris carros e assim e disse que enquanto o carro tivesse a compor que o zequinha se calhar ia andar no corsa para ir buscar os alunos	1	
Desculpa não foi porque não tinha carro pra ir somente agora que os carros estaõ indo pra canoa e já está tarde pra eu sair	1	
Dia mana olha tu ontem disses tês aonde vais buscar o carro e um STAND vez se ele tem um site para ver quais o carros ele tem la ok Obg	1	
E depois de meteres esse carro no complexo sai e compra motas para meter numa garagem para tirares esses carros do complexo bro	1	
Entra no carro para eu te amostar os outros carros	1	
Eu não queria despachar o carro vou ver se compro um Mercedes antigo eu gosto de carros clássicos	1	
Kkkkkkkkk e serio Esses carros anda que só meu pai foi so anda com o carro de joel também corre dms e meu pai e louco todo mundo sabe kkkkkkk so anda que nem um aviao	1	
Nao consigo desde pequeno que nao consigo dromir em carros foi daqui a Bélgica de carro sem dormir	1	
Nao percebo muito de carros mas se o carro estiver bom deve ser um bom negocio	1	
O carro nao deve ser dele e arma se com os carros dos outros	1	
O vernon foi obrigado a parar porque uns carros estavam parados pk um carro tinha se atravessado no caminho e estava lá parado	1	
Oh isso é como tudo tambem nao tenho assim tanta segurança a andar de carro quando andam muitos carros na rua ya uma coisa é com instrutor outro é sem	1	
Oie tudo bem Deixa eu te falar pro seu carro nao ficar parado o brown pegou um funileiro aqui pra trabalhar em outros carros e o brown vai trabalhar no seu mas vou precisar de dinheiro ate sabado pra pg o funileiro	1	
Os mecenicos remendam isso cm material adequado a carros a pressao que o peso do carro faz nos pneus e mt maior a que uma bicicleta faz nos pneus por isso n convem usar cenas de bicicletas em carros é bué perigoso	1	
Pq o cara do guincho q foi pegar o carro da mulher disse que ele achava q era pt nos dois carros	1	
Preciso de um lavador de carros Nao estou conseguindo falar com Cesinha Bike Mas q pegue o carro aqui comigo	1	
Som alto de casa ou carro nem se fala mas como vão cobrar se um dos mais famosos carros de som da cidade só faz proganda no último volume Passeio é para pedestre mas aqui passeio serve para as mesas dos bares e restaurantes seja na orla da lagoa ou no centro da cidade  .	1	
Tp tava todo fdd fomos andar de carrinhos e tava no carinho e meti me casaco no outro banco como tava a bater nos outro carros o casaco tava quase a cair parei o carro para por direito vem um gajo bateu d traz e bati com a boca no volante	1	
Vdd ah por enquanto qero uma so pra pdr ir tramp e pr dar uns role ai mas pra frente vou compr um carro e uma outr moto maior tbm sou apaixonad por carros rebaixados sb	1	
carro rebaixando e uma paixão que n da pra explicar por carros rebaixado	1	
mas agr expliquem me uma cena pq que só vai dois carros e vai tudo apertado no carro da dona rosario por exemplo quando ha mais carros de pais que podem ir á Maria e levar atletas	1	
#construção,	edifícios
#homem,	homens
Toda mulher precisa de um cara que seja homem o suficiente para provar que nem todos os homens são iguais	9	
O coração de mulher er diferente dos corações dos homens a mulher Ama so um homem i o homem ama uma duas três  .	3	
Toda mulher precisa de um cara que seja homem o suficiente para provar que nem todos os homens são iguais Ser feliz não é apenas resumir nossa vida em bons momentos  .	3	
Mulheres que acham que corpo bonito segura homem aqui vai meu recado entenda uma coisa sobre os homens homens querem uma parceira / que fecha com ele sempre e só pra deixar falado corpo bonito não cozinha corpo bonito não limpa a casa corpo bonito apenas da prazer nos homens então queridinhas parem de colocar silicone e se preocupar com unha com roupa bonita porque isso agrada os homens mais não do tanto que ele te queira como mulher mulherão da porra é aquela que além de bonita e tem corpão	2	
Todos os habitantes da aldeia e os homens honrados que tratavam com ele vendo um homem assim chamavam no amigo de Deus uns o amavam como a filho outros como a irmão  .	2	
Ahaha mas o meu n e bem como tu deves estar a pensar deves estar a pensar naqueles que tem tics de pita o meu primo n ele é normal continua a ser um homem mas só que tmb gosta de homens	1	
Ahahaha mesmo sendo homem sei como andam os homens de hj em dia	1	
Alguns cuidados a tomar com a falsidade ou com o homem falso Não se associar com homens falsos Salmos  .	1	
Após ta ruim pra me pq eu hoje percebi que eu sou uma pessoa horrível um ser humano que vivo entre dois homens que n respeito meu namorado do vivo de liberdade com outro homem só peço favores a outro homem	1	
Deves ser isso que o homem que andas te te deixou por falas como todos os homens e que lhes das confiança  .	1	
E digo vos que todo aquele que me confessar diante dos homens também o Filho do homem o confessará diante dos anjos de Deus  .	1	
E dps havia um site que era uma criança q fazia isso com homens adultos tp cada video com um homem diferente e a foto do site era ela com uma coisita do homem na boca e eu era tao inocente que smp pensei q fosse um chupa chupa	1	
Enquanto os Orixas Orisa são os intermediários entre os homens e Olodumare o Orí é o intermediário entre o homem e seu Orixa  .	1	
Er pq ner todos homem quer não gosta de asumim um mulher tem homens qer sou qer usa isso jogar fora	1	
Este é o homem que me acusa de ter varios homens pra eu me sentir rebaixada quando ele tem uma mulher assumida em luanda e ainda me diz que eu nao posso ir porque tenho homens quem nao quer ir sou eu pois nao quero morrer assassinada como ja disse a tua namora que assim que eu puser isso pes em luanda manda me matar	1	
Eu amo homem forte dos olhos puxados tenho uma queda por homens assim	1	
Eu discordo depende do caráter do homem na minha opinião o homens e as mulheres são iguais	1	
Eu sonhei que eu tu o Speedy e o Dinis o irmao só Speedy tavamos a jogar futebol e de repente aparecem homens encapuçados e levaram o Dinis Eu e tu fomos atraz deles e o Speedy foi chamar a mas dele Eles levaram no para debaixo de uma ponte de repente chegou o Speedy e a Angela no carro com a Policia e de repente o Speedy saltou caiu em cima deles e depois eu puxei o Dinis a polícia prendeu os homens Depois tiraram os capuzes aos homens e era mulher e homem	1	
Eu sonhei que eu tu o Speedy e o Dinis o irmao só Speedy tavamos a jogar futebol e de repente aparecem homens encapuçados e levaram o Dinis Eu e tu fomos atraz deles e o Speedy foi chamar a mas dele Eles levaram no para debaixo de uma ponte de repente chegou o Speedy e a Angela no carro com a Policia e de repente o Speedy saltou caiu em cima deles e depois eu puxei o Dinis a polícia prendeu os homens Depois tiraram os capuzes aos homens e era mulher e homem Nos fomos embora e o Speedy ficou la mais o Dinis e a Angela Depois um dos polícias era a Madalena O Speedy ficou com a Madalena e acabou o sonho	1	
Ja que meus pensamentos seriam totalmente voltados para yaois e yaois ou seja apenas homens e como sou homem e tu homem aumentaria	1	
Mas no caso com outros homens q tenham rola eu não sou nada atraente não sou homem e muito menos rola	1	
Mulher não é apenas a beleza estampada a sua face ela tem personalidade de mãe esposa mulher e seu lado profissional além de ser uma ótima dona de casa a mulher tem características seja ela brava sorridente alegre ou chorona ela tem sua expectativa de trazer a todos os homens o sentimento da alegria afinal Mulher tem letras com objetivos que os homens devam entender M MaravilhosaU Ultra morosaL LindaH HumanaE EleganteR Responsável Agora se depare a sua frente a elegância e o poder que cada uma delas tem seja ela da raça que eis devemos o grande respeito e o lado satisfatório de fazer elas felizes afinal o sentimento que elas nos passam é de puro e dedicado amor a cada homem que a agrada afinal elas tem o poder que homens nunca terão na vida Elas são o símbolo do Amor  .	1	
Mulheres que acham que corpo bonito segura homem aqui vai meu recado entenda uma coisa sobre os homens homens querem uma parceira / que fecha com ele sempre e só pra deixar falado corpo bonito não cozinha corpo bonito não limpa a casa corpo bonito apenas da prazer nos homens então queridinhas parem de colocar silicone e se preocupar com unha com roupa bonita porque isso agrada os homens mais não do tanto que ele te queira como mulher mulherão da porra é aquela que além de bonita e tem corpão tem carater personalidade e sabe se da o valor e saiba pelomenos cozinhar e que não tenha nojinho da comida que fica quando vai lava louça sóisso	1	
Nao mete mais esses moves de bife se escreverem demostra que és mais homem que eles ai eles vao ver que aqui tao lidar com homens nao putoa	1	
O Filho de Deus tornou se homem para possibilitar que os homens se tornem filhos de Deus  .	1	
O amor pode ser entre um homem e uma mulher entre dois homens ou duas mulheres  .	1	
Obg por vc me colocar prá fora da sua casa eu achava que vc era um homem mais me enganei vc é igual a todos os homens	1	
Paulo apóstolo não da parte de homens nem por meio de homem algum mas por Jesus Cristo e por Deus Pai que o ressuscitou dentre os mortos	1	
Pois eu sou homem e digo te nunca confies a nos homens primeiro conhece	1	
Pois qual dos homens entende as coisas do homem senão o espírito do homem que nele está assim também as coisas de Deus ninguém as compreendeu senão o Espírito de Deus  .	1	
Porque Homens tj surdos ou ouvi pergunta eu mas homens fala Solteira ou noiva ou casar qual Eu fala sou namorar sim Mas homem conversa nada eu	1	
Porque hoje em dia e muito difícil encontrar homens que queram ter responsabilidade com filhos de outro homem	1	
Pra isso acontecer nao precisa só da atitude do homem hoje no mundo quer vivemos as mulheres espera sempre dos homens  .	1	
Psr e também e muito difícil acha um homem que preste esses homens de hj em dia sao tudo safado	1	
Que poha er essa todo Diia um homem matar mulher deus er mais deixa eu solteira mesmo viu pq esses homens	1	
Sabe o mal do homem e fala pra mulher se vc gostasse De mim msm tu corria atras ai a mulher vai la e corre atras ai o bonitoo do homem fica se achando so pq a mulher ta atras vai entender esses homens agr eu falo se Depende De mim eu vou morre gostando da pessoa mas nao vou atras	1	
Sei qe as vezes é mtoo difícil pra vc por ser homem Mais nem sempre é difícil só pros homens	1	
Tanto com homens como com mulher e um homem	1	
Todos os habitantes da aldeia e os homens honrados que tratavam com ele vendo um homem assim chamavam no amigo de Deus uns o amavam como a	1	
aiii q sotaque feio mds ele é homem queridinho só que gosta de outros homens	1	
de resto sou homem com tudo o que acarreta os homens  .	1	
soU terrível sou nada eu sou e ótimas adoooro fuder essee o diferencial e quando mas sacana melhor não me interessa se fôr homem mulher ou dois homens ou duas mulheres ou sei la quantos der quero e gozar faço pra mim ora minha satisfação pro meu prazer não pra agradar ninguém a não ser a mim mesma mas quem Faz comigo adooooro esse meu lado	1	
É mole oh homem casado e que outra rsrsrs entender os homens	1	
#abacaxi,	abacaxis
#gato,	gatos
Ai você vai mandar uma cantada envolvendo gatos pra sua crusha mas lembra Q NN tem gato	2	
Duras o caralho k se eu sou gato tenho vidas e até um cao tem medo de gatos	1	
Esqueçe eu quero um gato mas aqui ninguem quer gatos	1	
Olha eu sei que tu goatas de gatos mas se fosse eu tinha mandado um arrochada no gato	1	
Os gatos gostam eu tenho gato sei como q é	1	
Tava no onsta e como eu sei q gostas mt de gatos ai tens a coisa mais incrivel que vi um gato a fzr	1	
Ter gatos é quando tu respiras e sai uns ruidos parecidos a um gato a miar	1	
Têm que fazer um vídeo de um gato a dizer eu amo gatos	1	
a Athena come a raçao dos gatos pq ela fica do lado de fora e so compram raçao de gato  .	1	
#pássaro,	pássaros
#vaca,	vacas
Nao estejas a falar com as vacas do teu trabalho por que tu tens uma vaca em casa e mal falas para ela ay de ti  .	1	
Por que e vaca sim e eu amo vacas	1	
Pq ela é uma vaca q vê porno de vacas	1	
Uhhhhhhma vaca feliz uma ilha de vacas felizes	1	
Uma vaca feliz outra vaca feliz uma ilha de vacas felizes andam sempre a passear com vista para o mar um manjar é o seu bem estar uma vaca feliz outra vaca feliz e um leite sem igual	1	
isso sao vacas nao é a mulher com quem dormes ha anos que é vaca até porque nunca fiz nada dessas merdas	1	
#bode,	cabras
#cavalo,	cavalos
Quem nunca perdeu o estribo no meio de uma prova Quem nunca fez uma bolha na mão por causa de um cavalo teimoso Quem nunca caiu do cavalo Quem nunca ficou com a unha do pé roxa por causa de um pisão equino Quem nunca perdeu uma balada pra acordar cedo e competir no dia seguinte Quem nunca deixou de comprar uma roupa nova para adquirir um equipamento hípico Quem nunca chamou seu cavalo de filho Quem nunca foi ao shopping de bota e recebeu vários olhares estranhos Quem nunca pediu pra ver se seu cavalo estava mancando Quem nunca machucou o pé com uma bota nova Quem nunca tomou um banho duchando seu cavalo Quem nunca desistiu antes de entrar na pista mas foi mesmo assim Quem nunca viu um filme só pq tinha cavalos na trama Quem nunca correu atras de um cavalo fujão Quem nunca teve sua roupa suja com baba de cavalo Quem nunca contou segredos para seu cavalo sabendo que ele seria o único que poderia ter certeza que não contaria para ninguém Quem nunca amou seu cavalo	1	
#criança,	crianças
Uma grande mulher e grande profissional esta a sofrer uma grande injustiça Carla chio é uma educadora com o coração do tamanho do mundo suas crianças são suas prioridades todos os dias leva seu coração cheio de amor para criança que nesse dia precise  .	3	
Como é bom ser criança Hoje todos seremos crianças de novoCriança sonha de dia e de noite ama sem preconceito não conhece limites na imaginação e tem um mundo novo a cada dia para descobrir  .	2	
Então Foi tudo muito rápido Sabe Foi uma experiência diária Eu nunca imaginei minha irmã doente sendo que você acha que só acontece com outras pessoas Mas com você jamais eu vi de perto sofrimento de várias criança no hospital conhecir tantas crianças que Passava Por tanto sofrimento pra  .	2	
Essas crianças so por deus msm pq a atitude q vc Ta fazendo e de criança desgraça moss venho la ta desgraçada pra vim aqui de ver e vc fica com essas criançine to com tando Ta sua cara Kleyder se num ta intendendo	2	
A Liria tava em uma pracinha dando comida pras criança e pros pais e e o tobby tava la e brincava com as crianças	1	
A aparencia de criança é porque na realidade as garotas mesmo cm anos parecem crianças parem gente	1	
Acho que as pessoas precisam de mais empatia com os pequenos Tem gente que não suporta criança e só a presença dela incomoda Tem gente querendo proibir crianças em restaurantes e em outros estabelecimentos Fui babá pra pagar a faculdade e muitas vezes levei a menina em lugares pq não podia contar com ninguém para ficar com ela A menina era quietinha mas percebia os olhares de reprovação	1	
Adriana eh uma pessoa q tem uma criança dentro d si e as crianças adoram d brincar pedir p fazer desenhos ajuda na tarefa etc  .	1	
Ai q crianças quietinha o minha criança tbm vai ser assim melhor com essa música do q com choro	1	
Alegria de ser criança é uma felicidade contagiosa parabéns a todas crianças do muido quer Deus guia oa passos delea sempre	1	
Ariani Costa tem jeito pra treinar criança mais nao daquela forma as crianças nao sabem fechar a boca o narir e ainda jogando o bebe de cara dentro da piscina isso machuca ainda mais pra uma pela fina como sao dos bebes é bom trainar mais nao desse jeito q o cara faz poderia matar a criança ou deixar sequelas  .	1	
Como uma mãe ou o pai autoriza uma coisa destas k lavagem lhes fazem para fazerem isto ao próprio filho ai minha rica criança adotava todas as crianças do mundo se pudesse	1	
Crianças tem que ser criança tem que ser inocente gosta de coisas de crianças  .	1	
Dizia ahm eu nunca irei chorar por uma gaja so de crianças para fazer isso agora vejo que a criança era eu pk homem que ama chora	1	
Duas crianças que vai ter criança	1	
Feliz dia das crianças minha princesa obrigada por ser essa criança maravilhosa Mamãe te ama	1	
Gustavo Tem sim ele sorri ja ja minha mulher chega com as crianças ele sorri era um bebê e uma criança de aninhos	1	
Não sou o tipo de pessoa q é q nem as outras pessoas com bebês e crianças eu fico meio sem jeito mas sou amorosa ás vzs com alguma criança q é legal comigo e fofa tipo meus priminhos  .	1	
Oh mor mas a minha vizinha de cima n bate bem da tola eu sei muito bem olhar pelas crianças eu uma altura ja vai ha muito olhei pela criança ate chegou a dormir em minha casa isto ja vai ha anos e tal a criança se começasse a chorar eu punha me a pe e tentava adormecer e acabava mesmo por adormecer mor	1	
Olha tou e ja que és criança fica com as crianças que homens arranjo eu	1	
Ontem eu ganhei meu presente do dia das crianças depois de tanto insistir pq mainha disse q eu não sou mais criança kkkkkkkkkkkkkkkk	1	
Paciência eu tenho muito haha Ha mor sabe crianças faz diferença na vida sabe eu amo cuidar de criança e você também vou vai ser uma ótima mãe você cuidando dos seus priminhos	1	
Pode é haver alguém que seja menos criança pk os rapazes de hoje em dia sao muito crianças nao gostam de responsabilidades	1	
Pois é isso que começa a confusao na criança pais educando e ensinando o certo em casa as crianças não aprenderao errado na rua  .	1	
Pq era criança q quem criava era a avó ai ela morreu ai as crianças ficaram sozinha	1	
Scrr que quando eu era criança adorava pegar essas revistas pra ver os bebês e crianças ou talvez também ler sobre eles	1	
Sinceramente a pabblo canta coisas que nao sao adaptadas para crianças eu achei que tao forcado a barra dizendo que é pra dar pra criança	1	
Ta bem k ele n ta habituado a estar com outras crianças mas ele qd ve uma criança sorri e quer dar a mao  .	1	
Tia Marta falta criança ai vamos marca um dia pra eu levar as crianças ai	1	
e ja q eh criança pq ngm ajudou todo mundo ajuda crianças	1	
feliz dias das crianças so se ja e moça mais a criança dentro de ti pode morrer não se não perde a graça	1	
marido é mãe solteira essas crianças vendem doces na rua para compra a comida de cada dia tem dia não conseguem vender direito e ficam sem comer minha patroa doou as crianças tratamento odontológico até os anos e eu estou com o coração em frangalhos ao ver a realidade dessas crianças uma das crianças estava vendendo doces foi atravessar a rua e uma moto a atropelou e não parou para prestar socorro a mãe não tem dinheiro para comprar remédio estamos ajudando eles e só que não podemos ajudar muito então estou aqui para pedir auda a quem puder para proporcionarmos a essas crianças um natal de sorrisos e alegrias quem puder doar alguma coisa para o natal dessas crianças por favor nos ajude eles precisam nada como ver uma criança sorrindo pode ser qualquer coisa desde roupa sapatos alimentos para a ceia de Natal tem uma criança de anos que tem dia que não pode tomar um copo de leite o pai das crianças não paga pensão pode ser presentes qiem puder nos ajudar por favor se manifeste chama no privado o número é tenho certeza que eles ficaram muito gratos  .	1	
#computador,	computadores
#dólar,	dólares
#banana,	bananas
mas a fruta realmente tem aguentado muito tempo ni frigorifico e as bananas muitas vezes a casta ja esta preta e a banana ta boa por dentro  .	1	
#dedo,	dedos
A um dedo na carta dois dedos na carta meche o ombro piscar um olho levantar a sobrancelha lingua no canto da boca não sei explicar lingua pra fora não sei explicar também	2	
Ah sera anel de namora dar meu dedo amor sabre como meu dedos	1	
Dedo na boceta língua no cu Lingua na boceta dedo no cu Dedo língua cu boceta também Boceta vezes dedos noves fora Cú  .	1	
Desafios de outro mundo fzr video a meter os dedos por minutos fzr video a meter os dedos por minutos video a meteres os dedos e a seguir mijares e voltares a por os dedos video a enfiar o dedo no cu	1	
Eu comprei o de um dedo mas quando eu vir um de dois dedos eu vou comprar um desses	1	
Foto da tua parte íntima Foto fazendo uma careta Foto dos teus olhos Foto dos teus pés Foto com meu nome escrito nas tuas coxas Manda um áudio gemendo Áudio cantando a tua música favorita Áudio gritando Áudio Falando meu nome Coloca minha foto no teu perfil faz colagem de nossas fotos um vídeo teu cantando venha me beijar um vídeo só de calcinha/ cueca Foto dos seios/peito um pedido Uma pergunta Desafios mais fortes que desafios Foto nua mas mais diretamente foto da cona Video toda nua a mostrar as partes do corpo Video a enfiar os dedos deve ter pelo menos / minutos Video a enfiar alguma coisa para alem dos dedos Foto com os dedos enfiados Um video a tua escolha mas tem de haver com a perversidade tens de fazer um video perverso Desafios de outro mundo fzr video a meter os dedos por minutos fzr video a meter os dedos por minutos video a meteres os dedos e a seguir mijares e voltares a por os dedos video a enfiar o dedo no cu	1	
Kaah Solto um gemido manhoso ao sentir o dedo do maior em minha intimidade acabando por rebolar em seus dedos  .	1	
No dedo Almogei os ossos desses dois dedos vou ser operada dia de janeiro	1	
Nos dedos um letra em cada dedo	1	
Para vocês tudo e todos estao mal apontam o dedo a tudo mas nao ainda nao repararam que teem dedos apontados para vocês mesmos  .	1	
Pra o fazeres ele tera que comecar com o dedo por um bom gel depois tentar meter fois dedos e nao ser bruto	1	
Se a pessoa não levanta um dedo para ficar com você já está na hora de levantar os cinco dedos e dar tchau  .	1	
Se o cara por o dedo carol derrete os dedos kkkkkk	1	
Solto um gemido baixinho e enfio outro dedo fazendo movimentos mais bruscos com os dedos	1	
Yah ele disse pcc me mandou um dedo eu disse Atao me tas mandando dedos vou dormir Agora me lembro pk n deu certo a um tempo atras	1	
nem morto meto um dedo no cu mas ja meti dedos a uma gaja e ela ja me bate	1	
É pra apertar dedo dos lados e dedos na manga	1	
#cão,	cães
Os outros dois cães não comem e o cão preto sim hahahaha	1	
os cães são puros mas não tem papéis de pedigri por quê um cão com pedigri é carrissimo é não custam o que estou a pedir pelos meus  .	1	
#pera,	peras
