#Sacramento,	Califórnia
#Portland,	Oregon
#Glendale,	Califórnia
#Jacksonville,	Flórida
#Shreveport,	Louisiana
#Lexington,	Kentucky
#Tulsa,	Oklahoma
#Glendale,	Arizona
#Tucson,	Arizona
#Mesa,	Arizona
#Spokane,	Washington
#Memphis,	Tennessee
#Oxnard,	Califórnia
#Tacoma,	Washington
#Lubbock,	Texas
#Worcester,	Massachusetts
#Miami,	Flórida
#Cleveland,	Ohio
#Scottsdale,	Arizona
#Louisville,	Kentucky
#Stockton,	Califórnia
#Detroit,	Michigan
#Fénix,	Arizona
#Filadélfia,	Pensilvânia
#Huntsville,	Alabama
#Cincinnati,	Ohio
#Honolulu,	Havaí
#Nashville,	Tennessee
#Oakland,	Califórnia
#Houston,	Texas
#Fremont,	Califórnia
#Orlando,	Flórida
#Arlington,	Texas
#Omaha,	Nebraska
#Laredo,	Texas
#Chicago,	Illinois
#Baltimore,	Maryland
#Anchorage,	Alasca
#Plano,	Texas
#Modesto,	Califórnia
#Garland,	Texas
#irmãos,	irmãs
Oi boa tarde Como estas O vi suas irmãs perto de casa a sua irmã parece muito seus irmãos	2	
Amigo dos meus irmãos e eu sou super amiga das irmãs dele  .	1	
As minhas irmãs são mais velhas um dos meus irmãos é da minha idade e o outro só tem anos m  .	1	
E meus dois irmãos moram cm as duas irmãs	1	
Fico do lado das irmãs o culpado e sempre os irmãos	1	
Mas agora vi as tuas irmãs com amizade com meus irmãos mais velhos	1	
Minha avó macumbeira minha mae meus irmãos homens sao ogam minha irmãs macumbeira	1	
Oi boa tarde Como estas O vi suas irmãs perto de casa a sua irmã parece muito seus irmãos nossa legal uma ótima tarde pra vc Deus abençoe	1	
Queria te perguntar um negocio as irmãs que tal ficando hospedadas aí tao ficando na ksa de irmãos ou uma ksa só pra mulheres	1	
#padrasto,	madrasta
Estavamos todos muito triste eu vc minha mae meu padrasto meu pai minha madrasta minha avó e meu avô	1	
N mas é vdd tipo o meu pai só quer saber da filha da madrasta a minha mãe só me liga quando esta ca o filho do padrasto para eu fazer de babysiter os meus irmãos namoram tb n querem saber de mim	1	
Se alguém estivesse mal eu tbm estaria mas sei que está td bem c tds a minha mãe está com o meu padrasto e o meu pai com a minha madrasta e gosto de ambos por isso	1	
#dele,	dela
N me dá o computador dela e nao me diz a password dele logo n consigo estudar como a minha professora me pede Para fazer para estudar  .	8	
Bom dia sim Magali Domingues por drogas matou um homem pra se defender passou sete anos e meio regime fechado estava em liberdade mais parou de fazer tratamento de depressão a varios meses nao estava tomando medicamentos não porque não tinha medicamentos porque ele não queria tomar não gostava de muitas pessoas perto dele nem crianças minha irmã foi almoçar na casa da filha dela	6	
Aquele ex que mesmo namorando não para de te perturbar pra voltar e a atual dele acha que você tem recalque dela  .	3	
Amanhã o dele e hj o dela	2	
Amanhã o dele e hj o dela Outra bb	2	
Depois vai no facebook dele pede desculpa para mim no caso dela mais as fotos deve ter ido por engano como está fora manda para ele	2	
Eles se separaram daí hj é dia dele pega o nenê daí ele ganho uma distancia pra fk longe dela e da família dela daí era pra mim pega o nenê e trazer pra casa daí ela quis ir junto	2	
Eu quero namorar com ela ep titulo esqueceram de mim Bi ai viros vou matar vc corre atras dele V eu sou inocente aaa corre dela Bi pera viros essa casa ta um breuV pior liga a lanterna do celular Bi aaaaa uma assombração V na onde B a nao e sua sombra ufaa V nao me mata do coração coloca a mao no coração Bi hihihi ta mais cade todo mundoV nao sou vidente nao ta vamos tentar sairO pessoal trancou a porta V a porta ta trancada Bi ótimo vou ficar presa	2	
Issac Vc não Yanna Eu vou nem que eu morra eu vô tirar ela de la O Issac sorri e solta ela dando um beijo na testa dela passando o poder dele pra ela A yanna sorri	2	
Minha BFF é prima dele e ele tá na ksa dela	2	
Minha mae perdeu celular dela kkkkkkso que nao meu tio levou pensando que era dele	2	
Nos continuamos amigas somos e seremos sempre amigas E ela sabia o quanto eu gosto dele e tu tbm e n me afastei dela Por isso acho K Tas a fazer mal Mas tu é que sabes	2	
O Ivan fico com o rosto todo sangrando aí o homem Achou o celular do Ivan a ligou para a mãe dele aí o homem falou na onde que ele aquele lugar lá que Ele apanhou sabe o pai da Ivan foi lá no hospital que ele tava aí ele fez um negócio lá aí ele viu van lá aí o pai dele o Bruno saiu de perto já na cara dele tava todo sangrando aí a mãe dele viu e ficou falou assim meu filho meu filho chorando sabe aí a mulher atendeu ele ela foi lá aí a mulher falou assim que ele não tinha quebrado nada mas só que ele apanhou muito e se ele perder o bebê e tava andando no morro aí ela viu a Karine Aí ela começou a discutir mas só que ela tava com medo ABC já voltou para casa da mãe dela aí o filho da Bibi Dá um abraço na avó dele ela falou assim que achava que nunca mais ia ver ela ela deu um abraço chorou a Ritinha fez outro vídeo mostra a foto do Eugênio o nome dele eu acho mas não não mostrou o vídeo inteiro sabe não tem esqueci o nome daquele daquela mulher deixa eu ver ai esqueci o nome dele e aquela outra mulher foi fazer um depoimento do vídeo gatinha que ela fez aí Ivan chegou todo machucado com um negócio no braço Nossa tava com mó dificuldade de deitar na cama mas ele falou assim que tava o negócio lá que Ninguém ajudou aí o Ivan falou assim que as pessoas tinha medo o Zeca tava no sofá o pai dele com a mãe dele conversando E aí a mãe dele falou assim que a Ritinha tinha feito um vídeo lá né aí ele viu falou assim que era injusto também né a Ritinha a mãe ainda mora lá falou assim que sabia que uma hora ia chegar um terremoto da irmã dele não tinha chegar né só contando a ordem da que aconteceu tudo errado mas agora não pelo menos eu tô contando que aconteceu kakakakaka	2	
Oi qui história e essa de juanito falar qui não tem obrigação de de dar o dinheiro e nem o senhor tem a obrigação de dar isso e errado sabia Mãe e super cuidadora com ele ela faz comida e passar a roupa dele da massagem e faz de tudo ainda ele vem falar de não ter obrigação de dar o dinheiro ele tem sim porque ela não ta trabalhando ela tava cuidando dele ela tem as conta dela pra pagar ele ta sendo injusto com ela isso errado ele e mal agradecido não gosta dela e nem da gente ela e carinhosa com ela cuidar dele chama de pai ele fica fazendo ruindade com ela e errado isso	2	
Que os desejos dele de crescer na vida sejam iguais aos dela  .	2	
Rita o Hamilton tbm é culpado dela agir assim pq ele não fala as coisas com ela e a mae dele q faz	2	
Se deus fez outra dela ta decorando a casa dele	2	
daqui eh a bf dela Fica sbnd que ela nao comenta nd dele yha Ele eh meu okay Posso nao namorar c ele mas ele eh meu	2	
/ Rosa Castro Não sou boa a fazer textos mas aqui vai um Espero que gostes Parece que hoje alguém faz anos aninhos Parabéns a vocêsDesta data queridaMuitas felicidades Muitos anos de vidaHoje é dia de festa Cantam as nossas almas Para o menino Pedro Miguel Bragança Fernandes Uma salva de palmas yeahh Parabéns meu pequenote Que tenhas um dia feliz ao pé das pessoas que mais gostas Apesar de eu não estar aí mas dia já estou Agora vou relembrar como a gente se conheceu Dia / / uma menina fazia aninhos E apareceu uma notificação no telemóvel de um rapaz E ele decidiu lhe mandar os parabéns por msg E essa menina recebeu essa msg e quando viu agradeceu Apesar de não o conhecer mas decidiu responder pk o rapaz tinha sido simpático para ela E aí o rapaz respondeu E ela respondeu lhe também Depois ele começou a por conversa com ela e ela com ele também Depois eles trocaram a rede social instagram Mas ele já seguia ela Então ela começou a seguir ele E depois trocaram a rede social whatsapp E começaram a falar mais pela rede social whatsapp Pk era a rede social que ela usava mais Então eles apresentaram se mlhr Ela ficou o a conhecer mlhr e ele a ela Depois criaram uma data juntos que foi / / Pk foi quando eles começaram a falar E então eles começaram a fazer chamada e depois video chamada Virou rotina falarem por msgs por chamada e video chamada Se ela não falar com ele fica incompleta E ela começou a gostar de falar com ele Que se deixar N sabe o que fazer Mas ela começou a sentir alguma coisa por ele Mas tem medo de se magoar pk sofreu mt no passado por rapazes que não valiam a pena Ela até tinha dito a ele que ia virar freira E que não queria relações Mas ele deu uma volta tão grande ao coração dela Que ela nem sabe como Até que dia ou / / o rapaz começou a chamar ela de bb e de mor E ela também começou a chamá lo Mas ela não costuma se apaixonar assim tão depressa Demora muito tempo para se apaixonar Mas ele derreteu rápido O coração dela Ele dia / / ele fez um texto lindo para ela Então o coração dela ainda bateu mais forte Ela quando saiu da escola foi para casa Quando chegou a casa despachou se o mais rápido possível para fazer vídeo chamada com ele Quando fizeram video chamada ela teve uma surpresa Ele dedicou lhe uma canção muito linda E depois ajoelhou se E pediu a ela em namoro Ela ficou sem reação Só corou Parecia um tomate todo vermelho E baixou a cabeça E veio lhe as lágrimas aos olhos Pk nnc ninguém lhe tinha feito uma coisa daquelas A única coisa que lhe tinham feito era sofrer e chorar Ela cada vez começou a gostar mais dele E gosta dele como nunca já tinha gostado Ele fez uma forma diferente dos outros para conquista la Ela nem sabe bem como Ele diz que foi difícil conquista la Mas ela não acha isso Ela acha que foi mt fácil Ela nem sabe se se apaixonou pelo jeito dele Ou por aquele olhar penetrante no dela Que é lindo Ela só sabe que se apaixonou por ele Quando ele pediu em namoro a ela Ela não deu a resposta E ele disse que esperava o tempo que fosse preciso Tao fofo Então ela decidiu fazer uma surpresa E a surpresa era dar a resposta dia / / que é quando ele faz anos E ela vai fazer isso mesmo Mas antes vai escrever a letra da música que ele lhe dedicou / Rosa Castro Oh minha menina Temos que falarEu tenho uma coisa pra desabafar E já faz tempo que tenho guardado comigo Sinceramente não sei por onde começar Lembraste da primeira vez que trocamos de olhar Foi uma pequena forma de aviso Lembraste da primeira vez que pedi pra parar Foi para ver de perto esse teu sorriso Agora estou aqui e desabafei / Rosa Castro Ficas comigo Eu juro te amar Eu juro te adorar Confia em mim Oh mulher em mim Eu juro te amar Eu juro te cuidar Confia em mim Oh mulher em mim Fica comigo Oh baby Fica comigo Oh baby / Rosa Castro Eu dou te tempo para pensar Pensa bem Pensa bem baby Eu discuti com a minha vida Ela disse que pensava mais em tiDo que nela babyEu disse a ela que se pensasse em ti não existiria ela Quando fecho os olhos moça Imagino os teus lábios colados aos meus Quando o teu sorriso brilha E olhares para mim Sinto me tipo tou no céu Eu juro te amar Eu juro te adorar Confia em mim Oh mulher em mim Eu juro te amar Eu juro te cuidar Confia em mim Oh mulher em mim Fica cmg Oh bby Fica cmg Oh bby Eu juro te amar Eu juro te adorar Confia em mim Oh mulher em mim Eu juro te amar Eu juro te cuidar Oh mulher em mim Ficas cmg Cmg E a surpresa é Fico cnt para	1	
/ Rosa Castro Não sou boa a fazer textos mas aqui vai um Espero que gostes Parece que hoje alguém faz anos aninhos Parabéns a vocêsDesta data queridaMuitas felicidades Muitos anos de vidaHoje é dia de festa Cantam as nossas almas Para o menino Pedro Miguel Bragança Fernandes Uma salva de palmas yeahh Parabéns meu pequenote Que tenhas um dia feliz ao pé das pessoas que mais gostas Apesar de eu não estar aí mas dia já estou Agora vou relembrar como a gente se conheceu Dia / / uma menina fazia aninhos E apareceu uma notificação no telemóvel de um rapaz E ele decidiu lhe mandar os parabéns por msg E essa menina recebeu essa msg e quando viu agradeceu Apesar de não o conhecer mas decidiu responder pk o rapaz tinha sido simpático para ela E aí o rapaz respondeu E ela respondeu lhe também Depois ele começou a por conversa com ela e ela com ele também Depois eles trocaram a rede social instagram Mas ele já seguia ela Então ela começou a seguir ele E depois trocaram a rede social whatsapp E começaram a falar mais pela rede social whatsapp Pk era a rede social que ela usava mais Então eles apresentaram se mlhr Ela ficou o a conhecer mlhr e ele a ela Depois criaram uma data juntos que foi / / Pk foi quando eles começaram a falar E então eles começaram a fazer chamada e depois video chamada Virou rotina falarem por msgs por chamada e video chamada Se ela não falar com ele fica incompleta E ela começou a gostar de falar com ele Que se deixar N sabe o que fazer Mas ela começou a sentir alguma coisa por ele Mas tem medo de se magoar pk sofreu mt no passado por rapazes que não valiam a pena Ela até tinha dito a ele que ia virar freira E que não queria relações Mas ele deu uma volta tão grande ao coração dela Que ela nem sabe como Até que dia ou / / o rapaz começou a chamar ela de bb e de mor E ela também começou a chamá lo Mas ela não costuma se apaixonar assim tão depressa Demora muito tempo para se apaixonar Mas ele derreteu rápido O coração dela Ele dia / / ele fez um texto lindo para ela Então o coração dela ainda bateu mais forte Ela quando saiu da escola foi para casa Quando chegou a casa despachou se o mais rápido possível para fazer vídeo chamada com ele Quando fizeram video chamada ela teve uma surpresa Ele dedicou lhe uma canção muito linda E depois ajoelhou se E pediu a ela em namoro Ela ficou sem reação Só corou Parecia um tomate todo vermelho E baixou a cabeça E veio lhe as lágrimas aos olhos Pk nnc ninguém lhe tinha feito uma coisa daquelas A única coisa que lhe tinham feito era sofrer e chorar Ela cada vez começou a gostar mais dele E gosta dele como nunca já tinha gostado Ele fez uma forma diferente dos outros para conquista la Ela nem sabe bem como Ele diz que foi difícil conquista la Mas ela não acha isso Ela acha que foi mt fácil Ela nem sabe se se apaixonou pelo jeito dele Ou por aquele olhar penetrante no dela Que é lindo Ela só sabe que se apaixonou por ele Quando ele pediu em namoro a ela Ela não deu a resposta E ele disse que esperava o tempo que fosse preciso Tao fofo Então ela decidiu fazer uma surpresa E a surpresa era dar a resposta dia / / que é quando ele faz anos E ela vai fazer isso mesmo Mas antes vai escrever a letra da música que ele lhe dedicou / Rosa Castro Oh minha menina Temos que falarEu tenho uma coisa pra desabafar E já faz tempo que tenho guardado comigo Sinceramente não sei por onde começar Lembraste da primeira vez que trocamos de olhar Foi uma pequena forma de aviso Lembraste da primeira vez que pedi pra parar Foi para ver de perto esse teu sorriso Agora estou aqui e desabafei / Rosa Castro Ficas comigo Eu juro te amar Eu juro te adorar Confia em mim Oh mulher em mim Eu juro te amar Eu juro te cuidar Confia em mim Oh mulher em mim Fica comigo Oh baby Fica comigo Oh baby / Rosa Castro Eu dou te tempo para pensar Pensa bem Pensa bem baby Eu discuti com a minha vida Ela disse que pensava mais em tiDo que nela babyEu disse a ela que se pensasse em ti não existiria ela Quando fecho os olhos moça Imagino os teus lábios colados aos meus Quando o teu sorriso brilha E olhares para mim Sinto me tipo tou no céu Eu juro te amar Eu juro te adorar Confia em mim Oh mulher em mim Eu juro te amar Eu juro te cuidar Confia em mim Oh mulher em mim Fica cmg Oh bby Fica cmg Oh bby Eu juro te amar Eu juro te adorar Confia em mim Oh mulher em mim Eu juro te amar Eu juro te cuidar Oh mulher em mim Ficas cmg Cmg E a surpresa é Fico cnt para sempre Aceito namorar contigo Amo te muito Espero que gostes da surpresa e do texto Mais uma vez parabéns Amo te mt Es tudo para mim Pff agora aproveita Oficialmente namorados Melhor data / / Te amo	1	
A Eduarda veio tbm a irmã dela veio trazer o filho pro pai dele	1	
A Josi fala que quando briga com Alice filha dele de anos em vez dela ir chorar para o pai chora para ela Ai o pai da Alice fala vai besta tu gosta de apanhar puxa saco	1	
A Liria colo a mão no rosto dele e beija ele mais e mais O lucas entra na casa dela com tudo gritando ela A Liria levanta um susto e ri	1	
A Liria da um grito e geme colocando a mão na boca e pegando o filho dele com tudo ela vira os olhos e a filha dela chega a pinga ela sorri e senta na boca dele	1	
A Liria da um grito e some do nada e fica só um pedaço da pele dela com o nome dele e no papel escrito a sangue do cara Bem vindo de volta	1	
A Liria escuta a voz dele e para com tudo o sorriso dela some e o brilho nos olhos tbm i ela vira lentamente olhando pra ele	1	
A Liria fica em silêncio e se afasta dele ela pela primeira vez na vida dela era realmente tava com medo dele	1	
A Liria geme baixinho e sorri e fala Então vc quer provocação ela sorri e vira de costa e rebola lentamente no filho dele passando a filha dela ela sorri e da uma arranhadinha	1	
A Liria olha pra aliança na mãe dela e sorri ela some e pega a mão dele e fala Juntos para todo o sempre lembra ela sorri e fala eu aceito o seu quase pedido de casamento ela sorri	1	
A Liria olha pra ele e sorri ela tinha um sorriso perfeito Desculpa ela desvia dele e sai andando ela tinha deixado a carteira dela caida no chão e tinha um pouco de dinheiro mais só nota alta i ela nem tinha visto	1	
A Liria olha pra ele olha pra ela levanta pega a mão dele coloca na barriga dela e dava pra sentir como se algo ja tivesse nascendo dentro dela Ela sorri como nuncan	1	
A Liria para a mão dele com tudo não deixando ele encosta na bunda dela ela fecha a porta com tudo e taca o prato de comida na porta com tudo que quebra e esparra comida pra todo lado ela joga prato e copo morrendo de raiva ela deita com tudo no chão cheio de cacos de vidro de calcinha e sutiã e fala bem baixinho Eu ainda te amo tanto mais ela abre os olhos com tudo e fala Eu te odeio mais	1	
A Liria retribui o beijo dele levantando o pé e a barriga dela cresce pra um mês ela sente e sorri	1	
A Liria ri e chega bem perto dele e pega o filho dele com tudo e sorri passando ele na boca dela lentamente	1	
A Liria senta no colo dele e coloca a mão na barriga dela e o bebê juta com tudo i ela sorri boba	1	
A Liria sente o carinho dele e sorri se confortando no peito dele i a Barriga dela cresce pra meses	1	
A Liria sente o nome dele aparecer na custela dela de novo ela para de beija ela tira a blusa e olha pra custela dela e la estava o nome dele e uma data	1	
A Liria sorri e puxa o beiso dele ela sorri olha pra ele tira o sutiã dela e da na mão dele e sorri levanta Fica com vc pra lembrar de mim ela sorri e levanta indo embora Eu preciso ir ela sorri manda um beijo pra ele e volta pra casa dela o seios dela fico marcando certinho na blusa dela	1	
A Liria vira olhando pra ele e ela da o melhor sorriso dela Liria olha pro tanquinho dele pra ele e depois pros conjuntos e o cabelo dela se solta com tudo e ela fica sexy e perfeita	1	
A Luciana sorri O clone dela se explode Ela aparece atras dele e fala Esse cordão e pra vc conseguir dormina O seu dragão Porra Roberto eu não so sua inimiga eu quero ti ajudar sera que vc ainda não perdebeu Eu quero fazer pra vc O que sua mão não fez Mais vc não ajuda porra ela prede O colar nele e O colar suga O dragão e deixa a parte Mais fraca no corpo do Roberto e fala Se não quiser esse colar me chama que eu tiro Ele e como uma maldição so abaca se vc for atras e pedir pra quem colar Tira ou vc	1	
A Nicole meu bb tava pensando em conversa com o namorado dela só que se fzd de outra menina para ver se ele não traia algo assim ai ela disse q a Ludmila uma menina la da escola disse q no começo de namoro deles Nicole e ele ele gostava dela da Ludmilla ai ela ficava dando em cima dele e ela me mandou muitos prints e tals ai eu disse q se ele quisesse fazer isso não vejo problema pq ela só estava querendo confirma se ele gosta mesmo dela e q ele não a trairia mas tb disse q da para ver q ele não faria algo assim eu sei q ele ama muito ela da para ver e a Ludmilla pensou q ele gostasse dela então ela deu em cima dele e bla bla bla só q ele nunca gostou dela e tals eu eu sei como a Ludmilla e	1	
A Nicole meu bb tava pensando em conversa com o namorado dela só que se fzd de outra menina para ver se ele não traia algo assim ai ela disse q a Ludmila uma menina la da escola disse q no começo de namoro deles Nicole e ele ele gostava dela da Ludmilla ai ela ficava dando em cima dele e ela me mandou muitos prints e tals ai eu disse q se ele quisesse fazer isso não vejo problema pq ela só estava querendo confirma se ele gosta mesmo dela e q ele não a trairia mas tb disse q da para ver q ele não faria algo assim eu sei q ele ama muito ela da para ver e a Ludmilla pensou q ele gostasse dela então ela deu em cima dele e bla bla bla só q ele nunca gostou dela e tals eu eu sei como a Ludmilla e conheço desdo sexto ano e ela ja deu em cima de um ex quando eu estava namorando com ele e enganou a isa dzd q so iria namorar com o ex dela para descobrir algo sendo q N tem nd para descobrir	1	
A Yanna coloca a mão na filha dela e massagea ela sorri e vira com tudo ficando encima dele	1	
A Yanna ri e desce da cintura dele e o seios dela balança e fala Ja vo deixando bem claro se sua namoradinha vim de gracinha pro meu lado eu vou bater nela Tah ela entra	1	
A Yanna senta na cama e olha a mensagem olha a foto ela olha pro seios da Letícia olha pro seios dela e fala Eh concerteza ela e melhor que eu ela suspira coloca o celular dele do lado dele levanta coloca o sutiã dela coloca a camisola dela e desce fechando a porta e apagando a luz mais antes ela olha pro gustavo e sorri	1	
A Yanna sorri e entra na sala dela soltando o braço dele	1	
A Yanna sorri e vira com tudo ficando encima dele ela abre a calça ou bermuda dele e tira junto com a cueca dele e fala tirando a calcinha dela Eu quero vc em mim Roberto ela sorri	1	
A alma dela fala no ouvido dele Eu cansei de correr atrás dele e no final ficar sozinha	1	
A ame dela disse que ia na casa da casa dele falar com a mae dele	1	
A ana geme e segura a mão dele que tava com os três dedo que tava dentro da filha dela	1	
#neto,	neta
Casei tenho uma filha de anos tenho filho de anos neto de anos e vou ganhar neta no final do ano	1	
Sua neta pediu pao e seu neto tava aqui querendo o tenis dele	1	
#homem,	mulher
Quando uma mulher marca a vida de um homem poderão chegar milhares e essa continuará a ser a sua favorita a sua mulher  .	13	
Perigosa é a mulher que age como uma dama e pensa como homem  .	9	
Talvez o homem não gosta de mulher que gosta de mulher vagabundo	9	
Toda mulher precisa de um cara que seja homem o suficiente para provar que nem todos os homens são iguais	9	
Olha vaso eu tô aqui pra lhe ajuda pois do jeito que vc precisa de me eu tbm preciso de vc pois uma dia minha família vai sabe que estou com um cara preso sei vaso que meu pai e dono de empresa mas eu tenho que trabalhar pra ganha o meu quantas vez vc já escutou eu dizendo vou come na casa de mainha pq aqui não tinha nada ai eu tinha que ir pra lá pois ele não me nega come não mas fica falando se eu fôr direto e eles falar com razão pois eu trabalho e tenho que me sustenta mesmo sei que vc tá preso e vou fazer de tudo pra bota as calças pra dentro poia uma mulher não precisa so de sex não vaso eu quero um homem que me ajude em tudo vc tá me entendedo se fôr pra viver de sex eu prefiro fica só sabe pq sex não enche barriga não vaso e quando todos sabe eu quero tá com esse direito de falar ah mas Paulo paga meu aluguel e faz minha fera vc tá entendendo nnnnnjjkk	7	
Talvez o homem não gosta de mulher que gosta de mulher vagabunda	7	
Um homem com sonhos precisa de uma mulher com	7	
Sempre vai existir uma mulher mais bonita que a sua ou um homem mais bonito que o seu  .	6	
Uma mulher pergunta a um mestre chines Mestre por que um homem que faz sexo com varias mulheres é chamado de campeao e Uma mulher que faz sexo com varios homens é chamada de vagabunda E o mestre responde filha  .	6	
Antes de você homem casado olhar pra uma mulher linda bem cuidada e montada na rua ou internet e ficar babando dizendo que é muito mais bonita que a sua esposa me acompanha aqui Cabelo à por semanaAlongamento só a manutenção tá Unhas por semana naturais pq se forem de porcelana fibra de vidro acrigel são mais caras ainda Sobrancelha x ao mês Depilação á x ao mês Academia	5	
Antes de você homem casado olhar pra uma mulher linda bem cuidada e montada na rua ou internet e ficar babando dizendo que é muito mais bonita que a sua esposa me acompanha aqui Cabelo à por semanaAlongamento só a manutenção tá Unhas por semana naturais pq se forem de porcelana fibra de vidro acrigel são mais caras ainda Sobrancelha x ao mês Depilação á x ao mês Academia à mensal Silicone milAlongamento de cílios mensal Luzes sem contar o retoque da raiz Esteticista á mensalE aí É sua esposa que é feia ou é você que não dá condições pra ela realçar a beleza dela Mulher de família que te ajuda está contigo no dia a dia lutando crescendo com você merece ser bem cuidada	5	
E aí eu fui com outras pessoas sempre buscando o mesmo patamar de riqueza nobreza um casamento de alguém que me sustentasse uma relação com um homem que me cuidasse como mulher  .	5	
Esposa linda Que Deus perdoe o homem que não reconhece o valor da mulher que Deus coloca ao lado  .	5	
Se você nunca foi chamada de maluca por um homem então você não está exercendo seu papel de mulher corretamente  .	5	
pra mim não tem nada melhor que elogiar mulher bicho eu adorohomens oq tenho haver aksoaksoabrincadeira eu so me identifico com homem	5	
Aah mais homem e mais facil arruma uma menina ligeiro e ja mulher nao pode ficar com ninguém por agora pq o povo fala	4	
Nenhum homem tem a obrigação ou a necessidade de carregar uma mulher  .	4	
perigosa é a mulher que pensa igual ao homem	4	
Agora mulher dando lucro a peste de homem colocou o cartão sacou	3	
Antes de você homem casado olhar pra uma mulher linda bem cuidada e montada na rua ou internet e ficar babando dizendo que é muito mais bonita que a sua esposa me acompanha aqui Cabelo à por semanaAlongamento só a manutenção tá Unhas por semana naturais pq se forem de porcelana fibra de vidro acrigel são mais caras ainda Sobrancelha x ao mês Depilação á x ao mês Academia à mensal Silicone milAlongamento de cílios mensal Luzes sem contar o retoque da raiz Esteticista á mensalE aí É sua esposa que é feia ou é você que não dá condições pra ela realçar a beleza dela Mulher de família que te ajuda está contigo no dia a dia lutando crescendo com você merece ser bem cuidada Quem leu até o final e concordou comigo deixa um	3	
E hoje casado cristão as pessoas tendem a generalizar muito quando uma mulher conversa com outro homem e principalmente se estes forem casados como se fosse algo do diabo fugir da aparência do mal que homem casado não conversa com outra mulher e vice versa  .	3	
E quem disse que um homem nao pode ser amigo de uma mulher	3	
E quem disse que um homem não pode ser melhor amigo de uma mulher	3	
E saiba não há nada mais emocionante e gratificante Quando uma mulher se torna mãe ou um homem se torna pai as emoções passam a ser vividas em dobro  .	3	
E tem muita mulher q n acha homem mesmo porq é a frente de seu tempo  .	3	
Eu sempre achei que toda mulher deveria ter um desses pra quando o homem não querer fumcionar	3	
Falou a mulher que pensa como homem Sim em público me comporto bem  .	3	
Feliz é o homem que pode chamar uma mulher de sua  .	3	
Homem que é homem é de uma mulher só o que é de várias ainda tá na fase da molecagem  .	3	
O coração de mulher er diferente dos corações dos homens a mulher Ama so um homem i o homem ama uma duas três  .	3	
O erro do homem é dizer que mulher é o que não falta se liga parceiro o que não falta é puta mulher de verdade quando encontra tem que ser valorizada	3	
Por que não dizer que te amo se isso também é uma forma de amar pode parecer estranho mas a palavra amar não é apenas de um homem para com uma mulher ou vice versa pode ser um grande amigo um pai ou uma mãe o que importa é o carinho e a ternura que você tem com essa pessoa lembre se Quem ama perdoa e sabe compreender as imperfeições das outras pessoas	3	
Quando agente tiver casados vamos lembrar de todos esses momentos ne amor de tudo q agente passou pra ficar juntos de tudo LETÍCIA eu tenho muito Orgulho de você eu so tenho q agradecer a deus por ele ter colocado uma pessoa incrivel como vc em minha vida voce me mudou completamente hj sou um homem bastante apaixonado eu so quero voce na minha vida minha mulher so quero amar voce quero contruir uma família com você nossa família meu sonho um dia eu chegar em casa vc esta la na porta de nossa casa com nossa filhinha me esperando e ela falando mamae olha papai ja chegou	3	
Quando agente tiver casados vamos lembrar de todos esses momentos ne amor de tudo q agente passou pra ficar juntos de tudo LETÍCIA eu tenho muito Orgulho de você eu so tenho q agradecer a deus por ele ter colocado uma pessoa incrivel como vc em minha vida voce me mudou completamente hj sou um homem bastante apaixonado eu so quero voce na minha vida minha mulher so quero amar voce quero contruir uma família com você nossa família meu sonho um dia eu chegar em casa vc esta la na porta de nossa casa com nossa filhinha me esperando e ela falando mamae olha papai ja chegou meu sonho e viver um momento desse com vc eu não sei oque foi q eu fiz pra te merecer eu tenho muita sorte te ter voce na minha vida e prometo te amar eternamente vou fazer tudo certinho pra gente viver feliz pro resto da minha vidaaa	3	
Tah mas qnd um homem se vira ah papavate toda uma mulher nao gsta e mts vzs nao se sente a vontade com essas brincadeiras	3	
Toda mulher precisa de um cara que seja homem o suficiente para provar que nem todos os homens são iguais Ser feliz não é apenas resumir nossa vida em bons momentos  .	3	
Vc que eu homem Bruno me explica pq hemem fala que a mulher e criança e no final o homem que acaba sendo criança	3	
homem não gosta de mulher certa a mulher certa ele não valoriza	3	
meu bebê eu quero te dizer que farei o possivel e o impossivel farei tudo que estiver ao meu alcançe pra te fazer o homem mais feliz do mundo quero ser a mulher perfeita a mulher que você merece ter eu quero estar do seu lado nos piores e nos melhores momentos quero te fazer rir até sua barriga doer quero te fazer sorrir quero te fazer delirar eu quero ser TUDO pra você eu vou fazer você esquecer tudo que te fez chorar um dia e serei aquela que você vai querer ter ao seu lado em todos os momentos como melhor amiga namorada amante mulher você me faz um bem danado e não deve nem ter noção disso não é talvez seja cedo demais mas eu digo de peito aberto e pra todo mundo ouvir eu preciso de você pra viver feliz eu te amo demais meu bb	3	
Às vezes o grande é um homem às vezes é uma mulher  .	3	
A mulher foi feita da costela do homem não dos pés para ser pisada nem da cabeça para ser superior mas sim do lado para ser igual debaixo do braço para ser protegida e do lado do coração para ser amada  .	2	
A mulher que estava perto do suicida Confirma que ouviu o homem dizer Adeus mundo cruel	2	
A mulher tem poder de deixar o homem louco  .	2	
Acabou o namoro com o brode pq tava interessada em um homem casado depois falar que é mulher de respeito mds	2	
Antes de você homem casado olhar pra uma mulher linda bem cuidada e montada na rua ou internet e ficar babando dizendo que é muito mais bonita que a sua esposa me acompanha aqui Cabelo à por semanaAlongamento só a manutenção tá Unhas por semana naturais pq se forem de porcelana fibra de vidro acrigel são mais caras ainda Sobrancelha x ao mês Depilação á x ao mês Academia à mensal Silicone milAlongamento de cílios mensal Luzes sem contar o retoque da raiz Esteticista á mensalE aí É sua esposa que é feia ou é você que não dá condições pra ela realçar a beleza dela Mulher de família que te ajuda está contigo no dia a dia lutando crescendo com você merece ser bem cuidada Quem leu até o final e concordou comigo deixa um  .	2	
Antes de você homem casado olhar pra uma mulher linda bem cuidada e montada na rua ou internet e ficar babando dizendo que é muito mais bonita que a sua esposa me acompanha aqui Cabelo à por semanaAlongamento só a manutenção tá Unhas por semana naturais pq se forem de porcelana fibra de vidro acrigel são mais caras ainda por volta de  .	2	
Awnn Bom dia vida Espero que tenhas um oto dia siu o homem mais feliz do mundo e espero que sejas a mulher mais feliz do mundo quero fazer te a mulher mais feliz do mundo Amo teee	2	
Bom é mulher qui tem um homem qui sabe dar valor não é eu não	2	
Chamava se este homem Elimeleque e sua mulher Noêmi e seus dois filhos se chamavam Malom e Quiliom eram efrateus de Belém de Judá  .	2	
Desculpa ai eu toca nesse assunto pq eu odeio homem que bate em mulher  .	2	
#Enteado,	enteada
#marido,	esposa
Ahhh meu amor pois a esposa ainda vai enlouquecer o marido dela ainda mais meu amor	4	
Ahhhh meu amor disso meu marido pode ter certeza meu amor sua esposa ama enterrar a carinha assim no meu pescocinho pra sentir o meu cheirinho meu amor Ahhhh meu amor então meu amor mais não vai ser por agora que sua esposa vai comprar ele não meu amor sua esposa vai comprar outras coisas pra ela meu amor	4	
Ôhhhh meu amor graças a Deus que meu anjinho já voltou meu amor sua esposa estava aqui tão mais tão preocupada com o marido dela meu amor Ôhhh meu amor sua esposa também está aqui morrendo de saudades do marido dela meu amor mds meu amor sua esposa precisa ver o anjinho dela urgentemente meu amor sua esposa endoida se ficar sem conversar com o marido dela meu amor mds meu amor é a pior coisa do universo inteirinho meu amor Ôhhhh meu amor sua esposa só começou a endoidar assim mesmo meu amor depois que sua esposa chegou do simulado meu amor e meu anjinho ainda não tinha entrado e nem recebido mensagem alguma meu amor sua esposa tava em tempo de passar mal com uma dorzinha no peito meu amor e o coraçãozinho apertado meu amor Ôhhh dó do meu anjinho mds meu anjinho deve tá então bem cansadinho meu amor meu anjinho precisa descansar um pouco meu amor Ôhhh meu amor sua esposa também nem fez o textinho meu amor ontem dava pra ter feito mesmo meu amor devido ao tempo e pra ver se destraia um pouco meu amor mais é impossível meu amor sua esposa estava muito preocupada meu amor Ôhhh meu amor sua esposa acordou no horário que combinamos meu amor mais como sua anjinha falou ai meu amor o celular da sua esposa estava em meu amor e era só pegar já desligava meu amor ai sua esposa deixou carregando meu amor e foi terminar de lavar a louça meu amor e depois já veio mandar mensagem pro meu anjinho meu amor ai sua esposa ficou deitadinha esperando meu amor até mandar mensagem novamente avisando que ia já arrumar meu amor sua esposa depois que terminou almoçou assim correndo pois já estava atrasada meu amor e sua esposa foi pra lá com sua cunhada correndo literalmente meu amor ai sua esposa chegou já tava em tempo de passar mal lá meu amor com o estômago revirando meu amor mais ai sua acalmou mais meu amor e terminou a prova era meu amor ai como sua cunhada não tinha terminado ainda meu amor sua esposa veio sozinha mesmo meu amor e já veio correndo ver se meu anjinho já tinha recebido as mensagens meu amor	4	
Ôhhh meu amor minha vida amor da minha vida meu tudo sua esposa não sabe se meu anjinho vai receber essa mensagem meu amor mais sua esposa já está aqui muito preocupada com o anjinho dela meu amor pra saber se meu marido ta bem meu amor sua esposa estava sem sinal no chip meu amor e só voltou agora meu amor ai sua esposa pensou em tentar mandar mensagem aqui pro meu anjinho meu amor sua esposa passou o dia todo agoniadinha meu amor mais meu anjinho ta bem né meu amor	3	
Ahhh meu amor que horas meu marido acha melhor meu amor Por meu esposo demorar mais que a esposa no banho meu amor  .	2	
Ahhh meu amor sua esposa está sozinha aqui meu amor meu marido pode conversar por ligação agora meu amor	2	
Ahhh meu amor sério meu amor quando sua esposa ouviu assim a minha voz mais que perfeita meu amor dizendo o quanto ama a esposa e tudo mais meu amor sua mulher ficou muito emocionada aqui meu amor Ahhh meu amor então meu amor sua esposa também precisa tanto sentir o marido dela meu amor sentir esse meu corpo gostoso meu amor e beijar muito essa minha boquinha deliciosamente gostosa meu amor Ahhh meu amor sua esposa estava falando as coisas assim meu amor e ficou toda bobinha meu amor ai sua mulher embolou tudo meu amor mais não pode rir da esposa não meu amor rum	2	
Ahhhh meu amor isso que meu marido fala assim de esquecer o passado sua mulher acha besteira falar isso assim meu amor pois são anos da vida da sua esposa antes de conhecer o marido dela meu amor e não da pra simplesmente apagar ou esquecer uma vida inteira meu amor e o passado sim que deveríamos esquecer é aquele referente a certas coisas meu amor que são insignificantes meu amor	2	
Então meu amor minha vida amor da minha vida meu tudo Então meu amor ficaria bem legal mesmo meu amor Ahhh meu amor a conclusão meu amor é que independente de tudo sempre vamos buscar compreender o lado um do outro meu amor e buscar por aquilo que deixe os dois bem e felizes meu amor sempre vamos da opiniões sim meu amor sobre absolutamente tudo meu amor pois somos infinitamente mais que casados meu amor e sempre vamos fazer de tudo pra ver o outro feliz meu amor mesmo que pra isso tenhamos que aceitar algumas coisitas meu amor Então sobre isso da roupa sua esposa tem certeza que nunca vai contrariar o marido dela meu amor pois vamos sempre comprar juntinhos meu amor e meu esposo vai sempre poder da o opinião sim meu amor pois somos muito mais que casados meu amor e sua esposa vai usar sempre aquilo que agrade aos dois meu amor	2	
O marido chega em casa indignado e já vai contando para a esposa Encontrei aquele trouxa do segundo andar se gabando de ser o maior garanhão  .	2	
Ôhhh meu amor então meu amor sua esposa também estava aqui morrendo de saudade do marido dela meu amor mais é tanta mais tanta saudade mds desculpa a demora meu amor tinha umas panelas que tavam bem chatas pra lavar meu amor e desculpa a demora agora meu amor meu marido tinha demorado um pouquinho ai sua esposa estava aqui conversando com sua sogra meu amor Ôhhh meu amor sério que a internet do meu marido caiu meu amor mds meu amor ainda bem que já voltou meu amor	2	
Ôhhh meu amor mds meu amor essa internet não pode cair assim mesmo não meu amor mds meu amor sua esposa estava tão mais tão agoniadinha meu amor sua esposa de manhã mandou mensagem pro meu anjinho meu amor depois mandou no horário que saiu pra fazer o simulado meu amor achando que quando voltasse meu anjinho já estaria com internet meu amor e nada meu amor sua esposa também abriu a boquinha chorando meu amor sua esposa estava tão preocupada com o marido dela meu amor Ôhhhh meu amor sua esposa também estava sem sinal na tim meu amor porém quando deu meia noite certinho meu amor o sinal voltou meu amor ai sua esposa tentou enviar um sms pro meu anjinho meu amor mais não sei se meu anjinho chegou a receber meu amor sua esposa estava tão preocupada meu amor sua esposa também não dormiu nada praticamente meu amor sua esposa logo cedo só tava pegando o celular pra ver se meu anjinho já tinha recebido as mensagens meu amor	2	
Ôhhh meu amor meu anjinho não pode ficar desse jeito não meu amor tem que comer meu amor Ôhhh meu amor então meu amor sua esposa precisa tanto do marido dela meu amor Ahhh meu amor pois meu esposo não fica meu amor impossível meu marido ficar feio meu amor Ahhh meu amor mais hoje vamos descansar ta bom meu amor Pois amanhã temos que acordar um pouco mais cedo também meu amor Ôhhh meu amor ainda bem meu amor tem mais que esquecer essas coisas mesmo meu amor Ahhh meu amor sério meu amor ahhhh meu amor se estávamos assim bem grudadinhos meu amor o sonho foi muito mais que ótimo meu amor	2	
Ôhhhh meu amor graças a Deus que meu anjinho já voltou meu amor sua esposa estava aqui tão mais tão preocupada com o marido dela meu amor Ôhhh meu amor sua esposa também está aqui morrendo de saudades do marido dela meu amor mds meu amor sua esposa precisa ver o anjinho dela urgentemente meu amor sua esposa endoida se ficar sem conversar com o marido dela meu amor mds meu amor é a pior coisa do universo inteirinho meu amor Ôhhhh meu amor sua esposa só começou a endoidar assim mesmo meu amor depois que sua esposa chegou do simulado meu amor e meu anjinho ainda não tinha entrado e nem recebido mensagem alguma meu amor sua esposa tava em tempo de passar mal com uma dorzinha no peito meu amor e o coraçãozinho apertado meu amor Ôhhh dó do meu anjinho mds meu anjinho deve tá então bem cansadinho meu amor meu anjinho precisa descansar um pouco meu amor Ôhhh meu amor sua esposa também nem fez o textinho meu amor ontem dava pra ter feito mesmo meu amor devido ao tempo e pra ver se destraia um pouco meu amor mais é impossível meu amor sua esposa estava muito preocupada meu amor Ôhhh meu amor sua esposa acordou no horário que combinamos meu amor mais como sua anjinha falou ai meu amor o celular da sua esposa estava em meu amor e era só pegar já desligava meu amor ai sua esposa deixou carregando meu amor e foi terminar de lavar a louça meu amor e depois já veio mandar mensagem pro meu anjinho meu amor ai sua esposa ficou deitadinha esperando meu amor até mandar mensagem novamente avisando que ia já arrumar meu amor sua esposa depois que terminou almoçou assim correndo pois já estava atrasada meu amor e sua esposa foi pra lá com sua cunhada correndo literalmente meu amor ai sua esposa chegou já tava em tempo de passar mal lá meu amor com o estômago revirando meu amor mais ai sua acalmou mais meu amor e terminou a prova era meu amor ai como sua cunhada não tinha terminado ainda meu amor sua esposa veio sozinha mesmo meu amor e já veio correndo ver se meu anjinho já tinha recebido as mensagens meu amor e nada meu amor ai sua esposa ficou com sua sogra conversando sobre o simulado meu amor e depois ficou deitadinha esperando e pensando no meu esposo meu amor e quando deu umas mais ou menos meu amor sua esposa foi tomar banho meu amor que foi a hora que sua anjinha abriu a boquinha chorando meu amor e depois sua esposa so ficou deitadinha vendo as nossas fotos meu amor e acho que sua esposa conseguiu cochilar ia da umas h mais ou menos meu amor	2	
A esposa chega desesperada na delegacia Meu marido saiu ontem de casa pra comprar arroz e não voltou até agora  .	1	
A esposa queixosa encontrará conselhos contra o seu marido e assim por diante  .	1	
A esposa sai de casa da manha e o marido liga pra saber se ta td bm	1	
A mulher pergunta para o marido Amor qual o seu plano para a Semana Santa O homem responde O mesmo de Jesus sumir na sexta e reaparecer no domingo Aí o abestado do marido resolve perguntar para a esposa E os seus planos querida A esposa responde O mesmo que Judas TRAIR Que mulher ignorante não sabe nem brincar	1	
A resposta é que quando se casa vc tem liberdade o suficiente para dizer a sua esposa e ao seu marido o q gosta ou não se prefere isso ou aquilo	1	
Ahhh meu amor então ta bom meu amor assim que sua esposa terminar então de arrumar as coisas lá mando mensagem pro meu marido lá no insta meu amor e ai conversamos até a hora de sua esposa sair meu amor	1	
Ahhh meu amor graças a Deus que já passou mais meu amor e sério que meu anjinho ainda ta sentindo dorzinha meu amor Ohhh meu amor ta muito forte meu amor se tiver toma algum remedinho meu amor pra aliviar mais meu amor vai lavar o rostinho meu amor e toma um pouco de água meu amor e descansa meu amor meu anjinho tá precisando descansar bem meu amor logo já vamos dormir ta bom meu amor ai meu marido fica deitadinha imaginando como sempre a esposa ai bem grudadinha	1	
Ahhh meu amor imagine sua esposa ai com o marido dela meu amor pois sua esposa daqui vai está imaginando o mesmo meu amor assim como  .	1	
Ahhh meu amor isso do curso meu amor se não fosse necessário mesmo sua esposa não faria ele meu amor mais vai ser bom pra sua esposa meu amor pois sua esposa precisa aprender a fazer uma boa redação que sua esposa não sabe meu amor e aprender mesmo aquelas outras matérias que sua mulher ta com mais dificuldade meu amor então sua esposa está indo pra lá por isso meu amor e também é quase certo que sua esposa vai com sua cunhada meu amor e mesmo que ela não fosse meu marido poderia ter a mais absoluta certeza que sua esposa não vai pra lá pra fazer amizade com ninguém meu amor e que sua esposa vai ficar bem quetinha no cantinho dela meu amor e buscando aprender ainda mais meu amor Ahhh meu amor sua esposa ficaria com ciúmes sim meu amor pois por ser sua esposa meu amor e amar meu marido mais que tudo meu amor sua esposa sente muito ciúmes do marido dela meu amor então isso do ciúmes é normal sempre sentir mesmo pra tudo meu amor mais ninguém vai ficar olhando pra sua esposa não meu amor Ahhh meu amor isso de não podermos conversar mesmo vai ser muito ruim meu amor mais vamos da um jeitinho nisso meu amor	1	
Ahhh meu amor isso do curso meu amor se não fosse necessário mesmo sua esposa não faria ele meu amor mais vai ser bom pra sua esposa meu amor pois sua esposa precisa aprender a fazer uma boa redação que sua esposa não sabe meu amor e aprender mesmo aquelas outras matérias que sua mulher ta com mais dificuldade meu amor então sua esposa está indo pra lá por isso meu amor e também é quase certo que sua esposa vai com sua cunhada meu amor e mesmo que ela não fosse meu marido poderia ter a mais absoluta certeza que sua esposa não vai pra lá pra fazer amizade com ninguém meu amor e que sua esposa vai ficar bem quetinha no cantinho dela meu amor e buscando aprender ainda mais meu amor Ahhh meu amor sua esposa ficaria com ciúmes sim meu amor pois por ser sua esposa meu amor e amar meu marido mais que tudo meu amor sua esposa sente muito ciúmes do marido dela meu amor então isso do ciúmes é normal sempre sentir mesmo pra tudo meu amor mais ninguém vai ficar olhando pra sua esposa não meu amor Ahhh meu amor isso de não podermos conversar mesmo vai ser muito ruim meu amor mais vamos da um jeitinho nisso meu amor vamos dividir direitinho o nosso tempo meu amor e durante a tarde vamos sempre está bem grudadinhos meu amor então isso que vai melhorar tudo meu amor pois se fosse igual o ano passado mesmo meu amor a gente em salas separadas que seria muito ruim meu amor Ahhh meu amor sobre aquilo que sua esposa disse perdoa sua esposa meu amor sua mulher falou sem pensar meu amor mais foi no sentido que sua esposa é infinitamente mais que casada meu amor e que se sua sogra soubesse disso ela não teria feito esse comentário meu amor Ahhh meu amor sobre isso da faculdade meu amor não vamos ficar pensando nisso por agora não meu amor não sabemos como tudo vai ser meu amor futuramente meu amor mais o importante é termos em mente que se Deus quiser tudo vai da certo meu amor e não vamos nunca ficar longe um do outro meu amor nada nunca vai afastar nós dois meu amor Ahhh meu amor pois então agora meu anjinho trate de se acalmar mais meu amor e por nessa minha cabecinha mais linda meu amor que sempre vamos da um jeitinho pra tudo meu amor e que não vamos nunca mais nunca mesmo ficar longe um do outro meu amor nada vai nos afastar um do outro meu amor e se Deus quiser tudo vai da certo meu amor e ano que vem vamos poder ficar bem grudadinhos meu amor Ahhh meu amor então meu amor meu marido tem um textinho infinitamente mais que perfeito pra fazer pra esposa meu amor rum cortar meu cabelinho lindo meu amor e semana que vem ficar bem grudadinhos meu amor aproveitando bem meu amor espero que aqueles veis não estejam no nosso lugar meu amor nunca temos sorte de ficar lá meu amor Ahhh meu amor vamos sim meu amor ficar infinitamente mais que felizes meu amor pois só temos que comemorar esses dias meu amor e não precisa pedir perdão não meu amor só quero ver o meu sorriso mais perfeito meu amor pra sua esposa ficar bem feliz aqui meu amor	1	
Ahhh meu amor meu marido está melhor mesmo meu amor Ahhhh meu amor graças a Deus meu amor meu marido não sabe o quanto isso deixa sua esposa feliz meu amor e sim meu amor temos sempre que ficar infinitamente mais que felizes meu amor  .	1	
Ahhh meu amor pois a esposa ainda vai enlouquecer o marido dela ainda mais meu amor  .	1	
Ahhh meu amor quanto ao assunto de ontem sua esposa não está tristinha não meu amor Ahhh meu amor é verdade meu amor meu esposo pode perguntar sim meu amor como não pode perguntar as coisas pra própria esposa meu amor Ahhh meu amor então meu amor minha vida amor da minha vida meu tudo Ôhhh meu amor sério isso meu amor mds meu amor ohhh meu amor toma algum remedinho meu amor pra aliviar ainda mais meu amor e fica deitadinho minha vida imaginando sua esposa ai cuidando do neném dela meu amor que se Deus quiser logo meu marido vai está ótimo meu amor Ahhh	1	
Ahhh meu amor sua esposa bem sabe disso meu amor meu marido é um dengo meu amor meu dengosinho meu amor Ahhhh meu amor sua esposa não ver a hora de poder está todos os dias bem grudadinhos meu amor pra poder dengar muito esse meu neném meu amor que é a coisinha mais linda e mais fofa que existe no universo inteirinho meu amor Ôhhh meu amor não sinta isso não meu amor sua esposa só estava tristinha por ver meu anjinho tristinho meu amor e ontem meu marido	1	
Ahhh meu amor sua esposa pode até não está agora ai fisicamente com meu esposo meu amor mais imagine sua esposa ai meu amor a noite inteirinha bem grudadinha com meu marido meu amor pois no pensamento e no coraçãozinho da sua esposa meu amor estarei bem ai com meu  .	1	
Ahhh meu amor são meses ao lado do homem da minha vida meu amor ao lado do marido que Deus fez exatamente e especialmente pra mim meu amor e sua esposa é muito grata por isso meu amor grata por ele ter me dado meu esposo logo meu amor por ele ter dado pra sua esposa meu amor um marido muito mais que perfeito meu amor o marido que foi mais além do que sua esposa havia sonhado meu amor e  .	1	
Ahhhh meu amor meu esposo citou ai várias vezes no textinho meu amor o quanto que meu marido é sortudo por ter a mulher como esposa meu amor e sua esposa fala exatamente o mesmo meu amor sua esposa é a mulher mais sortuda de todo o universo meu amor por ter um marido assim tão mais tão perfeito meu amor que supera completamente a perfeição meu amor tão mais tão maravilhoso meu amor tão fofo tão lindo e tão tudo que existe no universo inteirinho meu amor sem dúvidas alguma sua esposa tirou a sorte grande meu amor Ahhh meu amor meu esposo disse ai que a esposa é a sua anjinha da guarda meu amor pois sua esposa fala exatamente o mesmo meu amor meu marido é o meu verdadeiro anjinho da guarda meu amor o meu verdadeiro anjinho enviado por Deus meu amor o anjinho mais perfeito de Deus que Ele colocou na vida da sua esposa meu amor colocou na vida da esposa meu amor pra cuidar e proteger ela como ninguém meu amor sua esposa fica tão mais tão feliz e bobinha quando vejo meu anjinho cuidando da esposa meu amor pois através disso sua esposa da pra ver e sentir o amor do meu marido meu amor e sua esposa fica toda bobinha meu amor e ao lado do meu esposo sua mulher se sente verdadeiramente protegida meu amor Ahhhh meu amor sua esposa só tem a agradecer a Deus meu amor e ao meu esposo por tudo meu amor  .	1	
Ahhhh meu amor não precisa não minha vida e não fale isso meu amor rum meu amor somos infinitamente mais que casados meu amor e devemos sempre conversar sobre tudo um com o outro meu amor independente do assunto ser bom ou ruim meu amor não devemos nunca ocultar nada um do outro meu amor rum meu amor Ahhhh meu amor e sua esposa fala exatamente o mesmo meu amor meu marido é o tudo da esposa meu amor e sua esposa vai sempre	1	
Ahhhh meu amor sua esposa não está nada bem meu amor pois estou longe do meu marido meu amor e morrendo de saudade do meu esposo meu amor mais é tanta mais tanta saudade do meu marido meu amor sua esposa precisa tanto mais tanto do marido dela meu amor preciso do meu marido urgentemente meu amor	1	
Ahhhh meu amor sua esposa também amou tanto o textinho do marido dela meu amor cada palavrinha meu amor as coisas que meu esposo contou meu amor meu esposo conseguiu deixar a esposa bem emocionada com tudo meu amor Ahhhh meu amor tudo que sua esposa mais pede a Deus meu amor é que Ele a cada dia continue abençoando o nosso casamento meu amor que o tempo continue passando rápido assim meu amor para que possamos realizar todos os nossos sonhos logo meu amor porque é tão impressionante como o tempo ta passando tão rápido meu amor daqui	1	
Ai o marido tem que arrumar outra esposa	1	
Aqui e o marido dela o que vc quer com a minha esposa  .	1	
Assinado um marido que quase perdeu sua esposa pra sempre	1	
Cada esposa tem que ser bem safada com seu marido	1	
De tecnico EuFlavio domingues e esposa c filhosPedroRicardoEx tecnicos Aline com filho e silvia com filhos e marido umas amoresEx estagiarias AndressaHelaine Vc e família Jose e familiaDona tereza E soh uhul kkkk	1	
E é esposa do melhor amigo do meu marido	1	
Então meu amor minha vida amor da minha vida meu tudo Então meu amor minha vida amor da minha vida meu tudo então meu amor sua esposa também só quer sair se for com o marido dela bem grudadinho com ela meu amor  .	1	
Então meu amor minha vida meu tudo Ahhh meu amor somos meu amor a delícia um do outro meu amor minha vida amor da minha vida meu tudo Ahhhh meu amor pois sua esposa vai fazer sempre assim meu amor pra deixar meu marido doidinho meu amor Ahhhh meu amor vamos fazer do mesmo jeito é meu amor	1	
Eu qero me ver sendo sua esposa amor e vc meu marido  .	1	
Existem tipos de marido O pau mandado da esposa O romântico e que faz tudo O que bota ordem na casa E o corajoso dono dessa suzuki	1	
Meu amor sua esposa já está saindo pra ir pra gbi meu amor se sua esposa sair aqui e não responder o marido meu amor foi porque seu sogro desligou a internet ta bom meu amor	1	
O marido chega para a esposa e pergunta como é que tá a cara desse arroz aí	1	
O marido pode saber sim do jejum da esposa	1	
Ohhh meu amor então meu amor semana que vem tem que chegar logo meu amor Ahhh meu amor até parece que sua esposa vai largar o marido dela por um segundo meu amor vamos sempre ficar bem grudadinhos meu amor ahhh meu amor	1	
Ohhh meu amor não precisa ficar assim não minha vida sua esposa não quer que o marido dela se culpe por nada meu amor meu anjinho precisava falar o motivo por está tristinho sim meu amor pois somos mais que casados meu amor e temos que sempre resolver tudo juntinhos minha vida amanhã conversamos sobre tudo meu amor e resolvemos tudo direitinho como sempre fazemos ta bom meu amor Ahhh meu amor tem muita mensagem congelada meu amor mais sua esposa vai responder todas amanhã  .	1	
Ohhh meu amor sua esposa já parou de chorar aqui meu amor mais o que ta mais agoniando sua esposa meu amor é ver o marido dela assim meu amor sua esposa queria tanto mais tanto poder está agora bem grudadinha com meu esposo meu amor se eu pudesse meu amor juro que já estaria ai com meu esposo meu amor pra poder abraçar meu esposo bem forte meu amor dizer que eu te amo mais que tudo e que meu esposo é tudo pra mim meu amor e que sem meu esposo eu morro meu amor Ohhh meu amor meu esposo não tem que se culpar por nada meu amor sua esposa que errou em ter dito essas coisas meu amor sua esposa realmente não parou pra analisar tudo direitinho meu amor por isso que é tão ruim falarmos as coisas sem pensar meu amor pois só ocasiona isso meu amor então depois que meu esposo disse essas coisas ai sua esposa percebeu que realmente errou em ter dito essas coisas meu amor e não estou dizendo que concordo com meu esposo só pra ver meu marido mais calminho não meu amor estou dizendo porque realmente percebi que estou errado meu amor Ahhh meu amor o que sua esposa mais quer é poder realizar logo todos esses nossos sonhos e infinitos outros meu amor e com a mais absoluta certeza que o nosso casamento vai ser muito mais que perfeito meu amor ass	1	
#avô,	avó
A minha avó gosta de armar confusao e um dia vai apanhar no focinho do meu avô Mas pronto nos temos um restaurante e ela foi pegando nos restos dad pessoas	2	
Oi boa tarde Falei com o rapaz agorinha a bronca foi que precisa dos documentos da minha avó que é a pessoa do cartão que te mandei e não do meu avô  .	2	
Shter não vai dar pra gente fazer amanhã porque avó de Bia ou foi o avô faleceu então a gente	2	
A cuidar do meu avô porque a minha avó foi para o hospital	1	
A minha avó Já falou com o meu avô sobre isso	1	
A minha avó disse numa vez que chamaste de bode ao meu avô ou qualquer coisa assim	1	
A minha avó e o meu avô iao fazer anos de casados mas o meu avô faleceu	1	
A minha avó esta bue mal e o meu avô	1	
A minha avó está sempre em casa e o meu avô a trabalhar	1	
A minha avó morreu em março e o meu avô está a namorar com outra senhora por isso estou triste	1	
A minha avó não fez comer para o meu avô e tls deu merda	1	
A minha avó ta a dormir na sala e o meu avô saiu agr	1	
A minha mãe perguntou ao meu avô ele disse que não então a minha avó também já não vem	1	
A nha mas mae o meu pai o meu avô e a minha avó vai com a a nha irma à escola	1	
A serio A tua avó era irma do meu avô	1	
A tua avó andava muito produzida pro teu avô	1	
Agora é o meu avô e a minha avó	1	
Ainda vou a casa do meu avô e da minha avó	1	
As saudades cada vez sao mais minha querida avó sinto tanto a sua falta e a do avô	1	
Deixaste a prenda ni avô ou na casa da avó	1	
Deixaste a prenda no avô ou na casa da avó	1	
E o meu avô eu vou ficar com a minha avó	1	
E só para te dizer que vou embora hoje já falei com a minha avó e o meu avô vem me buscar daqui hora	1	
E trazes avó e se quiseres trazes tmb o teu avô se quiser vir	1	
Eles são d kkkk engraçado são as discussões da minha avó e do meu avô kkkkk é um papo de que pai era o mais feio tlgd kkkkkk	1	
Em a minha casa com o avô E com o rui a namorada do rui com a avó	1	
Era pra ligar ao teu avô que a tua avó faz anos  .	1	
Estou eu e o meu avô junto a lareira a ver TV e a minha avó e as minha mae estao deitadas la em cima para variar	1	
Eu ja a conheço a minha avó uma vez saiu de casa porque o meu avô o pos na rua	1	
Eu ouvi o avô a dizer chateado à avó que se tu quisesses estar comigo e com a Diana que viesses para cá	1	
Eu tenho a nha bisavó no hospital a nha avó em recuperaçao porq a pouco tmp teve o cancro o meu avô é o unico q ta bem	1	
Eu vou ter que ficar ajudando a minha avó olhando o meu irmão pq minha mãe vai fazer companhia ao meu avô que ta internado no hospital com câncer muito agrecivo entende	1	
Foi no dia em que eu tive contigo Quando eu e o meu avô fomos comprar a prenda pra minha avó N foi	1	
Hum bom de mais estudar nee Rsrs meu bb e como anda sua mae sua avó ou melhor minha futura avô e minha sogra	1	
Mas ele não é mesmo meu avô mas ja está c a minha avó á anos mas trato lhe como avô na msm	1	
Meu avô faleceu ha anos e o Fernando a minha avó faleceu ha semanas era conhecida por Augusta Pacheca os teus pais conhecem bem	1	
Meu avô materno é alemão e minha avó materna é de Portugal	1	
Meu avô vai pra igreja ai vou ter q ajudar minha avó no bazar dela	1	
Mh avó passa o dia todo com meu avô no hospital mh tia só quer ta nas festa nn bota os pés no hospital pra tirar a mãe meu tio eu sei que trabalha e tal mais final de semana ella nn vai lá	1	
Minha avó também teve meu avô tá com princípio de pneumonia o que matou minha avó perdi um tio meu pai é ameaçado de morte todo dia por gente babaca meu avô também e pessoas da família	1	
Mudei me para Amarante por causa da minha avó e fui pro csg depois mudei me pra casa do meu avô q é aqui em Santo Isidro City e fui pro Liceu	1	
N vou passa o natal com a família materna em q somos pessoas só vou a minha avó no dia porque é o niver do meu avô	1	
Nao es a primeira nem seras a ultima que se apaixone por uma pessoa mais velha o meu avô fazia anos de diferença da minha avó	1	
Neu avó marido dela meu avô ja faleceu para ai anos nka teve mais ninguém nem se veste bem nem sai de casa respeito	1	
Nos vamos diretos para a casa dos meus avós eu aviso quando chegarmos lá pk devemos de ficar lá um tempo pk a minha mãe tem que ajudar o meu avô a despir se pk a minha avó tá no hospital	1	
O meu avô acho que nao mas a minha avó ja	1	
O meu avô apanhou uma infecao esta no hospital a minha avó a quimioterapia n fez nada esta mal	1	
O meu avô e bisavó a minha avó tava em casa	1	
O meu avô virou costas e a minha avó ficou a chamar lhe a atenção	1	
Obg fofa esta na casa da minha avó e do meu avô	1	
#noivo,	noiva
Adorei esse poema KkkkkkkkkO noivo escreveu um poema pra noiva um pouco antes do casamento  .	3	
A lyly tenta pega o celular dele falando Amooor devolve Era varias mensagens de um cara pedindo pra se encontrar com ela i ela respondendo que era noiva e tinha um filho e que ia mandar o noivo dela matar ele e o cara mandando risadas não acreditanso	1	
Adorei esse poema KkkkkkkkkO noivo escreveu um poema pra noiva um pouco antes	1	
Bom diaa Gente vcs assistem a novela Apocalipse da Record Que chocante o Arrebatamento Vcs viram Forte E é examente assim que vai acontecer portanto vamos estar sempre orando e vigiando pra quando o noivo vier buscar sua noiva que somos nós a igreja estejamos preparados para irmos ao encontro do noivo que é JESUS CRISTO estejamos como as cinco virgens prudentes com nossas lamparinas acesas amém Beijo á todos meus amigos e amigas do face	1	
Eu vou ser o noivo e ela a noiva é diferente	1	
Mas o noivo nao pode ver o vestido da noiva	1	
O noivo nao pode ver o vestido da noiva nao	1	
O único casamento na minha cidade que o noivo chegou minutos depois da noiva	1	
Olha como a Dani falou sou noiva e meu digníssimo noivo é ciumento e onde eu vou tem um conhecido sair assim é meio ruim pq sempre tem um que me ver  .	1	
Que noivo é esse que nem consegue escolher uma aliança pra noiva	1	
Te amo muito noiva Feliz Tenho muito orgulho em apresentá la como meu noivo e dizer que você é meu futuro esposo  .	1	
e outro que estavam tambem algumas pessoas e o noivo tinha que descubrir quais eram as pernas da noiva e ele descubrio	1	
#avô,	avó
A minha avó gosta de armar confusao e um dia vai apanhar no focinho do meu avô Mas pronto nos temos um restaurante e ela foi pegando nos restos dad pessoas	2	
Oi boa tarde Falei com o rapaz agorinha a bronca foi que precisa dos documentos da minha avó que é a pessoa do cartão que te mandei e não do meu avô  .	2	
Shter não vai dar pra gente fazer amanhã porque avó de Bia ou foi o avô faleceu então a gente	2	
A cuidar do meu avô porque a minha avó foi para o hospital	1	
A minha avó Já falou com o meu avô sobre isso	1	
A minha avó disse numa vez que chamaste de bode ao meu avô ou qualquer coisa assim	1	
A minha avó e o meu avô iao fazer anos de casados mas o meu avô faleceu	1	
A minha avó esta bue mal e o meu avô	1	
A minha avó está sempre em casa e o meu avô a trabalhar	1	
A minha avó morreu em março e o meu avô está a namorar com outra senhora por isso estou triste	1	
A minha avó não fez comer para o meu avô e tls deu merda	1	
A minha avó ta a dormir na sala e o meu avô saiu agr	1	
A minha mãe perguntou ao meu avô ele disse que não então a minha avó também já não vem	1	
A nha mas mae o meu pai o meu avô e a minha avó vai com a a nha irma à escola	1	
A serio A tua avó era irma do meu avô	1	
A tua avó andava muito produzida pro teu avô	1	
Agora é o meu avô e a minha avó	1	
Ainda vou a casa do meu avô e da minha avó	1	
As saudades cada vez sao mais minha querida avó sinto tanto a sua falta e a do avô	1	
Deixaste a prenda ni avô ou na casa da avó	1	
Deixaste a prenda no avô ou na casa da avó	1	
E o meu avô eu vou ficar com a minha avó	1	
E só para te dizer que vou embora hoje já falei com a minha avó e o meu avô vem me buscar daqui hora	1	
E trazes avó e se quiseres trazes tmb o teu avô se quiser vir	1	
Eles são d kkkk engraçado são as discussões da minha avó e do meu avô kkkkk é um papo de que pai era o mais feio tlgd kkkkkk	1	
Em a minha casa com o avô E com o rui a namorada do rui com a avó	1	
Era pra ligar ao teu avô que a tua avó faz anos  .	1	
Estou eu e o meu avô junto a lareira a ver TV e a minha avó e as minha mae estao deitadas la em cima para variar	1	
Eu ja a conheço a minha avó uma vez saiu de casa porque o meu avô o pos na rua	1	
Eu ouvi o avô a dizer chateado à avó que se tu quisesses estar comigo e com a Diana que viesses para cá	1	
Eu tenho a nha bisavó no hospital a nha avó em recuperaçao porq a pouco tmp teve o cancro o meu avô é o unico q ta bem	1	
Eu vou ter que ficar ajudando a minha avó olhando o meu irmão pq minha mãe vai fazer companhia ao meu avô que ta internado no hospital com câncer muito agrecivo entende	1	
Foi no dia em que eu tive contigo Quando eu e o meu avô fomos comprar a prenda pra minha avó N foi	1	
Hum bom de mais estudar nee Rsrs meu bb e como anda sua mae sua avó ou melhor minha futura avô e minha sogra	1	
Mas ele não é mesmo meu avô mas ja está c a minha avó á anos mas trato lhe como avô na msm	1	
Meu avô faleceu ha anos e o Fernando a minha avó faleceu ha semanas era conhecida por Augusta Pacheca os teus pais conhecem bem	1	
Meu avô materno é alemão e minha avó materna é de Portugal	1	
Meu avô vai pra igreja ai vou ter q ajudar minha avó no bazar dela	1	
Mh avó passa o dia todo com meu avô no hospital mh tia só quer ta nas festa nn bota os pés no hospital pra tirar a mãe meu tio eu sei que trabalha e tal mais final de semana ella nn vai lá	1	
Minha avó também teve meu avô tá com princípio de pneumonia o que matou minha avó perdi um tio meu pai é ameaçado de morte todo dia por gente babaca meu avô também e pessoas da família	1	
Mudei me para Amarante por causa da minha avó e fui pro csg depois mudei me pra casa do meu avô q é aqui em Santo Isidro City e fui pro Liceu	1	
N vou passa o natal com a família materna em q somos pessoas só vou a minha avó no dia porque é o niver do meu avô	1	
Nao es a primeira nem seras a ultima que se apaixone por uma pessoa mais velha o meu avô fazia anos de diferença da minha avó	1	
Neu avó marido dela meu avô ja faleceu para ai anos nka teve mais ninguém nem se veste bem nem sai de casa respeito	1	
Nos vamos diretos para a casa dos meus avós eu aviso quando chegarmos lá pk devemos de ficar lá um tempo pk a minha mãe tem que ajudar o meu avô a despir se pk a minha avó tá no hospital	1	
O meu avô acho que nao mas a minha avó ja	1	
O meu avô apanhou uma infecao esta no hospital a minha avó a quimioterapia n fez nada esta mal	1	
O meu avô e bisavó a minha avó tava em casa	1	
O meu avô virou costas e a minha avó ficou a chamar lhe a atenção	1	
Obg fofa esta na casa da minha avó e do meu avô	1	
#irmão,	irmã
mas ele tbm o faz por causa da amada dele mas q eu saiba ela tbm tem maos para se defender e n precisa de um guarda costas mas ele e q sabe o q faz simplesmente eu n gosto q batam no meu irmão ta bem q ele as vezes pode as merecer mas imaginesse no meu lugar acha q uma irmã mais velha q tem por obrigação defender o irmão gosta de ver os mais velhos a baterlhe Ninguém sabe o q se passa cmg mas sabe o q e acordar tds os dias e pensar q a sua vida ja n faz sentido Pensar q morrer vai ser a solução Sabe o q e acordar tds os dias e dizer para si propria mais um dia com esta maldita depressão ja pensou nisso Pois eu ns se ja pensou mas eu penso e agr fica a pensar pq q eu tou a dizer isto ne Pois eu sofre de depressão e ela ta cada vez pior  .	18	
Meu irmão amigos dele Minha irmã	3	
Amiga igual uma irmã nossa q amiga que cuidar de igual um irmão  .	2	
Aquele irmão mais novo ao qual devemos toda proteção e a irmã mais velha que fique de cabelos brancos com nós  .	2	
Se eu tivesse uma irmã por parte de mãe eu não iria saber dividir ela com meu irmão  .	2	
eu só vou dizer assim para você eu escrevo eu não mando áudio então eu escrevo um monte de texto aí você vai ver se sou eu ou minha irmã a eu vou mostrar a mensagem que o seu irmão mandou para minha irmã tá Daqui a pouco eu falo com você eu acho porque o celular dela tá descarregando então eu vou ter que colocar carregar vou ter que colocar para carregar também	2	
A irmã de lukinha eo irmão soltando piada	1	
A minha irmã deu me umas New balance e umas calças O meu irmão deu me uma camisola euros e se calhar vai me dar um smartwatch mas não tenho a certeza	1	
A minha irmã perguntou se o teu irmão já chegou	1	
A minha irmã que não é de sangue mas meu irmão é	1	
A minha irmã ta na casa do meu irmão então não fomos	1	
A minha irmã tbm é mais velha e o meu irmão é mais novo	1	
A minha irmã é filha do mesmo pai e da mesma mãe que eu o meu irmão já é só filho da mesma mãe que eu e do meu padrasto	1	
A minha mãe porque eu não né aptecia arrumar a casa o meu irmão porque lhe fui pedir um cigarro e a minha irmã porque eu não lhe liguei eu nem tenho o tele carregado e ela tem mas pronto	1	
A mulher do meu irmão ta grávida e minha irmã mais velha tbm	1	
A tua irmã deve conhecer o meu irmão	1	
A tua irmã e o meu irmão não param de falar	1	
A yanna olha pra ele e fala Aaah que lindo vc me chama de mentirosa e depois vem cuidar de mim ela levanta se afastando e fala Eu não menti meu irmão gosta da sua irmã sim ele só não demostrar mais ele disse isso pra mim ele me mostrou o sonho que teve eu não só mentirosa ele me bateu por sua causa e meu irmão nunca nunca me bateu ela chora caindo no chão	1	
Ai estou indo na minha irmã ai chega e pede pro meu irmão vou deixar falado com ele	1	
Amizade igual a sua da sua irmã e do seu irmão vale ouro amo vcs Obg por vcs existirem	1	
Amo muito vcs meu querido irmão e minha mais que cunhada uma irmã amiga	1	
Amor escondido cap Js nao sabia que a irmã do jungkook era bonita assim puxou pro irmão Ls para menina louca S/n eu ainda não sou irmã do jungkook Rs do mesmo jeito eu ouvi a treta e fiquei triste por vc Jn vdd foi horrível aquela menina é um saco S/n eu estou bem agora ela eu não sei Jh eu conheci elas estes dias e eu sabia que vc gostava delas então trouxe ela v	1	
Ana Minha irmã adormeceu com meu sobrinho A Minha mãe vai pa cama meu pai saiu o meu irmão tem escola já se vai deitar a minha outra irmã Tá nu estágio eu vou me lavar e vou me deitar um pouco	1	
Assusta os seu irmão cm qualquer coisa ou sua irmã ou seus pais	1	
Boa tarde mariana vc vai que dia visista seu marido eu gostaria de um favor seu tem como vc falar com meu irmão ELI pra ele colocar o nome da minha irmã Neia no rol de visita pq ela já mandou os documentos mas não tem como ela ir visitar	1	
Boa tarde é bom eu queria que vocês do programa da Eliana dance isso que chamasse minha mãe para o Beleza Renovada minha mãe tem um restaurante muito difícil criou filhos sozinha e meu pai judia muito dela e ela tem feridas nas duas pernas ou será varicose e e ela é tudo para mim se acontecer alguma coisa com ela eu não sei o que vai ser de mim e eu tenho uma irmã de e eu tenho e dois irmão meus adulto e queria muito que você chamasse ela programa para mim ver ela feliz porque depois do casamento mesmo só teve Tristeza na vida dela eu vejo tudo isso todos os dias minha mãe chora todos os dias de madrugada causa da dor na perna e	1	
Bom dia dona ana olhe estou no caminho do meu interior meu irmão veio pegar eu e minha irmã de da madrugada meu pai ta muito mau no hospital	1	
Bom dia meu irmão acabou o encanto pela sua irmã	1	
Bom dia prima Desculpa ontem nao ter respondido mais o santi em relação a irmã porta se bem e tem reagido bem é um irmão galinha so a quer proteger	1	
Bom eu tenho uma irmã que mora com minha mae no Rio e um irmão que naum conheço por parte de pai	1	
Brincava eu ele a irmã dele e o outro irmão	1	
Cm minha tia minha irmã minha prima meu irmão e etc	1	
Coitada da minha vó Pq Ela perdeu o irmão esse ano e ano passado a irmã	1	
Com minha irmã minha mãe e o meu irmão kkk	1	
Da minha irmã e do meu irmão só rapazes	1	
De hoje Ano novo com a minha coroa com meu irmão gta e com minha irmã cabana kkk	1	
E nas coisas horríveis que a irmã do Daniel tem feito contra o irmão e a mim	1	
E pc minh irmã mes ela precisa agr outra tablet meu irmão Lol so mimo	1	
Ele meu irmão mas velho minha irmã casada e o marido	1	
Ele ontem teve em minha casa porque veio com o irmão do namorado da minha irmã buscar o namorado da minha irmã e eu dei a minha prenda ao irmão do namorado da minha irmã e era uma saca pequena e o André disse é um anel vai lhe pedir em casamento e eu disse não é nada eu não vou casar com ele e ele pois não é comigo	1	
Ele para mim é um irmão mais velho pq ele smp me tratou como uma irmã mais nova e tb ele smp me chamou de irmã	1	
Ele para mim é um irmão mais velho pq ele smp me tratou como uma irmã mais nova e tb p	1	
Ele é meu irmão meu amigo companheiro e tudo que um irmão é na vida de uma irmã	1	
Elice depois vc manda zap pro Mimi pra saber se a Lorrane falou com a irmã dele sobre a questão de onde o irmão dele ta no CDP	1	
Ent teve um tempo q ele me ajudou mto com uns bglhs ai ele me apelidou de irmã e eu apelidei ele de irmão  .	1	
Eu minha irmã aquela moreninha que anda com a gente meu irmão o amigo do meu irmão e meu pai	1	
Eu não vejo mal na foto de um irmão estar a tapar os seios da irmã mas respeito a vossa Política mas acho que não tem mal	1	
Eu queria uma Timberland sempre ai em minha irmã pegou e me deu essa de presente fui com o meu irmão procurar ai achamos essa a Timberland é muito cara mas é parecida com a Timberland enfim um dia vou comprar uma Timberland	1	
Eu queria uma Timberland sempre ai em minha irmã pegou e me deu essa de presente fui com o meu irmão procurar ai achamos essa a Timberland é muito cara mas é parecida com a Timberland enfim um dia vou comprar uma Timberland Nos EUA deve ser bem mais barata pq é muito fácil ver uma pessoa lá com uma  .	1	
Eu quero e pra mim irmã e pro meu irmão este tem e anos	1	
#rei,	rainha
mas a unica cena que me manteve feliz e constante foi a nossa relação Foi nesse ano que te tornast meu marido assim como me tornei tua mulher Meu rei assim como sou tua rainha Meu banana assim como sou teu pêssego Meu tigre assim como sou teu ursinho Te tornast mta coisa principalmente tornast te no homem da minha vida que n quero perder e que quero ficar pra sempre junto a ti até realizarmos todos os nossos sonhos como ter os nossos babys a nossa casa e os nosso carros Neste ano tbm me ensinast verdadeiramente o que é amar e n conseguir viver sem uma pessoa por mto tempo  .	28	
Trate uma mulher como uma rainha e ela vai te tratar como um rei  .	3	
A rainha sempre protege o rei  .	1	
Bem se tu és o rei es o mais doido tal como a rainha	1	
Convidas me para outro dia para o rei estar ai com a sua rainha	1	
Ele rapidamente raptou a rainha para matar mas por deus knuckles uganda o rei knuckles apareceu e salvou a rainha porem ele deu a sua vida para a proteger  .	1	
Em fim nomearam a a rainha e ela governou com o rei knuckles mas o q menos esperavam e q o logan paul matador de knuckles aparece se	1	
Em que vc é a rainha e eu o rei	1	
Eu gosto de sentir que ganho sempre algo digamos todo o rei tem a sua rainha	1	
Eu sou a rainha do cantinho e ele o rei ksksksksksk Irmaos yah	1	
Guando o rei sai ele passa o comando pr sua rainha ent n venha fl coisa pra a rainha ok	1	
Ivo mas podes me chamar de rei e ser a minha rainha	1	
Me sinto uma rainha estando com um rei como tu obrigado amor por fazeres o que te peço isso é muito importante tz amo por me respeitares	1	
Neste caso seria em mim a rainha de espadas e na minha namorada o rei de espadas	1	
O menino q era o deus the way depois de alguma historias eles e ele precisavam de uma governadora entao o rei pediu para eles irem em busca da rainha the way mas o q menos eles esperavam era isso  .	1	
Olha raiara eu quero te dizer o meu amor sera o o que vc nunca vai conhecer por favor me perdoa o que eu sinto por vc eu nunca senti por outra mina quero um dia te chamar de amor tu vim na minha rua e nos mete o terror fazer competição de balansinho noz dos apostando quem perde lava a louça de deixar bem bunitonho so quero te dizer se algo eu estraguei vamo começar de novo dai eu te trato igual rainha e tu me trata igual um rei	1	
Percebeste O Rato roeu a rica roupa do rei de Roma A rainha raivosa rasgou o resto e depois resolveu remendar Em rápido rapto um rápido rato raptou três ratos sem deixar rastros  .	1	
Porque no final do dia se matasse o piao tinha mais hipóteses de ganhar e matando a rainha perdia o meu rei	1	
Roteiro sonhos de uma noite de verão Atores Erick atuara como Oberon Maria atuara como Titânia Vitor Barbosa atuara como Puck Flávio atuara como Lisandro Kamily atuara como Hérmia Gabriel Testa atuara como Demétrio Giovana atuara como Helena Guilherme atuara como Bobina Cenas A cena se inicia na floresta das fadas onde entram a rainha Titânia e o rei Oberon discutindo como sempre sobre algo de pouca importância Oberon Erick Você viu que absurdo Titânia Esses casais de hoje em dia não respeitam as tradições vivem se distraindo com esses celulares e tablets  .	1	
Se eu fosse rei tu ers a minha rainha	1	
Serás sempre a rainha e eu o rei	1	
Sou um rei por ter uma rainha tao linda comigo	1	
Só sou rainha se tu fores o meu rei  .	1	
Tu és o meu rei e eu a tua rainha  .	1	
eu sou o rei e tu a rainha disto	1	
eu sou o rei e tu a rainha disto ficava assim o tempo todo	1	
eu sou o rei e tu a rainha disto ficava assim o tempo todo essa tua linfua	1	
eu sou o rei e tu a rainha disto ficava assim o tempo todo essa tua língua	1	
mas a unica cena que me manteve feliz e constante foi a nossa relação Foi nesse ano que te tornast meu marido assim como me tornei tua mulher Meu rei assim como sou tua rainha Meu banana assim como sou teu pêssego	1	
mas a unica cena que me manteve feliz e constante foi a nossa relação Foi nesse ano que te tornast meu marido assim como me tornei tua mulher Meu rei assim como sou tua rainha Meu banana assim como sou teu pêssego Meu tigre assim como sou teu ursinho	1	
mas a unica cena que me manteve feliz e constante foi a nossa relação Foi nesse ano que te tornast meu marido assim como me tornei tua mulher Meu rei assim como sou tua rainha Meu banana assim como sou teu pêssego Meu tigre assim como sou teu ursinho Te tornast mta coisa	1	
mas a unica cena que me manteve feliz e constante foi a nossa relação Foi nesse ano que te tornast meu marido assim como me tornei tua mulher Meu rei assim como sou tua rainha Meu banana assim como sou teu pêssego Meu tigre assim como sou teu ursinho Te tornast mta coisa principalmente tornast te no homem da minha vida que n quero perder e que quero ficar pra sempre junto a ti até realizarmos todos os nossos sonhos como ter os nossos babys a nossa casa e os nosso carros Neste ano tbm me ensinast verdadeiramente o que é amar	1	
És meu rei e eu tua rainha	1	
És meu rei e eu tua rainha acredita foi difícil vir embora cria estar muito mais tempo contigo e desculpa fugir de ti na rua por causa de não gostar dakela rapariga	1	
#filho,	filha
Seus pais são separados Você é filha do primeiro casamento Você não conhece seu pai É filho adotivo Não tem filhos Não conheceu seus avós Não mora com seus pais Por que sua família é das do tipo italiana em que todos falam junto muitos parentes muita exaltação e sentimentos a flor da pele Por que você necessita dessa família como instrumento de sua evolução Para curar a falta paciência o stress a tensão emocional Por que sua família é do tipo alemã com pessoas mais introvertidas com tendência a serem mais reprimidas Por que você necessita dessa família como instrumento de sua evolução Para curar a baixa estima a dificuldade de falar e se expressar a rigidez emocional Por que você é um filho único Por que você necessita dessa família como instrumento de sua evolução Para curar o egoísmo o autoritarismo a carência Por que você é o irmão mais velho entre nove Por que você necessita dessa família como instrumento de sua evolução Para curar a carência o abandono a autorenúncia Por que nasceu em uma família rica Por que nasceu em uma família pobre Pense um pouco sobre isso reflitaNão se entristeça não se vitimize nada absolutamente nada está errado  .	4	
Agradeço cada coisa que passei cada coisa que aprendi e só tenho que agradecer filha você me ensinou que amor maior que pelo filho a não existe  .	2	
Hoje minha filha tem anos de idade e meu filho anos mas jamais me esqueço do nosso primeiro olhar assim quando eles me olharam pela primeira vez  .	2	
Meu filho só faltou minha filha	2	
A Liria da um grito e geme colocando a mão na boca e pegando o filho dele com tudo ela vira os olhos e a filha dela chega a pinga ela sorri e senta na boca dele	1	
A Liria geme baixinho e sorri e fala Então vc quer provocação ela sorri e vira de costa e rebola lentamente no filho dele passando a filha dela ela sorri e da uma arranhadinha	1	
A kenne abraça ele e passando a perna por cima dele e a filha dela fica encostada no filho dele	1	
A lyly sorri e senta com tudo encima do filho dele e dava pra sentir a filha dela molhadinha	1	
A lyly sorri pega o filho dele da um beijo sorrindo e passa na filha dela que tava muitooo molhada	1	
A minha filha tem O meu filho tem	1	
A minha filha tem o meu filho tem	1	
Aaaaaa mas se a filha sai puxando o pai então o filho sai puxando a mãe eita que filho sortudo que vamos ter	1	
Acredito eu amo muito a minha boneca como a filha metem se com elas vai ser o caralho podes por isso na cabeça filho  .	1	
Aeeee a preta gil nao tem filha mulher só um filho e homem  .	1	
Ai my cunhada perguntou a ela si ela tiverse uma filha sapatona ou um filho viado oq ela fazia ai ela nn respondeu	1	
Ai teu filho vai ficar pedindo chocolate e tu vai gritar com teu filha ai ele vai falar calma amor é só uma criança	1	
Ami cre so felisidad pa bu filha apenas cre cria nha filho djunto cu ela	1	
Até porque seu filho iria ficar perguntando quem era eu e meus filhos também minha filha de doze anos então	1	
Ben Mal Evie o filho do DungaJay a filha da mulanCarlos a filha da fada madrinha Tu fernando Eu decepção	1	
Boa tarde mãe zonas tenho uma filha que irà fazer anos em abril e pretendo ter outro filho só tenho um pouco de resenho por ela ainda ser muito pequena tenho medo de como ela vai reagir tendo outro bebe em casa ela è muito manhosa rs e vcs mamaes que tiveram l segundo filho qual foi a diferença de idade e como foi a experiencia Tenho medo de não dar conta pois minha pequena è muito bagunceira	1	
Casei tenho uma filha de anos tenho filho de anos neto de anos e vou ganhar neta no final do ano	1	
De casa deichou a filha e e o filho da irma dela	1	
E ai lado e o filho dela e em cima ao lado da mafalda a filha	1	
E vc como está no casamento e sua filha Quando vai ter outro filho	1	
Ea filha foi na escola e o filho tão dormindi	1	
Ela cuidou de mim e eu cuidava da filha dela e o filho dela seria meu afilhado	1	
Ele ontem falou p minha filha que o motivo de ter ido embora foi meu filho e eu fico imaginando quanto desamor	1	
Ele tava ai todo fim de semana com a mulher dele a Vanda o Lyncon filho dele e a Nicole essa da foto filha dele tbm	1	
Engraçado que antes de eu engravidar do meu filho eu era tudo minha filha então nem se fala ele fazia questão de que ela o chamasse de pai  .	1	
Entao e novidades Olha o meu convidou me de manha para ir com ele buscar o filho quando ey disse que eatava com a minha filha e que ela também ia ele disse logo que deixa tar atao eu se me apetecer dwpois vou ter com voces  .	1	
Entao é melhor parar por aqui e nunca proibir do jones falar e ver o filho dele pq eu tenho uma filha e mesmo nao tivesse filho eu nao ia proibir	1	
Era assim ó eu falava antes dela nascer antes das horas será que eu sou mais velha assim o mãe nunca mais tenha outro filho aí chegou ela falou assim filha estou grávida mãe se não for menino eu vou me matar mas só porque eu não ia fazer isso aí tá foi ela	1	
Eu agora a dias quando ela derramou por o gerson ter dito aquilo no vídeo a jurar pragas eu disse a ela olhe mas você quer nos mal vocês fala mal de nos você ralece Mase com apraga que a sua filha disse para o casamento do seu filho isso sim foi direto para nos você se quisesse o seu filho levantava lhe a mao e dava lhe um estalo e ela ai isso nao tem nada ver e eu tem aver so que a você nao lhe cheira imagine como tou eu e o gerson com ela mas Deus e grande	1	
Eu cuando eu batizar o meu filho ou a minha filha tu vais sre madrinha	1	
Eu disse q jogar um filho ou abandonar seria se eu fosse embora ficar com ele e deixasse minha filha	1	
Eu falei com marquinho pq ele chingou tal mas nunca encostaria a mao no filho dos outros nao pq se fosse minha filha eu matava de porrada	1	
Eu gosto muito do seu filho mesmo vc nao quiser acredita pq eu tbm tenho uma filha	1	
Eu nao sou cega ta meu filho é lindo mais lindo que sua filha ta kkk	1	
Eu não tenho ninguém que goste de mim k fique comigo numa relação seria claro e com meus filhos não tenho com quem conversar não tenho nada só tenho o amor do meu querido filho que quando me vê a chorar agarra se a mim a minha filha anda mais virada para o face poriço	1	
Eu que quero que você chupe mis pechos bien gostoso que agora minha filha está aqui com meu filho	1	
Eu também nao mas o filho vai ser lindo a tua filha também por isso eles vao querer ficar juntos	1	
Eu vou te dar um filho mor ou uma filha mor	1	
Filho é algo tão maravilhoso tão lindo um amor tão puro tão intenso que até Deus quis um mas não satisfeito com um só resolveu fazer toda a Humanidade e lhes da a oportunidade de serem chamados filhos de Deus Obrigada Meu Pai pelo privilégio de ser sua filha e de poder ter um filho Te Amo meu Pai meu Deus	1	
Ha um filha da puta igual a mim vestido de travesti e este filho da puta quando o apanhar vou mata lo	1	
Imagina vc ver seu filho entrando e saindo da minha filha	1	
Jamais vou chingar brigar com sua filha por causa do meu filho ela não gosta mais dela então eli tem que seguir em frente ela a mesma coisa	1	
Kenne sorri e fala Tem certeza que vc quer um banho ela sorri e senta no colo dele e a filha dela encosta no filho dele e ela sorri	1	
Lorezo olha pro filho dele que entra com tudo na filha dela ele sorri e fala Bom dia amor	1	
Manda me foto do teu filho e da tua filha	1	
Mano tipo eles falam incesto é errado Bem pelo menos na catequese Mais tipo tem adao e eva taAdao mais eva um filho adao mais eva uma filha tempo mais adao e eva morte como vao continua a se multiplicar incesto entao que conclusão chegamos NAO TEM NADA DE ERRADO EM INCESTO	1	
#pai,	mãe
Oiii armys esse imagine foi baseado em fatos reais só que não aconteceu comigo foi com uma amiga essa é a Sinopse amanha saíra o próximo episódio e como eu tinha dito no imagine anterior Fim de Semana não tem Imagine okSinopseEstranho Com certeza Meu nome é S/n tenho anos e estou na ano do ensino médio sou de Busan mas tive que vir para Seoul pq meu pai morreu então vim morar com minha avó e minha mãe esta no Canadá  .	25	
Nasceu um bebê e minutos depois começou a falar E o bebê falou Eu nasci pra viver sómente dias e minha mãe vai morrer em dias e o meu pai vai morrer em dias  .	6	
Telefone para contato Data de nascimento / / Nome da mãe Maria Mirtes Pereira da Silva Nome do pai Raimundo da Silva Carvalho  .	6	
Capítulo Chego a casa com o Taehyung S/n não precisava de fazer aquilo Taehyung T claro que precisava não os ia deixar magoar teS/n obrigada Taehyung Ele sorri para mimT olha vou pousar a mochila ok S/n okEle sobe as escadas eu ouço a porta a abrir S/n pai S/p s/n Eu abraço o meu pai que já não via há muito tempo nesse momento o Taehyung desce as escadas T olá S/p quem é este S/n tenha calma pai este é o Taehyung é um amigo meu mas como ele não tem casa eu disse que ele podia morar aquiO meu pai olha para ele com desprezo S/m s/p deixa o rapaz em paz é um amigo da sua filha bem vindo Taehyung Eu abraço a minha mãe entre ela e o meu pai sempre preferi ela ela sempre foi mais compreensiva S/m bem  .	5	
Queria agradecer a minha mãe e ao meu pai pois sem eles eu não teria nascido  .	5	
Olha babe as coisas q eu vou disser aqui é só pra ficares a saber ok mas tem a ver com a cena q se passou à bocado pq eu disse te q n havia problema pq a minha mãe era a única em casa e o meu pai tá fora e tipo se eu incesti em tar ali é pq sei o q to a fazer e tbm tenho a noção q nós já n teremos muito tempo juntos pq na Sexta tenho treino ainda n sei a q horas e tu queres fazer a prank depois este fim de semana n posso tar cntg pq vou pra Ericeira e depois na próxima semana to cntg na Sexta e no jogo ao q parece depois tenho um casamento e n posso tar cntg e depois e só até pro ano literalmente e depois eu gosto de ti e gosto de tar cntg pq a minha vida anda literalmente uma merda e tu és a única coisa boa q eu tenho nela	4	
meu pai casou com a minha mãe  .	4	
E eu sei que nós somos para sempre pelo simples fato de que eu me canso de tudo muito rápido mas com você não é assim meses juntos os melhores meses da minha vida É contigo que eu quero casar é contigo com quem eu quero viver e é contigo que eu quero ter filhos tentar ser o melhor pai do mundo porque eles a melhor mãe de certeza que irão ter Já passamos por mts aventuras juntos mts tolices meu amor já passamos por MTTT bons e maus momentos mas o amor que sentimos um pelo outro é mais forte do que tudo e todos minha mulher linda e perfeita TE QUERO PARA A MINHA VIDA TODA ME FAZES MAIS FELIZ DO QUE ALGUMA VEZ EU PODE SE SER QUANDO ME PERGUNTO A MIM MESMO SE EU GOSTO DE TI EU ME RESPONDO NÃO EU NÃO GOSTO ESTE SENTIMENTO É MTTT FORTE PARA SER GOSTAR POIS EU TE AMOOO MINHA MULHER LINDA E PERFEITA TE QUERO PARA A MINHA VIDA TODA MINHA MULHER LINDA E PERFEITAJUNTOS PARA SEMPRE	3	
E saiba não há nada mais emocionante e gratificante Quando uma mulher se torna mãe ou um homem se torna pai as emoções passam a ser vividas em dobro  .	3	
Eu tó com saudade da minha mãe e do meu pai amo vcs	3	
Isso que da o pai morrer n tiroteio e a mãe morrer no parto do irmão	3	
Ninguém enxerga o pai da criança que vive nos role por aí mas enxerga a mãe e a crítica por esta nos role  .	3	
Porquê porque tipo eu fui para minha mãe né aí encontrei dois cara eles são amigos do meu pai entendeu e eu tava sozinha tinha ninguém comigo eu e eles perguntaram você tem primo falei tenho irmão tenho também aí ele falando assim e namorado tou	3	
Quando você estava no ventre da sua mãe era um ser bem minúsculo um pedacinho de sua mãe Rafaela Gomes eu do seu pai Alex Silva sua mãe me presenteou com esse bem maior que é você meu afilhado ela me disse que eu ia ser seu padrinho é foi à melhor notícia que eu recebi aquele dia  .	3	
A do meu pai e da minha mãe	2	
Ainda não deu o meu pai não esta em casa e a minha mãe esta a aspirar	2	
Alô Oi Giovana Oi você está em casa já saiu para buscar seu pai a gente tava aqui Não voltou para casa minha mãe ficou aqui Ah eu pensei que ela ia trazer vocês para casa não entendi tá certo para ela	2	
Aqui minha mãe está perguntando se tem como vc perguntar o tio Pedro ou a sua mãe qual era o nome do vô dela o pai do vô bituta	2	
Cheguei em ksa fui almoçar aí pai chegou cm peixe fui ajudar mãe tratar  .	2	
Chico aponta uma arma para sua mãe por que seu pai nem aqui tá	2	
E pq eu to começando a mim corta de novo por certas coisas que tao acontecendo cmg eu acabei de brigar com a minha mãe briguei com o meu pai minha avó ta muito doente no hospital nao sei mas Oque eu faço eu to mim cortando pra ver se essa dor passa mas nao quer passa dar vontade as vezes e de morre nao existir	2	
E tanta coisa jef e pai e irmão e mãe e a família e escola e tudo e eu já to cansada Tipo	2	
Eita mais e uma pequena mais linda da minha vida meu dengo como eu amo vc pequena da prima quando eu soube da sua existência eu ja te amava tanto dentro da barriga da sua mãe eu passava a mao e sentia vc mechendo e falava eita minha pequena mechendo agora olha que coisa mais linda da minha vida minha pequena que mais amo e a prima vai estar aqui sempre o que precisa e sua mãe sabe disso vc tem uma mãe maravilhosa pequena Karen Gabriela e um pai super atencioso Edwim Guedes vc tem uns pais maravilhoso pequena que vai te proteger sempre minha pequena e parabéns minha prima forte que tenho por ter aguentado esse parto pra nossa chegada da nossa pequena amoooo vcs duas minhas linda e sabe que o que precisa estarei aqui pra te ajudar  .	2	
Então e tu não queres que o teu pai volte para a minha mãe	2	
Eu sei eu percebo q vc tentar ajudar eu tbm reclamo cm ela as vezes mas ela precisa de um pai e de uma mãe pra apoia lá	2	
Eu tenho duas irmãs o meu pai e a minha mãe  .	2	
Eu tenho uma irmã minha mãe é emfermeira e a mãe tava noiva do pai da minha irmã	2	
Foi assim eu estava na porta do comércio do pai da minha tia minha mãe estava fazendo a unha dela ai desceu um menino da moto e apontou o revólver só pra mim e pediu o cllr eu fiquei foi sem ação Bru	2	
Guarda me a mim ao meu irmão ao meu pai e à minha mãe  .	2	
Mas o meu pai está fora de trabalho e a minha mãe de há umas horas para cá começou a sentir se mal penso qe seja uma paragem de digestão ela falou me que esteve a vomitar  .	2	
Meu nome é Nelma sou filha da Graça e do expedito que deus o tenha em um bom lugar não sei se vc ficou sabendo que meu pai faleceu ele era irmão de sua mãe	2	
Meu pai anda batendo na minha mãe há mais ou menos meses	2	
Minha mãe falou que meu pai tá bandeiroso	2	
Minha mãe ja decidiu so falta meu pai	2	
Não fique chateado com sua mãe ou com seu pai se eles não puderam lhe dar um tênis ou uma roupa nova esse natal pense quantas vezes eles deixaram de comprar para eles pra poder comprar para você e se esse ano eles não compraram pra você é porque realmente estão sem condições o natal é a comemoração do nascimento de Jesus e não um desfile de modas se apegue em Deus e agradeça seja grato por você ter saúde e a sua família perto de você  .	2	
Não há no mundo nenhuma palavra capaz de confortar o coração de um pai ou de uma mãe mas deixo o meu mais sincero pesar e carinho  .	2	
Não podemos avisar antes por causa de um problema familiar entre o meu pai e a minha mãe	2	
O Ivan fico com o rosto todo sangrando aí o homem Achou o celular do Ivan a ligou para a mãe dele aí o homem falou na onde que ele aquele lugar lá que Ele apanhou sabe o pai da Ivan foi lá no hospital que ele tava aí ele fez um negócio lá aí ele viu van lá aí o pai dele o Bruno saiu de perto já na cara dele tava todo sangrando aí a mãe dele viu e ficou falou assim meu filho meu filho chorando sabe aí a mulher atendeu ele ela foi lá aí a mulher falou assim que ele não tinha quebrado nada mas só que ele apanhou muito e se ele perder o bebê e tava andando no morro aí ela viu a Karine Aí ela começou a discutir mas só que ela tava com medo ABC já voltou para casa da mãe dela aí o filho da Bibi Dá um abraço na avó dele ela falou assim que achava que nunca mais ia ver ela ela deu um abraço chorou a Ritinha fez outro vídeo mostra a foto do Eugênio o nome dele eu acho mas não não mostrou o vídeo inteiro sabe não tem esqueci o nome daquele daquela mulher deixa eu ver ai esqueci o nome dele e aquela outra mulher foi fazer um depoimento do vídeo gatinha que ela fez aí Ivan chegou todo machucado com um negócio no braço Nossa tava com mó dificuldade de deitar na cama mas ele falou assim que tava o negócio lá que Ninguém ajudou aí o Ivan falou assim que as pessoas tinha medo o Zeca tava no sofá o pai dele com a mãe dele conversando E aí a mãe dele falou assim que a Ritinha tinha feito um vídeo lá né aí ele viu falou assim que era injusto também né a Ritinha a mãe ainda mora lá falou assim que sabia que uma hora ia chegar um terremoto da irmã dele não tinha chegar né só contando a ordem da que aconteceu tudo errado mas agora não pelo menos eu tô contando que aconteceu kakakakaka	2	
O pai natal meteu folga e mandou a mãe natal igualdadedegêneros	2	
O que você fez com a minha mãe eu não lê perdou ela chegou com a mão enchada que você arumou o portão nela se eu não gostava de você a gora eu te odeio eu não conciderava você como pai agora pior na minha mãe nigen toca so jesus seu velho desconpridido se você mim esceceu pra mim foi uma benca pra mim tanto faz você não fede nem cheira não que r	2	
Oie pai sera que tem como vc vim aqui na casa da minha mãe pra nos buscar e nos levar pro hospital Santa Genoveva para nossa consuta no ginecologista amanhã e só deixar la pq minha mãe	2	
Olha babe as coisas q eu vou disser aqui é só pra ficares a saber ok mas tem a ver com a cena q se passou à bocado pq eu disse te q n havia problema pq a minha mãe era a única em casa e o meu pai tá fora	2	
Olha babe as coisas q eu vou disser aqui é só pra ficares a saber ok mas tem a ver com a cena q se passou à bocado pq eu disse te q n havia problema pq a minha mãe era a única em casa e o meu pai tá fora e tipo se eu incesti em tar ali é pq sei o q to a fazer e tbm tenho a noção q nós já n teremos muito tempo juntos	2	
Olha babe as coisas q eu vou disser aqui é só pra ficares a saber ok mas tem a ver com a cena q se passou à bocado pq eu disse te q n havia problema pq a minha mãe era a única em casa e o meu pai tá fora e tipo se eu incesti em tar ali é pq sei o q to a fazer e tbm tenho a noção q nós já n teremos muito tempo juntos pq na Sexta tenho treino ainda n sei a q horas e tu queres fazer a prank depois este fim de semana n posso tar cntg pq vou pra Ericeira e depois na próxima semana to cntg na Sexta e no jogo ao q parece depois tenho um casamento e n posso tar cntg e depois e só até pro ano literalmente e depois eu gosto de ti e gosto de tar cntg pq a minha vida anda literalmente uma merda e tu és a única coisa boa q eu tenho nela pq as coisas com os meus pais n tao das melhores e exemplo disso é q eles n foram ao meu jogo e foste tu e obg por isso e a outra tu já sabes qual é	2	
Olha babe as coisas q eu vou disser aqui é só pra ficares a saber ok mas tem a ver com a cena q se passou à bocado pq eu disse te q n havia problema pq a minha mãe era a única em casa e o meu pai tá fora e tipo se eu incesti em tar ali é pq sei o q to a fazer e tbm tenho a noção q nós já n teremos muito tempo juntos pq na Sexta tenho treino ainda n sei a q horas e tu queres fazer a prank depois este fim de semana n posso tar cntg pq vou pra Ericeira e depois na próxima semana to cntg na Sexta e no jogo ao q parece depois tenho um casamento e n posso tar cntg e depois e só até pro ano literalmente e depois eu gosto de ti e gosto de tar cntg pq a minha vida anda literalmente uma merda e tu és a única coisa boa q eu tenho nela pq as coisas com os meus pais n tao das melhores e exemplo disso é q eles n foram ao meu jogo e foste tu e obg por isso e a outra tu já sabes qual é depois eu sou gozado lá nos treinos pelos meus colegas e um desses gozos e a foto q eu te mandei hj	2	
Pena ela te um pai tão filho da mãe	2	
Pk o meu pai e a minha mãe tem cenas pra fazer  .	2	
Por que minha mãe ganhou o Moto G K aniversário e meu pai comprou o	2	
Porquê porque tipo eu fui para minha mãe né aí encontrei dois cara eles são amigos do meu pai entendeu e eu tava sozinha tinha ninguém comigo eu e eles perguntaram você tem primo falei tenho irmão tenho também aí ele falando assim e namorado t	2	
Quais são as melhores lembranças que você tem da sua infância Qual foi suas férias favoritas quando criança e por quê Você é mais próximo da sua mãe ou do seu pai Qual é a coisa exclusiva que você mais adora no seu pai e na sua mãe Você tem irmãos Qual foi a coisa mais constrangedora que você já fez quando criança Qual foi a coisa mais perigosa que você já fez quando era adolescente A primeira pessoa com quem você se apaixonou era uma garota da vida real ou uma atriz da malhação Perguntas Sobre Música  .	2	
#principe,	princesa
Oh mor n preciso flr mt com isto ou preciso Se sou o teu mundo tu és o meu universo Se sou a tua vida tu és a minha vida e sorte Se sou o teu principe és a minha rainha deusa princesa acima de tudo pq es o amor dmv Se sou tua perfeicao tu és a razao dela Se sou o Hdtv tu és a mulher q nnc deixou de ser para a minha vida toda nnc deixas te de ser o amor dmv e eu só te agradeço por uma segunda oportunidade por ambas as partes Contra tudo e todos e os fdp q venhan tentar mudar isto nng vai conseguir mudar o qnt eu te amoo e se digo q vamos construir uma família juntos é pq nnc mas nnc nng vai csgr me tirar de ti Teu maior apoio é simplesmente minha obrigacao ser melhor pessoa q todos os outros e como namorado  .	98	
Oh mor n preciso flr mt com isto ou preciso Se sou o teu mundo tu és o meu universo Se sou a tua vida tu és a minha vida e sorte Se sou o teu principe és a minha rainha deusa princesa acima de tudo pq es o amor dmv	10	
Oh mor n preciso flr mt com isto ou preciso Se sou o teu mundo tu és o meu universo Se sou a tua vida tu és a minha vida e sorte Se sou o teu principe és a minha rainha deusa princesa acima de tudo pq es o amor dmv Se sou tua perfeicao tu és a razao dela Se sou o Hdtv tu és a mulher q nnc deixou de ser para a minha vida toda nnc deixas te de ser o amor dmv e eu só te agradeço por uma segunda oportunidade por ambas as partes	6	
Oh mor n preciso flr mt com isto ou preciso Se sou o teu mundo tu és o meu universo Se sou a tua vida tu és a minha vida e sorte Se sou o teu principe és a minha rainha deusa princesa acima de tudo pq es o amor dmv Se sou tua perfeicao tu és a razao dela	3	
Oh mor n preciso flr mt com isto ou preciso Se sou o teu mundo tu és o meu universo Se sou a tua vida tu és a minha vida e sorte Se sou o teu principe és a minha rainha deusa princesa acima de tudo pq es o amor dmv Se sou tua perfeicao tu és a razao dela Se sou o Hdtv tu és a mulher q nnc deixou de ser para a minha vida toda	3	
Oh mor n preciso flr mt com isto ou preciso Se sou o teu mundo tu és o meu universo Se sou a tua vida tu és a minha vida e sorte Se sou o teu principe és a minha rainha deusa princesa acima de tudo pq es o amor dmv Se sou tua perfeicao tu és a razao dela Se sou o Hdtv tu és a mulher q nnc deixou de ser para a minha vida toda nnc deixas te de ser o amor dmv	3	
Oh mor n preciso flr mt com isto ou preciso Se sou o teu mundo tu és o meu universo Se sou a tua vida tu és a minha vida e sorte Se sou o teu principe és a minha rainha deusa princesa acima de tudo pq es o amor dmv Se sou tua perfeicao tu és a razao dela Se sou o Hdtv tu és a mulher q nnc deixou de ser para a minha vida toda nnc deixas te de ser o amor dmv e eu só te agradeço por uma segunda oportunidade por ambas as partes Contra tudo e todos e os fdp q venhan tentar mudar isto	3	
Oh mor n preciso flr mt com isto ou preciso Se sou o teu mundo tu és o meu universo Se sou a tua vida tu és a minha vida e sorte Se sou o teu principe és a minha rainha deusa princesa acima de tudo pq es o amor dmv Se sou tua perfeicao tu és a razao dela Se sou o Hdtv tu és a mulher q nnc deixou de ser para a minha vida toda nnc deixas te de ser o amor dmv e eu só te agradeço por uma segunda oportunidade por ambas as partes Contra tudo e todos e os fdp q venhan tentar mudar isto nng vai conseguir mudar o qnt eu te amoo	3	
Oh mor n preciso flr mt com isto ou preciso Se sou o teu mundo tu és o meu universo Se sou a tua vida tu és a minha vida e sorte Se sou o teu principe és a minha rainha deusa princesa acima de tudo pq es o amor dmv Se sou tua perfeicao tu és a razao dela Se sou o Hdtv tu és a mulher q nnc deixou de ser para a minha vida toda nnc deixas te de ser o amor dmv e eu só te agradeço por uma segunda oportunidade por ambas as partes Contra tudo e todos e os fdp q venhan tentar mudar isto nng vai conseguir mudar o qnt eu te amoo e se digo q vamos construir uma família juntos é pq nnc mas nnc nng vai csgr me tirar de ti	3	
Oh mor n preciso flr mt com isto ou preciso Se sou o teu mundo tu és o meu universo Se sou a tua vida tu és a minha vida e sorte Se sou o teu principe és a minha rainha deusa princesa acima de tudo pq es o amor dmv Se sou tua perfeicao tu és a razao dela Se sou o Hdtv tu és a mulher q nnc deixou de ser para a minha vida toda nnc deixas te de ser o amor dmv e eu só te agradeço por uma segunda oportunidade por ambas as partes Contra tudo e todos e os fdp q venhan tentar mudar isto nng vai conseguir mudar o qnt eu te amoo e se digo q vamos construir uma família juntos é pq nnc mas nnc nng vai csgr me tirar de ti Teu maior apoio é simplesmente minha obrigacao ser melhor pessoa q todos os outro	3	
Oh mor n preciso flr mt com isto ou preciso Se sou o teu mundo tu és o meu universo Se sou a tua vida tu és a minha vida e sorte Se sou o teu principe és a minha rainha deusa princesa acima de tudo	2	
a Marido Marida meu Grandão minha Grandona meu Pequeno minha Pequena meu lindoh Cunha moça minha princesa meu Cremoso minha Cremosa meu principe minha Arlequina Coringa Perfeito minha Perfeita meu Fofinho Bb Neném meu Amor minha fofinha minha lerdah Tonto Tonta minha Cinderela minha Nega meu Nego Duende E  .	2	
Ja tou a ser boa de mais quando ele me chama de princesa e eu chamolhe de principe antes quando ele me chamava eu n lhe chamava nd agora tmb lhe chamo principe eu tou msm a ficar uma boba apaixonada	1	
Neste caso tu és uma princesa só n encontras te o teu principe	1	
Pq eu era sempre o principe e ela a princesa	1	
Se eu sou a princesa o meu namorado e o principe	1	
Se tivéssemos um filho em comum seria um principe tão lindo quanto a tua linda princesa	1	
Vc falou boa noite princesa ai eu falei boa noite principe	1	
a Marido Marida meu Grandão minha Grandona meu Pequeno minha Pequena meu lindo Cunha moça minha princesa meu Cremoso minha Cremosa meu principe minha Arlequina Coringa Perfeito minha Perfeita meu Fofinho Bb Neném meu Amor minha fofinha minha lerda Tonto Tonta minha Cinderela minha Nega meu Nego Duende E  .	1	
a Marido Marida meu Grandão minha Grandona meu Pequeno minha Pequena meu lindoh Melhor Amg moça minha princesa meu Cremoso minha Cremosa meu principe minha Arlequina Coringa Perfeito minha Perfeita	1	
a Marido Marida meu Grandão minha Grandona meu Pequeno minha Pequena meu lindoh Melhor Amg moça minha princesa meu Cremoso minha Cremosa meu principe minha Arlequina Coringa Perfeito minha Perfeita meu Fof	1	
o principe foi levar a princesa a casa q lindo	1	
o principe tambrm quer ver a princesa skskks	1	
és a minha princesa e eu teu principe encantado	1	
#garoto,	menina
Bom dia mor É tão bom sonhar com você e acordar com um sorriso no rosto acordar sabendo que vc está presente na minha vida e que eu sou a menina mais sortuda do mundo por ter um garoto tão especial como vc obrigada por cada momento que passamos juntos obrigada por fazer a minha vida ter sentido  .	7	
/ Geise Vc n sai mais com nenhuma menina / Geise Que eu n saiu com garoto nenhum / Moreno / Moreno quando eu tava conversando com vc que disse que só tinha homens la era horas da tarde essas fotos ai já é a noite eu tenho culpa se elas chegaram la e quando a gente saiu fo todo mundo comer num to vendo nada de mais ai / Geise Vc não sai com nenhuma menina mais  .	1	
A menina ta a dormir o garoto ta aqui	1	
Acontece que a menina é doente ai ela se apaixonar por um garoto e esse garoto por ela só que ela não sabe que ele tava doente tbm ai ele morre primeiro do que ela É triste mais é lindo o filme assista	1	
Ainda outro dia estava a contar que gozam com um garoto porque tem tiques de menina e anda sempre sozinho e toda a gente a rir  .	1	
Bom dia mor É tão bom sonhar com você e acordar com um sorriso no rosto acordar sabendo que vc está presente na minha vida e que eu sou a menina mais sortuda do mundo por ter um garoto tão especial como vc	1	
Bom dia mor É tão bom sonhar com você e acordar com um sorriso no rosto acordar sabendo que vc está presente na minha vida e que eu sou a menina mais sortuda do mundo por ter um garoto tão especial como vc  .	1	
Bom dia mor É tão bom sonhar com você e acordar com um sorriso no rosto acordar sabendo que vc está presente na minha vida e que eu sou a menina mais sortuda do mundo por ter um garoto tão especial como vc obrigada por cada momento que passamos juntos obrigada por	1	
Bom dia mor É tão bom sonhar com você e acordar com um sorriso no rosto acordar sabendo que vc está presente na minha vida e que eu sou a menina mais sortuda do mundo por ter um garoto tão especial como vc obrigada por cada momento que passamos juntos obrigada por fazer a minha vida ter sentido	1	
Bom dia mor É tão bom sonhar com você e acordar com um sorriso no rosto acordar sabendo que vc está presente na minha vida e que eu sou a menina mais sortuda do mundo por ter um garoto tão especial na minha vida obrigada por cada momento que passamos juntos não sei como vc me aguenta me desculpa pelas vezes que vacilei com vc  .	1	
Como aquele garoto q matou a menina pq ela não queria namorar com ele	1	
Crlh garoto ingrato nao sabe dar valor a uma menina	1	
E o garoto me lembra o Guilherme E a menina eu não a conheço  .	1	
Eh de um garoto piscopata que e quer matar a menina ent finge estar apaixonadaum	1	
Kkk o garoto q acha q é um psicopata e a menina que é super mal educada e  .	1	
Não sei oq vcs então falando merda aqui nos comentários da menina duvido se fosse um garoto de costa na cama vinha um grupo de pessoas falando lindo gostoso agora a menina posta uma foto de costa na cama e vem um monte falando puta nossa que isso em nudez total mano a menina não mostro peito bunda vagina e ela mostrou apenas as suas lindas e perfeitas costas  .	1	
Que eu saiba Nenhuma menina de anos fala isso com garoto igual caic	1	
Sim isso mesmo que você leu ele me odeia por eu ter nascido menina porque ele sempre deixou bem claro que queria um garoto  .	1	
Tinha uma menina que estava sendo estuprada E um garoto chega batendo no cara que estuprava a garota  .	1	
sim mas é com outra menina não com um garoto que se considera uma  .	1	
#sobrinho,	sobrinha
Ja desliguei deu me pena de meu sobrinho a Raquel diz que nem minha sobrinha fala com a Raquel	1	
Minha família mãe irmã cunhado sobrinha e esposo dela sobrinho e nam	1	
Minha família mãe irmã cunhado sobrinha e esposo dela sobrinho e namirada dele	1	
Minha família mãe irmã cunhado sobrinha e esposo dela sobrinho e namirada dele sobrinha e esposo dela meu filho e filha	1	
Minha família mãe irmã cunhado sobrinha e esposo dela sobrinho e namorada dele sobrinha e esposo dela meu filho e filha e o pai dos meus filhos  .	1	
Minha família mãe irmã cunhado sobrinha e esposo dela sobrinho e namorada dele sobrinha e esposo dela meu filho e filha e o pai dos meus filhos que veio passar o Natal com eles  .	1	
Minha sobrinha e mim vezes pior q meu sobrinho	1	
Minha sobrinha e mim vezes pior q meu sobrinho Hj ela fez eu andar de bicicleta com ela eu quase cai  .	1	
Nosso sobrinho nasceu o filho da sobrinha de C  .	1	
Que festa maravilhosa digna de um príncipe foi o aniversário de anos de meu sobrinho Neto Mateus coppa filho da Maristela minha sobrinha	1	
Se puxa a família dele vai ser loira os sobrinho dele e tudo loiro a sobrinha até o cabelo e loiro	1	
Um carrinho para o sobrinho e um bonequinho para a sobrinha o natal ja é amanhã	1	
É um pro sobrinho e outro pra sobrinha	1	
#meio-irmão,	meia-irmã
#ele,	ela
mas ele tbm o faz por causa da amada dele mas q eu saiba ela tbm tem maos para se defender e n precisa de um guarda costas mas ele e q sabe o q faz simplesmente eu n gosto q batam no meu irmão ta bem q ele as vezes pode as merecer mas imaginesse no meu lugar acha q uma irmã mais velha q tem por obrigação defender o irmão gosta de ver os mais velhos a baterlhe Ninguém sabe o q se passa cmg mas sabe o q e acordar tds os dias e pensar q a sua vida ja n faz sentido Pensar q morrer vai ser a solução Sabe o q e acordar tds os dias e dizer para si propria mais um dia com esta maldita depressão ja pensou nisso Pois eu ns se ja pensou mas eu penso e agr fica a pensar pq q eu tou a dizer isto ne Pois eu sofre de depressão e ela ta cada vez pior  .	18	
Não tinha pra que ele vim no meu pv falar isso Já que tinha sido expulsa Covarde ele Já que eu não posso mostrar a baixaria dele pra AradiaE nem mim defender no grupo Por favor mostra a Aradia pra ela ver o tipo de pessoa baixa que ele é	17	
Vc tinha conseguido colocar ele pra dormir pq ela tava chorando muito kkkk  .	13	
Esta miúda é quem me alegra todos os dias até mesmo naqueles em que estou mais em baixo é ele que me abraça me da beijinhos e é ela que me faz rir com as suas palhaçadas eu amo a minha sobrinha	12	
Eu vivo tds os dias da minha vida a pensar cm seria se eu vivesse com a minha mae em vez de ela me abandonar e cm seria viver com um pai em vez de ele estar onde esta  .	11	
Ian ele que fica comigo e com ela e ñ da certo ñ ja bloqueei ele è melhor ele no canto dele e eu no meu pois ele ñ que muda eu gostei demais dele mais ele	11	
agora vamos procurar uma roupa bem bonita pra vc vestir S/n pra que Ls pra quando ele sair do banho ser surpreendido por vcS/n o okFomos até a barraca e ela ficou olhando todas as roupas que eu trouxe e foi	11	
E ela é tudo o que ele precisa	10	
Eu mas ela vem com o namorado pensei que ele tava falando da minha amiga Paula Ele a é  .	8	
Mas bom eu vou te contar como deve ser ela chegou la comigo ja agora chamo me maria e tipo ele deu lhe um beijo e ela afasto o e depois ela deu lhe um presente supostamen te de natal e tipo ela viu logo o que era	7	
Vc lembra que eu te falei dessa bebedeira dele que não é normal são vinte e um ano juntos sonhei e corri atrás realmente foi o que eu sonhei deram pra ele um copo preparado por mulher que foi feito em cemitério so que essa amiga minha vai desfazer pra mim ela esta no rio quem fez isto fez pra matar ele e eu vou ter que desenvolver meu lado espiritual pra ju	7	
Então ela se aproximou dele e com lágrimas nos olhos perguntou a ele  .	6	
Me contaram que ele a acompanha sempre que parece mais disposto e quando está com ela está sempre sorridente  .	6	
Capítulo I hate you I love you S/n nada não Ela sai do quarto Jk viu ela quer ficar com o TaehyungSg os dois só são amigosJk eu também era amigo da S/n mas nos beijamosSg calma ele não vai ficar com elaJk ela me odeia me odeia Sg ela só está nervosa o plano vai ser assim  .	5	
Em frente à escrivaninha dele olhando ele nos olhos lindos doispares azuis ela pede Osmar tem uma coisa que euqueria muito fazer  .	5	
Fia ele já me queixava tando com ela imagine agora solteiro	5	
Medo daquelas que se ele falar que vai sair ela só diz bom rolê tô saindo também vou ligar pras amigas  .	5	
Nao e com ela que tens pedir satisfações e a ele  .	5	
ela diz colando os corpos deles ah Jeon você e muito bonzinho com esses pirralhos depende você vai me prender ela disse piscando para ele eu gosto de você e eu sei que você também gosta  .	5	
Ahhhh meu amor disso meu marido pode ter certeza meu amor sua esposa ama enterrar a carinha assim no meu pescocinho pra sentir o meu cheirinho meu amor Ahhhh meu amor então meu amor mais não vai ser por agora que sua esposa vai comprar ele não meu amor sua esposa vai comprar outras coisas pra ela meu amor	4	
Do nada manda me msg a explicar tudo com a bruna que ela tinha ido gregar ns que e ele foi para a casa de banho eu nem vi nada dessa merda  .	4	
E ao te dizer isto nao quero q tejas cm ciumes Mas sim que entendas que pra mim ela é como o rui é pra tiNao os tou a compararApenas quero dizer a importanciaq ele tem pra ti e q ela tem pra mimEla sempre me ajudouAgora q ela precisa eu tou laÉ só issoNnc terei nada com elaNem conseguiria tar ou gostar delaSe nem se quer a vou verE alem disso tou contigoE apesar das mil e uma discussões sou muito feliz contigo Sempre que tamos bemSinto me a pessoas mais feliz do mundoAserio Fazes me muito bem qnd tamos bem e mt mal qnd tamos mal  .	4	
Ela falou assim Maria se ela quisesse teu irmão ela não já tinha ido para São Paulo ficar com ele aí Maria tu vai ver quando ele chegar aqui e eu só na me escutando Eu velho	4	
Eles ficaram faz tempo ai ele tirou a virgindade dela e ela dele  .	4	
Engraçado q ele pediu a foto e ela nem se quer inventou uma desculpa  .	4	
Er ela posta mais alguma coisa me fala pq o mths falou prA eu bloquear ela que e melhor pra ele não arrumar problema  .	4	
Eu falava que o mundo vai gira e ela vai te procurar aí ele já deu voltas	4	
Eu ouvir ontem ela tipo perguntando pra alguem se ele tava namorando o ex dela ai ne  .	4	
Eu tava la cuidando do Lorrah ai ela saiu correndo chorando dizendo que ele não gostava mais dela e um bagaço	4	
Oq entendi q ela cusou o guri d alguma coisa e ele nega e dps q ela jogou café ou sla nele uma mina grita n foi ele  .	4	
Raila pegou meu cll hj acho que ela mandou alguma coisa pra ele	4	
Sera que o Chris vai querer ir olho pra ela pensando Vou chamar ele ja volto saeng  .	4	
Tp hj minhas amiga na escola estavam passando por varios menino e uma amiga minha falou para um menino e disse q eu queria que ele me desse um beijo no rosto e ele falou q n e ela disse e se forna boca e ela disse q ai ja pode	4	
ela não sabia que ele bebia  .	4	
mas ela me salvou de um estranho que vestia uma armadura roxa ele estava prestes me matar quando ela explodiu uma montanha de gelo e congelou o homem Cavaleiro de ouro então parece que ela te escolheu garoto venha comigo para o Santuário e veremos se você é realmente digno da armadura de cisne Garoto	4	
Ai ela falou que tinha falado com ele	3	
Ainda não acredito Suga tava beijando aquela staff sendo que a S/n só deu um tempo no relacionamento deles ela veio só pra conversar com ele e da de cara com aquela cena  .	3	
Andou a dizer que ela era uma maluca que ele só deu umas cuecas com ela esso quis dizer que a minha mãe é uma puta	3	
Certamente com o crime seja ele organizado ou não é que ela nunca estará  .	3	
E ela começou a gostar de falar com ele Que se deixar N sabe o que fazer Mas ela começou a sentir alguma coisa por ele Mas tem medo de se magoar pk sofreu mt no passado por rapazes que não valiam a pena Ela até tinha dito a ele que ia virar freira E que não queria relações Mas ele deu uma volta tão grande ao coração dela Que ela nem sabe como	3	
E que ele faliu muito te pra ela	3	
Em um domingo em família ele pediu para sua segunda esposa pegar sua bengala no quarto e ela não o ouviu pois estava na cozinha  .	3	
Esta miúda é quem me alegra todos os dias até mesmo naqueles em que estou mais em baixo é ele que me abraça me da beijinhos e é ela que me faz rir com as suas palhaçadas	3	
Eu vivo tds os dias da minha vida a pensar cm seria se eu vivesse com a minha mae em vez de ela me abandonar e cm seria viver com um pai em vez de ele estar onde esta	3	
Fia ele já me queixava tando com ela imagine agora solteitob	3	
Gentilmente ela pediu me para sair do quarto pois ele precisava descansar após tomar os remédios  .	3	
Kkn vc n conhece a pamela realmente Ata q ela vai pra festa so cm a irmã primas se ele tu	3	
Mas acho é pq o Caio é assanhado mas ela devia falar pra ele mas cada um com suas loucuras deixamos de lado  .	3	
Mas como assim Estamos neste buraco sim Mas ainda não foi lançada terra sobre ele e se lançada com ela podemos subir  .	3	
Mesmo em gemido o senhor te ouvira até sem palavras ele vai te responder pois ele entende quando vc quer chorar sabe de tudo mesmo antes de falar ele conhece o teu sofre e tua dor sabe exatamente onde ela esta por isso eu sei que mesmo sem palavras o senhor te ouvira  .	3	
#papai,	mamãe
Deu positivo mamãe já ama Deu positivo papai já ama Declara ser torcedor do rival Feliz aniversário para mim já que ninguém lembrou  .	41	
Enquanto isso do outro lado da cidade o papai dorme o sono dos justos Papai abre a boca e diz que mamãe proibi ele de vim me ver mas ouço mamãe me pergunta cade papai Eu lembro vagamente dele Papai diz q no futuro vai me levar pra casa dele mas ele nem sabe do que gosto de comer e nem sabe mais como gosto de dormir Papai perde tanta coisa que faço legal já mamãe parece uma boba aplaudindo  .	5	
Ah papai o senhor nem sabe mas eu sinto Preciso de roupas sapatos novos mas mamãe prometeu q mês q vem vai comprar  .	4	
E meu gatinho hoje e seu dia né quero a agradecer adeus por ter você na minha vida meu filho quero ti parabenizar pelo seu niver que essa data repita por muitas e muitas vezes que papai do céu abençoe você cada dia mais mamãe amo você muito meu gatinho parabéns Vitor Gabriel	2	
Enquanto isso do outro lado da cidade o papai dorme o sono dos justos Papai abre a boca e diz que mamãe proibi ele de vim me ver mas ouço mamãe me pergunta cade papai Eu lembro vagamente	2	
Enquanto isso do outro lado da cidade o papai dorme o sono dos justos Papai abre a boca e diz que mamãe proibi ele de vim me ver mas ouço mamãe me pergunta cade papai Eu lembro vagamente d	2	
Enquanto isso do outro lado da cidade o papai dorme o sono dos justos Papai abre a boca e diz que mamãe proibi ele de vim me ver mas ouço mamãe me pergunta cade papai Eu lembro vagamente dele	2	
Hoje meu coração está muito triste dia do de meu paizinho foi ao encontro da minha mãezinha os dois juntos deve estar muito feliz ao se encontrar de novo viveram um amor lindo por anos de casamento um casamento de muito amor carinho e respeito papai e mãezinha te amarei por toda a minha vida Amor Eterno Amor Além da Vida papai nasceu hein do de faleceu hoje do de mamãe nasceu de Abril faleceu dia de setembro de tiveram uma vida longa mas hoje te entregamos papai o senhor para nosso senhor Jesus Cristo o senhor e a mam ficaram junto nos braços de Nosso Senhor Jesus Cristo amor	2	
e mais mimos para Laurinha presentinhos do papai a vovó que ajudou a escolher todos ansiosos para sua chegada hashtag mamãe	2	
A Cristiane Fernandes de Deus ate tinha febre qd ficava sem o papai entao eu era a cassula da mamãe	1	
A anos nessa mesma data / / as vc vinha ao mundo o presente mais lindo que papai do céu podia nos dar foi tão lindo e emocionante um sentimento que é inexplicável quando vc chegou aos meus braços eu chorei e agradeci a Deus pela sua vida pois vc foi planejado esperado desejado e hoje é amado cuidado querido por todos pois vc filho é a realização de um sonho e um desejo o qual foi tão difícil até a sua chegada papai e mamae tiveram algumas percas estavamos tao tristem então papai do céu nos fez uma promessa que nos daria um filho então mamãe descobriu q estava gravida papai e na	1	
A mamãe de lorrany ta com desejo do papai	1	
A mamãe ficou lá com o papai discuti	1	
A mamãe ta ali na cozinha com o papai	1	
A pois tem uma coisa se papai dizer lá que da pensão a mim e a Kah mamãe vai procurar o juíz	1	
Aaaaaaaa meu amor hj é seu dia e infeliz vc não ta aqui pra gente comemorar juntas mais não importa né vc não precisa ta aqui pra mim dizer o quanto você é importante e o quanto eu te amo minha linda hj eu só quero que você esteja muito feliz e também quero te desejar muitas felicidades e que o papai do céu te abençoe sempre e que mamãe passe a frente da sua vida  .	1	
Ai quase que eu falei pra ela foi assim que a mamãe descobriu que ela era amante do papai mas Deus foi bom e segurou minha língua	1	
As sugestões de presentes já são informadas de cara e assim fica muito mais prático para todos CONVITES DE CHÁ DE BEBÊ VIRTUAL K SaveTons neutros deixam qualquer convite elegante e sofisticado inclusive um convite virtual para chá de fraldas K SaveCores alegres e simplicidade são o ponto forte desse convite virtual para chá de bebê feminino K SaveNão dá para errar escolhendo cores neutras em nenhuma ocasião K SaveO clássico ícone da cegonha trazendo o bebê deixa o convite virtual online super fofo O tom de verde utilizado é delicado e pode ser utilizado tanto para chás de bebê femininos ou masculinos K SaveMais um modelo super moderninho e discreto K SaveEsses são ainda mais fáceis de editar basta acrescentar as informações e estão prontos para enviar K Save K Save K SaveFRASES CONVITE PARA ENVIAR VIA WHATSAPPQue tal uma maneira ainda mais fácil de convidar os seus amigos e parentes para o chá de bebê online pelo WhatsApp Basta complementar a mensagem com as informações necessárias como nomes data endereço e depois enviar Pelo tamanho da barriga da mamãe você já deve ter percebido que eu estou quase chegando né Mamãe e papai estão esperando por você para o meu chá de fraldas que acontecerá no dia / / no endereço às hr  .	1	
Avisa pra titia que a mamãe já voltou de viagem com o papai	1	
Bom dia papai Luca de primeira viagem Bom dia Gabi mamãe de primeira viagem primeira filhota linda olha Estou ansiosa quando vocês também não vejo a	1	
De manhã a mamãe teve uma briga feia com o papai	1	
Deu positivo mamãe já ama Deu positivo papai já ama	1	
Deu positivo mamãe já ama Deu positivo papai já ama Declara ser torcedor	1	
Deus abençoe essa princesa parabéns mamãe Fagna Mesquita e papai Daniel Messias	1	
E quando é a mamãe kkkk tudo preso kkk e papai deixa tudo armado kkkk amo	1	
E só acho qe mamãe nem vai pagar pq qm ia pagar era papai e eu nn falei mais cm ele	1	
E tbm a mamãe ta fazendo o papai sofrer	1	
Ele vira e fala mamãe tô trabalhando mais o papai filho cuidado com essa enxada nos pés viu ele fala mãe eu sei trabalhar	1	
Ele vira e fala mamãe tô trabalhando mais o papai filho cuidado com essa enxada nos pés viu ele fala mãe eu sei trabalhar  .	1	
Enquanto isso do outro lado da cidade o papai dorme o sono dos justos Papai abre a boca e diz que mamãe proibi ele de vim me ver mas ouço mamãe me pergunta cade papai	1	
Estou esperando o papai chegar de viagem pra poder alguém ficar com a mamãe  .	1	
Eu vou crescer muito rápido e você tem que aproveitar todos os momentos comigo então ñ fique com vergonha se um dia eu te chama pra brincar de casinha ou de fazer comidinha lembre se que o tempo passa rápido e quando você menos esperar sua menininha vai virar uma Linda mulher mais por enquanto papai continui curtindo a gravidez da mamãe eu prometo ser mais boazinha com você e vou chutar a barriga da mamãe quando estiver por perto Ah cuida bem da mamãe ela precisar ficar bem para que a minha chegada seja inesquecível para os dois então papai falta pouco pra vcs me conhecerem bjs papai te amo  .	1	
Fala pra mamãe q segunda Paula da o remédio a papai	1	
Faça com teu Filho a e veja o que ele respondeLyvia Juliana anos Qual é o nome da sua mamãe R nai Ela é gorda ou magra R gordakkkkkkkkk Alta ou baixa R pequena O que ela gosta de comer R cebola kkk O que ela gosta de vestir R saia e camiseta Quantos anos ela tem R kkkkk Pesa quantos quilos R um poko Qual presente gostaria de dar a ela R livo ou seja livro Quem ama a mamãe R eu e papai O que a mamãe é R eu da livia O que mamãe sempre te fala R não Adriano Koraleski Ipda	1	
Hoje e seu aniversário meu amor mamãe te deseja tudo q a de bom nessa vida q papai do céu te abençoe sempre  .	1	
Hoje faz dias do reencontro de um amor eterno é assim que o senhor papai e a senhora mamãe estão juntinhos no céu brindando este lindo amor	1	
Hoje meu coração está muito triste dia do de meu paizinho foi ao encontro da minha mãezinha os dois juntos deve estar muito feliz ao se encontrar de novo viveram um amor lindo por anos de casamento um casamento de muito amor carinho e respeito papai e mãezinha te amarei por toda a minha vida Amor Eterno Amor Além da Vida papai nasceu hein do de faleceu hoje do de mamãe nasceu de Abril faleceu dia de setembro de tiveram uma vida longa mas hoje te entregamos papai o senhor para nosso senhor Jesus Cristo o senhor e a mam	1	
Hoje meu coração está muito triste dia do de meu paizinho foi ao encontro da minha mãezinha os dois juntos deve estar muito feliz ao se encontrar de novo viveram um amor lindo por anos de casamento um casamento de muito amor carinho e respeito papai e mãezinha te amarei por toda a minha vida Amor Eterno Amor Além da Vida papai nasceu hein do de faleceu hoje do de mamãe nasceu de Abril faleceu dia de setembro de tiveram uma vida longa mas hoje te entregamos papai o senhor para nosso senhor Jesus Cristo o senhor e a mam ficaram junto nos braços de Nosso	1	
Hoje meu coração está muito triste dia do de meu paizinho foi ao encontro da minha mãezinha os dois juntos deve estar muito feliz ao se encontrar de novo viveram um amor lindo por anos de casamento um casamento de muito amor carinho e respeito papai e mãezinha te amarei por toda a minha vida Amor Eterno Amor Além da Vida papai nasceu hein do de faleceu hoje do de mamãe nasceu de Abril faleceu dia de setembro de tiveram uma vida longa mas hoje te entregamos papai o senhor para nosso senhor Jesus Cristo o senhor e a mam ficaram junto nos braços de Nosso Senhor	1	
Hoje meu coração está muito triste dia do de meu paizinho foi ao encontro da minha mãezinha os dois juntos deve estar muito feliz ao se encontrar de novo viveram um amor lindo por anos de casamento um casamento de muito amor carinho e respeito papai e mãezinha te amarei por toda a minha vida Amor Eterno Amor Além da Vida papai nasceu hein do de faleceu hoje do de mamãe nasceu de Abril faleceu dia de setembro de tiveram uma vida longa mas hoje te entregamos papai o senhor para nosso senhor Jesus Cristo o senhor e a mam ficaram junto nos braços de Nosso Senhor Jesus Cristo amor eterno amor por toda vida beijos	1	
Hoje meu filho minha vida meus parabéns vai para você que Deus te abençoe a cada dia da sua vida meu lindo mamãe ama muito você e papai nós te desejamos muitas felicidades para você que nós nos amamos você é o presente que Deus nos deu Obrigado meu filho por você existir na na nossa vida	1	
Hoje meu filho minha vida meus parabéns vai para você que Deus te abençoe a cada dia da sua vida meu lindo mamãe ama muito você e papai nós te desejamos muitas felicidades para você que nós nos amamos você é o presente que Deus nos deu Obrigado meu filho por você existir na na nossa vida nós nos amamos você feliz aniversário	1	
Mais a mamãe fala pra ele ñ sair pq o papai vai brigar ele ñ escuta	1	
Mais é muito lindo parabéns mamãe do ano que papai do céu abençoe e proteja ele sempre	1	
Mas outro dia a gente tava conversando ai a gente tava falando de aniversário so sei que eu sem querer mesmo soltei e a mamãe que descobriu a amante do papai no dia do meu aniversário	1	
Mas por enquanto papai continue curtido a gravidez da mamãe eu prometo ser mais boazinha com você e vou chutar a barriga da mamãe quando estiver por perto ah cuida bem da mamãe ela precisa ficar bem para que a minha chegada seja inesquecível para os dois Beijos papai  .	1	
O de mamãe os filhos o de papai os lucas bruna Sofia e os bisneto	1	
O papai deixa pq a mamãe e daquelas que e de contra kkkkk	1	
Onwt mamãe vai trabalhar e ela começa a chorar o papai dar a foto da mamãe pra consolar e ela pára de chorar É muito amor envolvido  .	1	
Parabéns minha filha que o papai do céu te abençoe sempre você te amo muito princesa da mamãe	1	
#tio,	tia
Meu filho não é para você ficar aí e nenhum Lucas vem com seu tio se a tua tia André e tua avó fica insistindo para vocês ficar você não fica e é para falar para o Lucas não ficar também	3	
Entao fui com um amigo meu de infância a casa dele e encontro a minha tia e ela assim é teu namorado e eu não não somos amigos de infância e a minha tia vira se e diz eu e o teu tio também éramos	2	
Mas é para vocês ir tia vocês fala que vai na hora não vai Ontem eu vi meu tio Tonho aí falei para ele falar comigo de Arlindo e meu padrinho porque é difícil ver eles aí qualquer coisa a senhora Avisa eles	2	
Mas é para vocês ir tia vocês fala que vai na hora não vai Ontem eu vi meu tio Tonho aí falei para ele falar como meu tio	2	
Não consigo esquecer meu tio hj falei com a minha tia ela ta tao abalada	2	
Primeiro deus leva a mha biza dps a mha tia meu primo meu tio e agora meu pai	2	
Quando o tio chegar me avisa tia	2	
Sao quase dias sem ir pra casa To vendo com meu tio se ele pode ficar com minha tia pra eu poder ir embora  .	2	
acho q deu ao tio e disse lhe pra qnd ele viesse da tia carmen	2	
A minha tia morreu o meu tio esta no hospital e esta a doerme os dentes	1	
A minha tia não gosta que o meu tio beba amor	1	
A tia Ana mandando audio parece o tio du	1	
A tia Leda ta ai com o tio Valberto	1	
A tia Tania ta a perguntar se esta o tio rao	1	
A tia chegou agr e eu disse tinha mas deu para o tio quím pk estava sem comer e ficou para ela a tia n tem prima	1	
A tia de vcs irma do tio joao  .	1	
A tia elzaa com medo do tio ontem	1	
A tia esta a falar com o tio	1	
A tia esta a perguntar se o tio Júlio tirou o luto	1	
A tia fa já falou com o tio	1	
A tia lena que saber se o tio ze luis foi embora ontem	1	
A tia não levou sua camiseta pra apertar não porque o tio biro acha que não é grande	1	
A tia tbm e o tio	1	
A tia tá com medo do tio	1	
A tua tia ia pah sala dormir em cima do teu tio	1	
A tua tia nnc fez nada com o André O teu tio anda tolo mano	1	
A tua tia ns se curte mt o teu tio n deve saber que eu existo  .	1	
Acho q não pq eu tava vendo aqui minha tia vai la na sogra dela mais meu tio e minha prima vai ficar	1	
Acho que n vai dá eu Tva la na tia penha com o meu tio ajudando ele vim aqui em casa p esperar o veterinário sacrifícar a minha cadela	1	
Ah ok tia um abraco pro tio e muita força	1	
Ahh prima q horror fiquei sabendo queria tanto q tia Flávia voltasse para o tio jeosias	1	
Ai hoje quando minha mãe foi eu liguei pra minha mãe pra saber como ta a vovó ela disse que a vovó nao ta do jeito que a tia dió falouOntem o tio dotor foi la passou o dia com ela quando ele chegou la ela nem ligou hoje quando minha mãe chegou ela tbm nao ligou e chegou la umas pessoa ela tbm nao ligou muito sei la  .	1	
Ai mal feito lera nao ligares para a Rita kkkk a Rita e a tio olga tem razão elas sao da vossa geração mas a tia ja sinhela velhota no natal vai levar com o presente do neto a caminho	1	
Ai pai e o que eu tou a dizet minha mae para fazerem os da casa do meu avô e os irmaos porque quem nao vai fazer parece que e o tio lipe por causa dele a tia olga ligou para o meu pai para ir buscar o dinheiro que ja deu	1	
Amanhã entao Porque estou em casa do tio marco e a tia zira em casa dela	1	
Amor o meu tio ta dormindo e a minha tia também	1	
Amor se um dia nosso filho fazer oq mh outra tia e meu outro tio faz elle nn er meu filho	1	
Aqiii em casa agora q complica mudou foi mais gente pra ca qnd minhas tia vai pra igreja meu tio fica	1	
Aqiii em casa agora q complica mudou foi mais gente pra ca qnd minhas tia vai pra igreja meu tio fica ai lasca	1	
Avisa ai a tia Regina e o tio antônio	1	
Beta diz a thiago que se ele vinher pra ca hj eu vou ta la em tio antônio ou em tia galega	1	
Bom dia tia como esta E o tio	1	
Casa da minha tia festa de aniversário do meu tio	1	
Claro q n tia achas mm Ainda nem mostrei a do tio	1	
Claro que não tio kkk dá um bj a tia Vanda Rodríguez e as primas de patas	1	
Com a minha tia e o meu tio	1	
Como o tio namora com a tia	1	
Comprei para a minha madrinha o meu tio e a minha tia	1	
Da um abraço ao teu tio nene e a tia ju	1	
Dai não sei se o tio vai direto pra i ou se vai primeiro na tia Teresa	1	
#filhos,	filhas
E acontecerá nos últimos dias diz o Senhor que derramarei do meu Espírito sobre toda a carne e os vossos filhos e as vossas filhas profetizarão os vossos mancebos terão visões os vossos anciãos terão sonhos e sobre os meus servos e sobre as minhas servas derramarei do meu Espírito naqueles dias e eles profetizarão  .	2	
Isso mesmo tem filhas pra ser noras dos parceiros q twm filhos	2	
Naqueles dias estavam os nefilins na terra e também depois quando os filhos de Deus conheceram as filhas dos homens as quais lhes deram filhos  .	2	
viram os filhos de Deus que as filhas dos homens eram formosas e tomaram para si mulheres de todas as que escolheram  .	2	
Mas os pais que criam filhas sao diferentes dos que criam filhos	1	
Uma das filhas mora na Boavista dos pinheiros com os filhos uma menina e um menino	1	
#policial,	policial
#completo,	completamente
O corpo humano após a morte dias após a morte as unhas começar a sair se dos dedos dias depois da morte os cabelos desprendem se do crânio e todos os pêlos do corpo caem dias depois o cérebro começa a apodrecer a carne seca se completamente os insectos invadem os genitais as nadegas e os seios desaparecem por completo  .	5	
Em quero começar a ser mesmo feliz ao teu lado mas não vou esquecer estes meses que ja passamos juntos nunca me senti tao feliz e completo tu dominas te completamente o meu coração quero mesmo fazer te a mulher mais feliz do universo	3	
Em quero começar a ser mesmo feliz ao teu lado mas não vou esquecer estes meses que ja passamos juntos nunca me senti tao feliz e completo tu dominas te completamente o meu coração quero mesmo fazer te a mulher mais feliz do mundo	1	
O corpo humano após a morte dias após a morte as unhas começar a sair se dos dedos dias depois da morte os cabelos se se do crânio e todos os pêlos do corpo caem dias depois o cérebro começa a apodrecer a carne seca e se se completamente os insectos invadem os genitais as nalgad e os seios desaparecem por completo  .	1	
TODOS DEVEM LER ISSO O corpo humano após a morte dias após a morte as unhas começar a sair se dos dedos dias depois da morte os cabelos desprendem se do crânio e todos os pêlos do corpo caem dias depois o cérebro começa a apodrecer a carne seca se completamente os insectos invadem os genitais as nadegas e os seios desaparecem por completo  .	1	
#sortudo,	felizmente
#rápido,	rapidamente
#raro,	raramente
Lolololol Eu raramente falo com ela mt raro e acho q ela ja namora entre nos e só amizade mais nd ja devias saber disso	1	
#surpreendente,	Surpreendentemente
#possível,	possivelmente
#infeliz,	infelizmente
/ Ana Paula Vc continua dando brecha e assunto p dayane / Ana Paula Mais digo e repito quero saber nao / Ana Paula Pq ja falei p ela sair de certos lugares ainda mais lugares q essa garota esta aff / Junior Essa infeliz vai no axe por causa da mãe dela e infelizmente carrega um filho meu	1	
#alegre,	alegremente
#principal,	principalmente
#afortunado,	Felizmente
#livre,	livremente
#seguro,	seguramente
#rápido,	rapidamente
#aparente,	aparentemente
#eficiente,	eficientemente
#rápido,	rapidamente
#preciso,	precisamente
#relutante,	relutantemente
#sério,	seriamente
#calma,	calmamente
Ele é bem inseguro normal a falta de confiança mas não é que ele não confie em ti mas é normal que ele reaja mal so tens que ter calma e aturar a birra e tentar acalmar tudo e depois explicar calmamente o q se passou uk	1	
Tha cantava calmamente e assim que estava calma calei me	1	
#feliz,	alegremente
#usual,	geralmente
#furioso,	furiosamente
#ocasional,	ocasionalmente
#imediato,	imediatamente
#profissional,	profissionalmente
#óbvio,	obviamente
Eu sonhei que eu estava num sonho bem isso onde eu tava com alguns dos meus colegas e entrei numa casa assombrada mas tipo tinha uma menina na porta como se a casa fosse uma atração sei lá daí eu entrei e era tudo escuro óbvio e muito estranho e obviamente também assustador eu não lembro muito mas eu não vi mais os meus colegas e uma hora eu percebi que pra eu sair dali eu tinha que morrer então ao mesmo tempo apareceu a Dahyun não sei como e uma mulher dando umas facadas que eu não sei se era pra ela ou pra mim eu podia ter ido pra sair logo mas eu decidi me jogar pela janela  .	1	
#repentino,	repentinamente
#típica,	tipicamente
#silencioso,	silenciosamente
#infreqüente,	infreqüentemente
#lento,	lentamente
#claro,	obscuro
