#Stockholm,	Swedia
Lowongan Kerja Freelance PT Orindo Alam Ayu oriflame Fakta tentang Oriflame Didirikan pada tahun di Swedia Terdaftar pada bursa saham Stockholm Stockholm Stock Exchange Kini telah berada di lebih dari negara di dunia  .	1	
#Manila,	Filipina
Pertanian Filipina Menghasilkan Padi Kelapa Abaca Serat Manila Dan Gula  .	1	
#Brussels,	Belgium
#Luanda,	Angola
#Nicosia,	Cyprus
#Santiago,	Chile
#Caracas,	Venezuela
#Minsk,	Belarus
Belarus free visa hari harus lewat bandara Minsk  .	1	
#Tbilisi,	Georgia
#Libreville,	Gabon
#Tegucigalpa,	Honduras
#London,	Inggris
AsmaSumber Institut Riset Atritis Edinburg Inggris Pusat Riset Obesitas di London British Medical Journal Lancel Asosiasi Dokter Umum Jerman Institut Kanker Anderson di Houston Universitas Pennsylvania dan GCLA Universitas New York di Albany Jurnal Pengobatan Alami China  .	14	
Rencananya saya akan pindah ke Inggris dan akan tinggal di Kota London selama tahun  .	2	
Inggris dan Belanda mengadakan perjanjian Convention of London yang isinya adalah berikut ini  .	1	
#Vienna,	Austria
#Warsaw,	Polandia
#Berlin,	Jerman
Ibu Chrisfina ada mama dari Wakil Duta Besar RI di Jerman yg sy kenal di Berlin  .	1	
Nah bagaimana solusi terbaik menangani masalah hukum tsb Apakah lembaga hukum tertinggi di NKRI harus dipecat semua dan diganti tokoh yang lurus tidak bisa disuap dan berkeinginan mengganti semua hukum dan tidak takut diancam keluarganya atau dirinya untuk dibunuh Ini adalah suatu kejutan revolusioner seperti jatuhnya tembok Berlin okt siapa yang nyangka Jerman bersatu lagi he	1	
#Islamabad,	Pakistan
#Bern,	Swiss
#Lima,	Peru
#Accra,	Ghana
#Tripoli,	Libya
#Gaborone,	Botswana
#Manama,	Bahrain
#Bratislava,	Slovakia
#Canberra,	Australia
#Kampala,	Uganda
#Kathmandu,	Nepal
sebelum Desember HANYA UNTUK ORANG SAJA Harga sudah termasuk Tiket Pesawat PP Jakarta Kathmandu Hotel selama malam di Nepal Makan Pagi Makan Siang dan Malam di Chitwan Local Transportasi selama di Nepal Tiket Masuk Taman Nasional Chitwan Tour Guide Tour Leader dari Jakarta Harga belum termasuk Visa on Arrival USD /orang Lunch dan DInner kecuali di Chitwan Tips Guide Pengeluaran pribadiSEATS TERBATAS  .	1	
#Lisbon,	Portugal
#Apia,	Samoa
#Belgrade,	Serbia
#Jakarta,	Indonesia
Pala Makasar Kota Jakarta Timur Daerah Khusus Ibukota Jakarta PT J&T Express Indonesia Di butuh kan Kurir/Messenger Pria Min  .	22	
WIB Auditorium Garuda Indonesia Training Center GITC Jl Duri Kosambi no Cengkareng Jakarta Barat  .	8	
Peluncuran produk ini sendiri di Indonesia dilakukan tanggal September di Grand Hyatt Jakarta di acara Press Conference dimana hadir Niclas Palmquist Vice President of Southeast Asia and Head of Indonesia dr  .	6	
Demikian ditegaskan Ketua Umum Dewan Pimpian Pusat Wahdah Islamiyah Ustadz Muhammad Zaitun Rasmin pada Tabligh Akbar Indonesia Bersatu Membela Palestina di Masjid Raya Pondok Indah Jakarta Selatan Selasa / /  .	4	
Garuda Indonesia GA Shanghai Denpasar dialihkan ke Jakarta  .	4	
Ustadz Zaitun Akan Lahir Para Mujahid dari Indonesia Untuk Membela Masjid Al Aqsa Jakarta Akan lahir mujahid mujahid dari Indonesia untuk untuk membela Masjid Al Aqsa  .	4	
Walaupun di Indonesia Bawang Putih Hitam masih asing didengar namun di sejumlah restoran di hotel Jakarta sudah menggunakan Bawang Putih Hitam sebagai bumbu andalan dalam hidangan utamanya  .	4	
DKI Jakarta bukan hanya milik warga Jakarta tapi milik seluruh bangsa Indonesia  .	3	
Dalam rangka promosi sekolah transportasi di lingkungan BPSDM Perhubungan STPI Curug hadir mengikuti pameran th Indonesia Internasional Education & Training yang dilaksanakan pada tanggal Februari di Jakarta Convention Center JCC Jakarta  .	3	
Kondisi tersebut diperkirakan mengakibatkan potensi hujan dengan intensitas lebat terjadi di beberapa wilayah Indonesia antara lain Sumatera Barat Bengkulu Sumatera Selatan Lampung Banten DKI Jakarta Jawa Barat Jawa Tengah DI Yogyakarta Jawa Timur Kalimantan Tengah bagian Selatan Kalimantan Selatan Sulawesi Tengah Sulawesi Tenggara Sulawesi Selatan Maluku Papua Barat Dengan adanya situasi potensi cuaca ekstrem ini BMKG mengeluarkan beberapa imbauan pada masyarakat yaitu Untuk waspada potensi genangan banjir maupun longsor bagi yang tinggal di wilayah berpotensi hujan lebat terutama di daerah rawan banjir dan longsor Waspada terhadap kemungkinan hujan disertai angin yang dapat menyebabkan pohon maupun baliho tumbang/roboh Agar tidak berlindung di bawah pohon jika hujan disertai kilat/petir Bagi masyarakat yang hendak memperoleh informasi terkini BMKG membuka layanan informasi cuaca jam yaitu melalui call center / follow infobmkg atau dapat langsung menghubungi kantor BMKG terdekat  .	3	
Bersediakah ibu bangun Tim di Jakarta ATOMY baru proses perijinan di Indonesia produknya semua yg konsumtif seperti sabun mandi pasta gigi	2	
Bertempat di kota Palembang dan Jakarta Asian Games menjadi momentum mengenalkan kepada dunia bahwa Indonesia adalah negara yang kaya akan keberagaman dan kuat akan persatuannya  .	2	
Di Indonesia sendiri QNET berkantor di Jakarta Surabaya dan Denpasar dengan didukung dua stockiest di Pontianak dan Balikpapan  .	2	
Dua orang ini kapan sihhh balik ke Jakarta nyaa Kemaren pergi ke Malaysia bikin mng pulang ke Indonesia langsung Ke Bandung bikin mng lagii	2	
Ini sudah dipastikan sembuh semua penyakit sembuh bahkan yang sangat parah sekalipun sudah banyak yang sembuh dan terhindar dari cuci darah dan operasi dengan biaya yang tidak sedikit hanya dan kecuali kanker otak yang tidak dapat disembuhkan dengan Ini pengiriman Jakarta sangat amanah welcome dropship bisa kirim seluruh Indonesia diJamin barang asli minat chatan ya mba	2	
Janji itu disampaikan Jokwi saat menerima dukungan dari seratusan tukang ojek yang tergabung dalam Ikatan Persaudaraan Ojek Indonesia IPOI di Jalan Borobudur Menteng Jakarta Pusat Senin / /  .	2	
Mbc bandung di dirikan pada tanggal Juli dan kita menginduk kepada MBC pusat yang berada di Jakarta yang di sebut MBC Indonesia  .	2	
Meskipun Kota Makassar jauh dari Jakarta yang merupakan pusat Indonesia  .	2	
Rangkanya dirancang untuk ukuran rata rata orang Indonesia oleh Veroland dan dibuat di Jakarta  .	2	
Rencana saya saya mau buat geng motor anak Medan di Jakarta Tangerang n beberapa kota di Indonesia dulu namanya Geng Motor Doa Ibu Ndan	2	
Selamatkanlah Indonesia dari pulau Reklamasi di Teluk Jakarta yang mau dijadikan benteng pertahanan dari orang Aseng dan Cina keturunan mau mengusai dan menjajah Indonesia untuk merebut kemerdekaan Republik Indonesia yang Syah  .	2	
Umat Islam dari berbagai penjuru Indonesia berduyun duyun menghadiri Reuni Akbar yang diselenggarakan di kawasan Monas Jakarta Sabtu / /  .	2	
com Jakarta Asosiasi Petani Garam Rakyat Indonesia APGRI kecewa dengan keputusan pemerintah	2	
com Jakarta Balkon lantai Gedung Bursa Efek Indonesia BEI ambruk  .	2	
com Jakarta Perempuan adalah aktor strategis perdamaian di Indonesia perempuan lebih toleran daripada laki laki sebanyak persen perempuan tidak  .	2	
hehe iyah ova bukan rapih lagie opa harus teliti tapi salang barkot selika tisu sama pasang harga mah di Jakarta di kiusi lagie sama pinising Jakarta baru di kirim ke Ramayana matahari seluruh Indonesia lia blom punya hp lagi opa kan hp nya di jual kartu nya di titip pin ke hp adhe eh hp adhe nya ilang	2	
kalau blusukan cuman cengar cengir planga plongo Jakarta itu Ibukota Negara Republik Indonesia bukan cuman punya nya org Jkt	2	
/ Tomi World Bank Alamat WB office Jakarta diGd Bursa Efek Indonesia Tower II lantai  .	1	
Afwan kk bisnis herbal yg bisa di jual seluru dunia produk ini asli orng Indonesia dan orng muslim yg punya kantor dn pablikx di Jakarta sama Malaysia dan kantor pusatx di makssar	1	
Aku cinta Indonesia tempat lahir ku Jakarta timur	1	
Allahu Akbar Maju terus pantang mundur gayang Zionis Cina yang membuat pulau Reklamasi teluk Jakarta di jadikan benteng pertahanan dari mereka mau menjajah dan ambisinya menguasai negeri tercinta Indonesia  .	1	
Apakah info ini benar atau Hoax ya Heboh Banser Temukan Bendera Bendera PKI Di Tempat FPIHANKAM SOSIAL BUDAYAFebruary by Raja WardoyoNo Comments on Heboh Banser Temukan Bendera Bendera PKI Di Tempat FPI BeritaMonas Jakarta Saat ini masyarakat Indonesia dihebohkan dengan ditemukannya bendera bendera PKI di tempat FPI oleh Banser/Ansor  .	1	
B Arteri Pondok Indah Jakarta Selatan bawa CV lengkap semangat bekerja Indonesia gak boleh nganggur	1	
BBM Naik Elektabilitas Jokowi Semakin Mengkhawatirkan ASPRI Jakarta Direktur Eksekutif Bimata Politica Indonesia BPI Panji Nugraha mengatakan kenaikan harga bbm non subsidi mendapat protes publik  .	1	
BREAKING NEWS Inilah Pemain Skuad Garuda Nusantara Timnas U yang akan mengikuti TC awal di Jakarta proyeksi Piala Asia U Jawa Barat Indonesia  .	1	
Bagaimana pun jumlahnya manfaatnya sungguh banyak buat kita demi kemajuan Dhamma dan mahasiswa Buddhis di Indonesia khusus nya du Jakarta	1	
Bahasan saya hanya sebatas peraturan Monas milik warga Indonesia diatur penggunaannya oleh pemerintah Pusat bukan milik warga Jakarta saja yg dgn seenaknya keluarin pergub utk Monas  .	1	
Baw aku tdi ke singapore wak numpang kencengbe abestu blek lgi ke Indonesia berangkat lgi ke arab nemuin kakek Salman abestu blek lgi ke Jakarta nemui bang ari dio nak blajar gitar	1	
Bencana gempa bumi melanda Jakarta dan sekitarnya peringatan secara tegas Allah SWT kepada kita bangsa Indonesia yang beragama bahwa maraknya perzinahan LGBT kemaksiatan Amoral seakan Habaib Alim Ulama Ustadz memperingatkan mengingatkan tidak di dengarkan suaranya tutup telinga tutup mata oleh Rezim pemerintahan Now ini malah di kriminalisasikan di hinakan  .	1	
Berikut ini daftar Sekolah tinggi ikatan dinas yang begitu lulus langsung kerja No Nama Sekolah Tinggi Lokasi Akademi Ilmu Pemasyarakatan Jakarta Jalan Raya Gandul Cinere Jakarta Selatan AKAMIGAS STEM Akademi Minyak dan Gas Bumi Sekolah Tinggi Energi dan Mineral Cepu Jawa Tengah kawasan rig dan pengeboran minyak AKIP Akademi Ilmu Permasyarakatan di bawah Kementerian Hukum dan HAM Depok Badan Meteorologi Nasional BMG Akademi Meteorologi dan Geofisika AMG Pondok Betung Bintaro Tangerang Badan Pusat Statistik BPS Sekolah Tinggi Ilmu Statistik STIS Jalan Otto Iskandardinata Nomor C Jakarta Timur Sekolah Tinggi Akuntansi Negara STAN Jalan Bintaro Utama Sektor V Bintaro Jaya Tangerang MMTC Sekolah Tinggi Multi Media Training Center di bawah Kominfo Yogyakarta Politeknik Kesehatan DEPKES Surabaya Jalan Pucang Jajar Tengah Surabaya Sekolah Tinggi Ilmu Administrasi Jalan Cimandiri Bandung Sekolah Tinggi Pariwisata Bandung Jalan Dr Setiabudi Bandung Sekolah Tinggi Penerbangan Indonesia Curug Banten Jalan Raya PLP Curug Tangerang Sekolah Tinggi Perikanan Jakarta Jalan AUP Pasar Minggu Jakarta Selatan Sekolah Tinggi Pertanahan Nasional Yogyakarta Jalan Tat	1	
Bersediakah ibu bangun Tim di Jakarta ATOMY baru proses perijinan di Indonesia produknya semua yg konsumtif seperti sabun mandi pasta gigi baju kosmetik dan kebutuhan laennya  .	1	
Bersyukur di Indonesia cina gagal menduduki Jakarta tapi tanah air Indonesia	1	
Cabang Mangga Dua Raya Jakarta No Rekening atas nama Perhimpunan Advokat Indonesia  .	1	
Dari soaking bersama murid murid Bethel School of Supranatural Redding California di Jakarta House of Prayer Plaza Indonesia lt  .	1	
Di mna ya Yg jls yah di Indonesia lebih rinci nyq lgi di Jakarta	1	
Dilam di Jakarta utara dilam kelapa gading mall of Indonesia	1	
Dinda Aku tak tahu apa yang harus dilakukan dengan senam hamil lebih baru posting di blogspot dan cara alami mengobati batuk yang tepat bagi para mahasiswa jurusan TK tunas muda dan cantik di Indonesia dan PT Bank ANZ Panin Syariah dan konvensional dan tidak dapat dipisahkan oleh jarak yang cukup tinggi di dunia dan di mana saja yang bisa dilakukan dengan menggunakan alat ini sangat cocok bagi anda yang ingin dicapai dan dimiliki oleh seorang yang sangat baik bagi kesehatan umum dan khusus dewasa ini wanita telentang dan bibi Tutik undangan J Hai hai semua orang lain dan tidak dapat diganggu gugat dan di mana mereka dapat dengan mudah dapat dipisahkan oleh jarak jauh dan tidak ada satu pun tidak bisa dipungkiri dengan banyaknya lapangan kerja yang baik untuk kesehatan dan pendidikan kewirausahaan dan cara merawat dan membersihkan wajah yang cantik selalu ada di Indonesia yang memiliki nilai yang lebih tinggi dari pada dicintai dan disayangi oleh jarak jauh yang lebih tinggi dibandingkan pria yang juga menjadi bagian yang tak bisa lagi memberi keleluasaan bagi wanita yang sedang hamil tapi tidak ada komentar untuk foto atau gambar yang lebih baik dari segi ekonomi dan bisnis anda sudah bisa digunakan dalam pembuatan SIM keliling dunia semenit untuk kelas gue yang lebih tinggi dari pada lu itu ngga tau alamat kantor dinas kesehatan kabupaten Bekasi Jawa timur Jakarta Selatan Jakarta DKI Jawa timur Indonesia dan PT KAI juga dapat digunakan sebagai alat komunikasi tersebut akan sangat mengganggu bagi penderitanya menjadi sangat penting untuk menjaga keseimbangan yang tepat untuk melakukan hal itu akan menjadi sebuah kebutuhan yang sangat penting bagi para remaja yang sedang terjadi dan tidak dapat dimuat dalam jurnal ilmiah tentang struktur tubuh jamur yang menyebabkan seseorang merasakan hal yang tidak bisa bayar obat ini tidak bisa dipungkiri lagi bahwa ia adalah seorang gadis kecil yang kemudian menggunakan alat bantu untuk memproses data dan informasi lainnya silahkan klik /  .	1	
Ex timnas Indonesia Gendut doni resmi gabung tim ibu kota PERSIJA Jakarta untuk musim	1	
Goblok dipelihara Indonesia itu memang negara yg rawan gempa dan gempa kmaren pusatnya silbak banten Jakarta kebagian gonjangannya ambil hikmah plajaran buat smua  .	1	
Hati virus Zika Saat ini didapati virus Zika sudah mewabah sampai Lampung Jakarta Bandung Surabaya Bali dan di beberapa kota besar Indonesia lainnya  .	1	
#Lilongwe,	Malawi
#Ljubljana,	Slovenia
#Moskowa,	Rusia
#Tirana,	Albania
#Ottawa,	Kanada
#Nairobi,	Kenya
#Copenhagen,	Denmark
#Niamey,	Niger
#Abuja,	Nigeria
#Windhoek,	Namibia
#Podgorica,	Montenegro
#Polandia,	zloty
#Brazil,	real
#Vietnam,	dong
#Sweida,	krona
#Angola,	kwanza
#Jepang,	yen
Tunjangan kedatangan senilai yen Rp juta yang diberikan pada saat kedatangan di Jepang  .	10	
Harga emas kembali bergerak di Zona hijau dan melesat naik ke level /toz pada hari Rabu / karena Turunnya Dolar AS ke level terendah dalam satu setengah bulan terhadap yen yang disebabkan adanya langkah bank sentral Jepang BoJ yang mengurangi jumlah pembelian obligasi Japanese Government Bond JGB jangka panjangnya hal ini telah memicu ekspektasi pengetatan moneter di tahun ini dan meningkatkan penguatan kinerja mata uang Yen serta mengirim Dolar AS untuk merosot tajam yang berimbas pada menguatnya harga logam mulia emas  .	4	
Yen melemah karena rakyat Jepang pesimistisKepercayaan masyarakat terhadap ekonomi Jepang yang memudar membuat yen melemah di hadapan mata uang utama dunia lainnya  .	2	
#Meksiko,	peso
#Latvia,	lats
#Lithuania,	litas
#Hungaria,	forint
#AS,	dolar
Harga emas berpeluang bergerak bearish dalam jangka pendek seiring kembali menguatnya dolar setelah perilisan data AS semalam yang mendukung untuk adanya kenaikan suku bunga AS di bulan Desember  .	1	
justru menurunkan kembali anggaran belanja militer AS yang hampir menyentuh miliar dolar menjadi miliar dolar pada tahun  .	1	
pengeluaran pertahanan AS hanya berkisar miliar dolar amerika per tahun sedangkan pada Presiden Bush meningkat dari miliar dolar pada tahun hingga melebihi miliar dolar di akhir masa jabatannya  .	1	
#Denmark,	krone
#Armenia,	dram
#Thailand,	baht
#Nigeria,	naira
#Romania,	leu
#Argentina,	peso
#Rusia,	ruble
#Algeria,	dinar
#Ukraina,	hryvnia
#Kroasia,	kuna
#Kambodia,	riel
#Kanada,	dolar
#Korea,	won
#Eropa,	euro
Pkg Optimisme investor Eropa meningkat lead Investor zona euro optimistis menyongsong bulan Januari ini// Investor justru mengabaikan pemerintahan baru di Jerman dan ekonomi global yang meningkat// Indikasi itu terbaca dari survei Sentix yang dilakukan terhadap investor di Eropa// roll pkg Visual eropa Investor zona euro optimistis menyongsong bulan Januari ini// Investor justru mengabaikan pemerintahan baru di Jerman dan ekonomi global yang meningkat// Indikasi itu terbaca dari survei Sentix yang dilakukan terhadap investor di Eropa//Dari survei tersebut/ indeks Sentix untuk zona euro pada Januari meningkat menjadi dari Desember yang sebesar // Angka tersebut mengalahkan konsensus Reuters yang memperkirakan sebesar // Perekonomian di semua wilayah di dunia terlihat stabil dan positif menunjukkan perbaikan yang moderat//tulis perusahaan riset tersebut//Bisnis pun dinilai tidak akan terganggu adanya koalisi baru di Jerman// Upaya Kanselir Angela Merkel membentuk koalisi di tahun lalu gagal// Merkel baru memulai pembicaraan dengan Partai Sosial Demokrat pada januari // Dia sangat yakin dapat menyetujui untuk membentuk pemerintah koalisi//Jika investor tak memperhatikan efek koalisi/ mereka justru fokus pada dampak reformasi pajak AS yang bakal meningkatkan keuntungan perusahaan dan mendorong permintaan barang modal//Berbagai	1	
Pkg Optimisme investor Eropa meningkat lead Investor zona euro optimistis menyongsong bulan Januari ini// Investor justru mengabaikan pemerintahan baru di Jerman dan ekonomi global yang meningkat// Indikasi itu terbaca dari survei Sentix yang dilakukan terhadap investor di Eropa// roll pkg Visual eropa Investor zona euro optimistis menyongsong bulan Januari ini// Investor justru mengabaikan pemerintahan baru di Jerman dan ekonomi global yang meningkat// Indikasi itu terbaca dari survei Sentix yang dilakukan terhadap investor di Eropa//Dari survei tersebut/ indeks Sentix untuk zona euro pada Januari meningkat menjadi dari Desember yang sebesar // Angka tersebut mengalahkan konsensus Reuters yang memperkirakan sebesar // Perekonomian di semua wilayah di dunia terlihat stabil dan positif menunjukkan perbaikan yang moderat//tulis perusahaan riset tersebut//Bisnis pun dinilai tidak akan terganggu adanya koalisi baru di Jerman// Upaya Kanselir Angela Merkel membentuk koalisi di tahun lalu gagal// Merkel baru memulai pembicaraan dengan Partai Sosial Demokrat pada januari // Dia sangat yakin dapat menyetujui untuk membentuk pemerintah koalisi//Jika investor tak memperhatikan efek koalisi/ mereka justru fokus pada dampak reformasi pajak AS yang bakal meningkatkan keuntungan perusahaan dan mendorong permintaan barang modal//Berbagaibsumber	1	
#Malaysia,	ringgit
Mata uang Malaysia ddu real tp ringgit	1	
#Iran,	rial
#India,	rupee
#Makedonia,	denar
#Bulgaria,	lev
#Wichita,	Kansas
#Akron,	Ohio
#Irvine,	California
#Toledo,	Ohio
#Indianapolis,	Indiana
#Denver,	Colorado
#Milwaukee,	Wisconsin
#Reno,	Nevada
#Boston,	Massachusetts
OMG Pembekuan banjir menenggelamkan mobil di jalan dekat Boston saat air pasang naik dan badai salju membanjiri Massachusetts pesisir dengan air dingin  .	1	
#Minneapolis,	Minnesota
#Bakersfield,	California
#Henderson,	Nevada
#Seattle,	Washington
#Atlanta,	Georgia
#Chandler,	Arizona
#Dallas,	Texas
#Madison,	Wisconsin
#Tampa,	Florida
#Tallahassee,	Florida
#Irving,	Texas
#Fontana,	California
#Anaheim,	California
#Fresno,	California
#Amarillo,	Texas
#Hialeah,	Florida
#Pittsburgh,	Pennsylvania
#Austin,	Texas
