#Sacramento,	California
#Portland,	Oregon
#Glendale,	California
#Jacksonville,	Florida
#Shreveport,	Louisiana
#Lexington,	Kentucky
#Tulsa,	Oklahoma
#Glendale,	Arizona
#Tucson,	Arizona
#Mesa,	Arizona
#Spokane,	Washington
#Memphis,	Tennessee
#Oxnard,	California
Itu daerah Oxnard city di State of California mencakup desa kecil a  .	1	
#Tacoma,	Washington
#Lubbock,	Texas
#Worcester,	Massachusetts
#Miami,	Florida
#Cleveland,	Ohio
#Scottsdale,	Arizona
#Louisville,	Kentucky
#Stockton,	California
#Detroit,	Michigan
#Phoenix,	Arizona
#Philadelphia,	Pennsylvania
#Huntsville,	Alabama
#Cincinnati,	Ohio
#Honolulu,	Hawaii
#Nashville,	Tennessee
#Oakland,	California
#Houston,	Texas
#Fremont,	California
#Orlando,	Florida
#Arlington,	Texas
#Omaha,	Nebraska
#Laredo,	Texas
#Chicago,	Illinois
#Baltimore,	Maryland
#Anchorage,	Alaska
#Plano,	Texas
#Modesto,	California
#Garland,	Texas
#kakak/adik,	kakak/adik
#ayah tiri,	ibu tiri
#dia,	dia
#cucu,	cucu
#pria,	wanita
tapi ketahuilah wanita masih tetap perdiri tegar meski pria telah menghantamnya dengan banyak rasa sakit yang mendera  .	75	
wanita masih tetap seperti orang yang sama ketika pria berusaha dan menghindar lantas datang kembali membawa asa  .	42	
Walaupun terjadi aku akan ttap berusaha untuk membuat hubungan kalian hancur Ucap wanita itu dengan penuh amarah dan tersenyum licik Tiba di belakang wanita itu datang lah seorang pria tua yang tak lain adalah Papa nya  .	33	
World Slimming Capsules WSC Biolo tidak hanya dapat dikonsumsi oleh wanita tapi juga sudah banyak pria yang terbukti sukses menurunkan berat badan karena produk ini  .	24	
Selain bisa dipake untuk wanita oxyglow ini juga bisa dipake untuk pria  .	22	
Suksesnya seorang pria dalam berkarir pasti ada wanita hebat di belakangnya yaitu ISTRINYA  .	22	
Pasti pria itu akan memilih wanita yang taat dan auratnya terjaga  .	20	
Karena Maaf sebejat bejatnya pria ia pasti merindukan wanita baik baik  .	16	
Tadi gak ada pulsa padahal pergikaraoke n hang out breng orang ke Ketika sore hari sesudah pulang setelahjalan bersamaorang ke si wanita bermaksud datangke rumah si pria supaya si pria gakmarah karena sejak malam sang priatidak menghubungi dia  .	16	
Ada beberapa pria pernah beranggapan bahwa ketika wanita sedang marah atau ngambek maka kecantikannya akan bertambah  .	15	
Karena pria yg berhasil mendapatkan wanita seperti itu dijamin mendapatkan surga di rumahnya  .	15	
Ketika wanita tdk cerewet lgi tdk lagi beradu pendapat menurut segalanya yang pria katakan tdk lagi mengeluh tdk lagi bertanya sedang apa dimana dan kapan pulang  .	15	
Baru setelah selesai ijab kabulnya pengantin wanita keluar menemui pengantin pria setelah mereka telah sah  .	14	
Dalam sesi ini juga bisa dilanjutkan dengan pemasangan cincin pernikahan dari mempelai pria ke tangan mempelai wanita  .	14	
Dia langsungpergi ke rumah sang pria dia melihatpacarnya sudah tertidur di atas kainputih dengan memegang cincin'Keluarga si pria memberikan HP si priauntuk di lihat oleh si wanita betapakagetnya si wanita ketika melihat sipria  .	14	
Jadilah wanita cerdas Kalo hanya DM WA atau INBOX pria juga bisa  .	14	
Chandra Saya ingin kamu bersama tim pria Durdhara Tidak saya sudah bersama dengan calon pengantin wanita Chandra Kamu tidak bisa Nandini adalah langkah kamu Durdhara Tidak masalah apakah Helina berbicara dengannya Chandra Helina itu pernikahan madhavs apakah kamu akan bergabung dengan tim kami  .	13	
Selain bisa dipakai untuk wanita bisa dipakai untuk pria juga loooooh  .	12	
Rumor menyebar oleh pria yang tidak bisa memiliki wanita atau wanita yang tidak bisa bersaing dengannya  .	11	
Selamat siang semuanya ini kenalin produk perawatan rambut para artis hair spa dan hair repair yang bagus buat gatasi masalah rambut wanita juga bisa digunakan untuk pria ada varian hairspa yang masing masing tentu punya manfaatnya sendiri yukk intip varian apa yang cocok buat masalah rambut mu  .	11	
Walaupun terjadi aku akan ttap berusaha untuk membuat hubungan kalian hancur Ucap wanita itu dengan penuh amarah dan tersenyum licik Tiba di belakang wanita itu datang lah seorang pria tua yang tak lain adalah Ayah nya  .	11	
Apalagi jika kepergian wanita / istri bercampur baur dengan para pria  .	10	
Berdasarkan hadits di atas Ibnu Hajar mengatakan bahwa wanita adalah godaan terbesar bagi para pria dibanding lainnya  .	9	
Ada pepatah berkata Kalau kamu bercermin dan menemukan kalau dirimu semakin lama semakin cantik maka kamu menemukan orang yang tepat Banyak pria yang berkata ingin menikahi wanita yang cantik lemah lembut dan baik hati  .	8	
Jika seorang wanita menangis karnadisakiti oleh pria maka setiap langkahpria tersebut dikutuk oleh para malaikat  .	8	
Kelemahan pria adalah terlalu mudah berjanji sedangkan kelemahan wanita adalah terlalu cepat mempercayai  .	8	
Ketika wanita tdk cerewet lg tdk lg beradu pendapat menurut pd segala yg pria katakan tdk lg mengeluh tdk lg bertax sedang aph dimn dan kpn pulang  .	8	
Seorang Pria mendambakan wanita yang sempurna dan seorang wanita pun juga mendambakan pria yang sempurna namun mereka tidak tahu bahwa Allah telah menciptakan mereka untuk saling menyempurnakan satu sama lain  .	8	
meski wanita terlihat tidak peduli meski wanita terlihat mengacuhkan tapi percayalah jauh dilubuk hatinya wanita punya sejuta do'a untuk pria  .	8	
wanita masih tetap seperti orang yang sama ketika pria berusaha dan menghindar	8	
Bahwa wanita masih tetap berdiri tegarMeski pria telah menghantamnya	7	
Chandra pergi ke durdhara dan mengatakan bahwa saya ingin kamu bersama tim pria durdhara mengatakan tidak saya sudah bersama dengan calon pengantin wanita Chandra mengatakan bahwa kamu tidak bisa Nandini adalah langkah kamu kata durdhara tidak masalah apakah Helina berbicara dengannya Chandra mengatakan helina itu pernikahanmadhavs apakah kamu akan bergabung dengan tim kami Helina bilang jangan memikirkannya dan saya bahkan tidak akan menjadi bagian darinya dan pergi  .	7	
DIBALIK PRIA SUKSES ADA WANITA HEBATSaya percaya itu jika ada pria sukses dalam kehidupannya maka lihatlah siapa wanita yang ada dibelakangnya  .	7	
Selamat siang semuannya ini kenalin produk perawatan rambut para artis yang baik untuk ngatasi masalah rambut wanita yang juga bisa digunakan oleh para pria lohh ada varian hairspa dan varian untuk hairrepair yang tentunya setiap varian punya manfaatnya sendiri yukkk yang punya masalah rambut segera intip varian apa yang paling cocok buat ngatasi masalah rambutmuHAIR SPA  .	7	
Tak hanya kaum pria saja yang bisa menggunakannya kaum wanita pun juga bisa menggunakannya  .	7	
Umumnya pria rela berbuat apa saja untuk wanita nya karna apa  .	7	
Aku ingin menjadi wanita di balik kesuksesan seorang pria  .	6	
Jgn jdi wanita bdoh hnya krna pria bertampang penipu Nnti klo mata so tabuka bru sadar ternyta slama  .	6	
Pernah ada orang berkata kesetiaan seorang wanita diuji ketika sang pria tidak mempunyai apa apa dan kesetian seorang pria diuji ketika ia telah mempunyai segalanya  .	6	
Selamat malam pria tampanTanpa status hubunganKapan mau jadi wanita idaman kalo hanya diberi harapanLalu ditinggalkanHastag SSSSSTag Devi	6	
Tapi wanita SHOLEHAH yang membuat menetap di hati para pria  .	6	
Tipe wanita seperti ini bukan hanya mampu mendorong sang pria untuk melangkah namun juga membuatnya berani mengambil risiko  .	6	
herbastamin juga bisa buat anda para bpk dengan masalah sperma bisa buat keharmonisan keluarga anda progam hamil gak cuma wanita saja yang punya masalah kewanitaan pria dewasapun punya masalah seperti ejakulasi dini sperma kurang & sering loyo sebelum mencapai puncaknya hati para bapak  .	6	
jadi kalo ada seorang pria berkata kasar pada wanita wanita tersebut merasa direndahkanSekali lagi mama minta maaf ya sayang	6	
Aku memiliki pria dengan jutaan teman wanita  .	5	
Bahwa wanita masih tetap berdiri tegarMeski pria telah menghantamnya dengan banyak rasa sakityang mendera  .	5	
Dibalik pria yang sukses ada seorang wanita hebat  .	5	
Dibalik pria yang tidak sukses ada dua wanita	5	
Kebahagiaan pria akan sempurna saat ia mendapatkan wanita yang memberikan kasih sayang sepenuh hatinya  .	5	
Kebahagian seorang wanita bukan karna ketampanan pria  .	5	
#anak tiri,	anak tiri
#suami,	istri
Selain patuh istri juga bertanggung jawab melayani segala kebutuhan suami  .	42	
Kedamaian seorang istri terletak pada kepercayaannya pada suami  .	21	
Tapi suami yg baik adalah ia yg dapat membedakan mana yg lebih utama antara istri dan keluarganya  .	17	
Karna kedamaian seorang istri terletak pada kepercayaannya pada suami  .	16	
Bagaimana dengan kita Apa yang kita istri andalkan jika kita berani berani pada suami Istri harus mencari ridhonya suami  .	15	
Sama Warning Tulisan ini hanya akan cocok jika dibaca oleh istri dan dijalankan olehnya bukan dipaksa sama suami untuk membaca dan melakukannya  .	15	
Terimah ksh yaallah engkau msh memberikan umur yg panjang semoga di sisa umurku jadi berkah jadi istri yg terbaik buat suami hamba lindungi rmh tangga hamba dr kejahatan  .	15	
Terdidiknya seorang istri tergantung tingkat kesalehan seorang suami  .	13	
INtinya pria tersebut mengungkapkan bahwa suami bisa seligkuh karena sang istri yang bau dapur pulang kerja capek malah harus lihat istri dengan daster dan bau dapur  .	11	
Maka jgn harap istri menyuntik kedamaian pada hati suami  .	11	
Warning Tulisan ini hanya akan cocok jika dibaca oleh suami dan dijalankan olehnya bukan dipaksa sama istri untuk membaca dan melakukannya  .	11	
iya laa biar suami betah diruma gak minta makan istri orang	11	
telah bersabda Empat perkara barangsiapa memilikinya berarti dia mendapatkan kebahagiaan dunia dan akhirat hati yang selalu bersyukur lisan yang selalu berdzikir badan yang sabar dikala mendapat musibah dan istri yang dapat menjaga kehormatan diri serta dapat menjaga harta suami  .	11	
Ahmad Beberapa adab wanita / istri jika keluar rumah adanya izin orang tua / suami jika sudah memiliki  .	10	
Ahmad dan Ibnu Hibban Jika ada problematika rumah tangga terkadang setan membujuk istri agar tidak taat kepada suami untuk pergi meninggalkan rumah dengan berbagai alasan & pembenaran  .	10	
biarkan saja yg terpenting dlm hidup saya sbgai seorang istri bisa mnjdi istri yg baik buat suami saya bisa mnjdi ibu yg baik buat anak saya  .	10	
dlm keadaan suami alhamdulilah bgt d angkt derajatx sm Allah aku jg d uji sbg istri  .	10	
seorang suami akan lari dri istrinya istri akan lari dri anaknya seorang teman sejati akan lari dri sohibnya begitulah sebaliknya  .	10	
Aku juga akan menutup telinga dari para istri yang menceritakan penghasilan suami mereka yang lebih besar darimu atau mengabarkan bahwa mereka dibelikan ini dan itu oleh suami mereka  .	9	
Biasanya klo bkn dri kta dri sikap aq tunjukkin dan it sbg suami pasti mmhami maunya istri	9	
Cucuk Santoso merasa geram dengan seorang pria yang menuliskan keluhannya tentang istri yang kerap pakai daster dan bau dapur ketika suami pulang kerja  .	9	
Suami yang bisa menjadi imam yang baik adalah suami yang senantiasa mengajak istri dan keluarganya memiliki keteguhan hati sehingga lahirlah sifat qana ah sabar dan tawakkal  .	9	
makasih ayah udah jadi suami yang bisa bimbing bunda semoga bunda bisa jd istri soleha  .	9	
mau minta k suami trus kan kasian istri shaliha  .	9	
Bila seorang suami gemar melakukan perbuatan maksiat sudah sepatutnya seorang istri memohon perlindungan kepada Allah SWT supaya pendamping hidupnya itu diberi hidayah  .	8	
Cemburu boleh tapi setidaknya sebagai suami and aharus bisa mengatur rasa itu dan memahami keinginan istri anda  .	8	
Diketahui Tedhy Sukma yang menuliskan suami pulang kerja kena macet di jalan sampai rumah harapannya ada penyegaran mata eh istri dengan daster dan acak acakan rambutnya dan masih bau dapur menyambut suami  .	8	
Kesuksesan suami bisa di lihat dari penampilan sang istri bukan di lihat dari apa yg di pakai suami  .	8	
MasyaAllah Barakallah ukhty ku syg Semoga menjadi keluarga yg Sakinah Mawaddah Warahmah dan menjadi istri yg shalehah buat suami	8	
Selalu mendukungSuami idaman adalah suami yang selalu mendukung keinginan istri misalnya istri memutuskan untuk bekerja atau istri ingin menjadi ibu rumah tangga  .	8	
Sesama istri pelaut saling memberi semangat dan selalu berpikiran positif ttg suami yg lg cari nafkah buat anak dan istri	8	
Warning Tulisan ini hanya akan cocok jika dibaca oleh suami dan dijalankan olehnya bukan dipaksa sama istri untuk membaca dan melakukannya Sumber Group Rahasia Magnet Rezeki Ust  .	8	
adit sebagai suami harus tau urusan istri karna segala sesuatu suami wajib tau  .	8	
ia lebih bhagia saat diri mu menjadi sosok istri yg menjga kcantikn tuk suami nya sendiri  .	8	
panjang umur sehat murah rejeki selalu menjadi suami yg baik untukku walai diriku mungkin bkn istri yg baik dn sempurna  .	8	
para laki laki dengan mau belajar sikap yang seperti dibawah ini kamu mampu kok jadi suami yang selalu menjadi pujaan sang istri  .	8	
Dengan dinding vagina yang relatif bersih organ intim wanita lebih peka dalam menerima rangsangan berdampak istri lebih bisa menikmati saat bersama suami  .	7	
Karena bagi istri kebahagiaannya tak akan lengkap tanpa suami di sisinya  .	7	
Kewajiban sebagai istri tidak berubah ape pon itu mengutamekan suami dr pade spj  .	7	
Si istri pun tersenyum dan membiarkan si suami memotret Kemudian si suami mandi  .	7	
Suami itu mau nya banyak makanya jadi istri harus pinter kasih yg bikin suami kelepek  .	7	
Suami lebih sering memaklumi wanita yang bengkok dan sering sering memperbaiki danmenasehati seringnya wanita hanya emosi sesaatdan mengeluarkan kata kata yang menyakitisuamiTetapi ketahuilah bahwa wanita itu sangat cintasuaminya maka pelukan kepada istri sambil terusmendengarkan dan menenangkan adalah solusinyaPerhatikan juga para suami Jika ada sesuatuyang tidak beres pada istri dan anak anak bisajadi akibat maksiat suami maka intropeksi diridan perbanyak istigfar  .	7	
Teman teman bidan atau mahasisswa kebidanan anak kesehatan dan mahasiswa kesehatan lainya dijual tiket seminar SKP IBI bagi yg manambah pengetahuan tentang GENTLE BIRTH atau untuk para gadis yg siap dipersunting ibu hamil atau yg lagi merencanakan kehamilan juga bisa ikut seminar ini sebagai persiapan biar proses kehamilan dan persalinanya nyaman aman menenangkan lancar jauh dari rasa nyeri Jadi bagi suami atau bapakpun mampu menambah pengetahuan membantu istri dalam mendampingi proses persalinan  .	7	
Aku siap jd istri yg selalu bantu suami  .	6	
Apha adha seorng suami yg tega blng istri ny gc pny hrga diri sprti ny gc adha yah	6	
Ayang maaf sya chtan sma suami orang dia nya nanyain kabar istri nya ke sya jdi sya bls chat nya	6	
Buat para istri yg sudah kehabisan cara melarang suami merokok tapi suami sdh terlanjur kecanduan  .	6	
Cucuk menuliskan agar seorang suami paham akan pekerjaan istri di rumah  .	6	
Dibalik seorang suami yg sukses ada seorang istri yg mendo'akanNya Love you my wife	6	
Itu hak seorang istri dan kewajiban seorang suami	6	
#kakek,	nenek
Heemhh aku gaberani galak sama kakek aku mah hahahah biar nenek aku ajaa yang galakin kakek aku buat mau maksain makan walau cman sesuap	2	
Yaallah sembuhkan lah nenek ku yaallah jangan sampe nenek ku diambil lagi setelah allah udah ngambil kakek ku	2	
tapi kan masik adh nenek nya syang sama kakek nya syang  .	2	
Abis nenek ojah ngeluh sakit ngajakin krmh kakek haji mulu	1	
Ada nenek jga ga ngaruh buat kakek	1	
Aku Syng ama mama aku bunda aku papa aku dan nenek aku serta adek dan kakek aku	1	
Aku mau kok jadi kakek asal kamu yg jadi nenek nya	1	
Aku pengen nengokin nenek di kampung sayang soalnya nenek aku sendirian di rumah kakek aku udh meninggal	1	
Anton kn anak kakak bos kandung sdgkn jery kakek kami yg bersaudara sm nenek bpknya	1	
Aoaoao wajar aku cerita kmu kan nenek baru aku ahahahh gak dapn yg bujangan kakek put di sikak kmu jugadasar jomblo	1	
Apa nenek mau bercinta sama kakek	1	
Aq nitipin nabila yaa nenek mw daftar buat kakek operasi mata bsk mungkin jam  .	1	
Ary aku bangun kakek ku udah berangkat Tunggu ya kalau aku di kasi uang sm nenek Ntar siang aku chat ya	1	
Aslm wr wb salam silaturahmi buat keluarga besar kakek abd rosid dan nenek bariyah  .	1	
Berarti tsunade itu keturunan dari dua clan yah min kakek nya dari clan senju dan nenek nya dari clan uzumaki	1	
Bii nti ya uang u baru aja dipinjem ma kakek u mau nebus obat nenek idah	1	
Bilangin nenek siapin kaos butuh kakek ntar sm ayh dibw	1	
Bukan kakek yg merantau kesana nenek memang asli disana orangtua nenek asli langkawi	1	
Bunda arita ini ada yg mau daftar waiting list Yanda Hybnu kakek cantik Bunda Sri Hartini nenek cantik	1	
Ceritanyaa lagi ngedengerin nenek cerita tentang kisahnya pas ketemu kakek masih muda	1	
Ceritanyaa lagi ngedengerin nenek cerita tentang kisahnya pas ketemu kakek masih muda cucu yang baik ngedengerin	1	
Coba mi saja kasi tau bilang subu nama kakek na kamaria nama nenek na  .	1	
Cu ini foto nenek masih muda waktu nenek masih menunggu kedatangan kakek kamu preettt	1	
Cuma ada ade sama nenek yg lain lgi ke kidul ngurus meninggalnya kakek	1	
D rumah nenek gua udh gak pernah ada pohon natal lagi semenjak kakek gua ninggal mbk	1	
Dan trnyata si kakek brada Lantai diatas nenek pada sbuah panti jompo  .	1	
Dari mama n bapakmu pun bgt panggil nenek sodaramu tante mu om mu n klo bs panggil polisi kakek kasri atw keluargax bpmu yg tentara spy sabir bs takut u berulah lg nak	1	
Denger nenek ngeruce tu la yg buat kakek marah tu	1	
Emng kakek berbuat jahat apa sama nenek	1	
Fadil di rawat same nenek fadil tante fadil paman kakek tuu lee mereka lee yee besarkan fadil dari kecil hingga sekarang klo bayar baju ape ape semua buku lee pokok die semua tuu tante fadil ama paman ama kakek	1	
Gimana bronis dei kakek tak cansel ya nek kan ada banyak makanan gimna menurut nenek	1	
Gk kakek yg org alorr nikah sama nenek aku	1	
Gx pp kok kakek biar ngerasain gmana jadi nenek	1	
Hahaa biar aku jdi nenek asalkan kamu jdi kakek ny	1	
Hahah itu salh nenek kau barang nenek kau ndk bepelok dgn kakek ka	1	
Hahah itu salh nenek kau barang nenek kau ndk bepelok dgn kakek kau	1	
Hahaha ya ke kakek bru lusi ini nenek	1	
Hahahah engk yoo kakek beneran sayang ke nenek	1	
Hahahahaha njirrr udah di panggil kakek kakek nya geseng pula emng ngelunjak ini nenek nenek	1	
Hanya bukin kopi kakek sama bikin susu nenek  .	1	
Hehe iya itu fto tahun bang pas acara ulang tahun nenek alhmdllah d kluarga aku kalo nnek atau kakek ultah suka di rayain kluarga aja sih makan makan doang ibarat nya syukuran gtu lah bang	1	
Hhmm kmu enak masih punya kakek aku mah dari kecil gk pernah ngerasain kasih sayang seorang kake nenek dari ayah ataupun mamah aku	1	
Ia kek nenek juga ngirimim foto kakek	1	
Idiiiih kakek ini maluuu yo maluu tp tar mlh nenek yg malu	1	
Info aja ke nenek aku juga agak bingung karena besok aku ke Bandung jemput kakek	1	
Itu nenek aku yang lubis tapi kakek aku bukan org batak oca	1	
Itu pun kakek tu yang suruah imi pakai baju seragam lo kakek tu adiak laki nenek	1	
Iy ini mah nenek lgi cri pngnti s kakek y hlang hanyut d laut	1	
Iya dy blg ma nenek klo udh ijin kakek pdahal ga  .	1	
Iya kakek juga sayang sama nenek	1	
#pengantin pria,	pengantin wanita
Paningset diserahkan oleh pihak calon pengantin pria kepada pihak calon pengantin wanita paling lambat lima hari sebelum pernikahan  .	1	
yang akan melakukan akad nikah adalah pengantin pria dengan wali dari pihak pengantin wanita gt Mas	1	
#kakek,	nenek
Heemhh aku gaberani galak sama kakek aku mah hahahah biar nenek aku ajaa yang galakin kakek aku buat mau maksain makan walau cman sesuap	2	
Yaallah sembuhkan lah nenek ku yaallah jangan sampe nenek ku diambil lagi setelah allah udah ngambil kakek ku	2	
tapi kan masik adh nenek nya syang sama kakek nya syang  .	2	
Abis nenek ojah ngeluh sakit ngajakin krmh kakek haji mulu	1	
Ada nenek jga ga ngaruh buat kakek	1	
Aku Syng ama mama aku bunda aku papa aku dan nenek aku serta adek dan kakek aku	1	
Aku mau kok jadi kakek asal kamu yg jadi nenek nya	1	
Aku pengen nengokin nenek di kampung sayang soalnya nenek aku sendirian di rumah kakek aku udh meninggal	1	
Anton kn anak kakak bos kandung sdgkn jery kakek kami yg bersaudara sm nenek bpknya	1	
Aoaoao wajar aku cerita kmu kan nenek baru aku ahahahh gak dapn yg bujangan kakek put di sikak kmu jugadasar jomblo	1	
Apa nenek mau bercinta sama kakek	1	
Aq nitipin nabila yaa nenek mw daftar buat kakek operasi mata bsk mungkin jam  .	1	
Ary aku bangun kakek ku udah berangkat Tunggu ya kalau aku di kasi uang sm nenek Ntar siang aku chat ya	1	
Aslm wr wb salam silaturahmi buat keluarga besar kakek abd rosid dan nenek bariyah  .	1	
Berarti tsunade itu keturunan dari dua clan yah min kakek nya dari clan senju dan nenek nya dari clan uzumaki	1	
Bii nti ya uang u baru aja dipinjem ma kakek u mau nebus obat nenek idah	1	
Bilangin nenek siapin kaos butuh kakek ntar sm ayh dibw	1	
Bukan kakek yg merantau kesana nenek memang asli disana orangtua nenek asli langkawi	1	
Bunda arita ini ada yg mau daftar waiting list Yanda Hybnu kakek cantik Bunda Sri Hartini nenek cantik	1	
Ceritanyaa lagi ngedengerin nenek cerita tentang kisahnya pas ketemu kakek masih muda	1	
Ceritanyaa lagi ngedengerin nenek cerita tentang kisahnya pas ketemu kakek masih muda cucu yang baik ngedengerin	1	
Coba mi saja kasi tau bilang subu nama kakek na kamaria nama nenek na  .	1	
Cu ini foto nenek masih muda waktu nenek masih menunggu kedatangan kakek kamu preettt	1	
Cuma ada ade sama nenek yg lain lgi ke kidul ngurus meninggalnya kakek	1	
D rumah nenek gua udh gak pernah ada pohon natal lagi semenjak kakek gua ninggal mbk	1	
Dan trnyata si kakek brada Lantai diatas nenek pada sbuah panti jompo  .	1	
Dari mama n bapakmu pun bgt panggil nenek sodaramu tante mu om mu n klo bs panggil polisi kakek kasri atw keluargax bpmu yg tentara spy sabir bs takut u berulah lg nak	1	
Denger nenek ngeruce tu la yg buat kakek marah tu	1	
Emng kakek berbuat jahat apa sama nenek	1	
Fadil di rawat same nenek fadil tante fadil paman kakek tuu lee mereka lee yee besarkan fadil dari kecil hingga sekarang klo bayar baju ape ape semua buku lee pokok die semua tuu tante fadil ama paman ama kakek	1	
Gimana bronis dei kakek tak cansel ya nek kan ada banyak makanan gimna menurut nenek	1	
Gk kakek yg org alorr nikah sama nenek aku	1	
Gx pp kok kakek biar ngerasain gmana jadi nenek	1	
Hahaa biar aku jdi nenek asalkan kamu jdi kakek ny	1	
Hahah itu salh nenek kau barang nenek kau ndk bepelok dgn kakek ka	1	
Hahah itu salh nenek kau barang nenek kau ndk bepelok dgn kakek kau	1	
Hahaha ya ke kakek bru lusi ini nenek	1	
Hahahah engk yoo kakek beneran sayang ke nenek	1	
Hahahahaha njirrr udah di panggil kakek kakek nya geseng pula emng ngelunjak ini nenek nenek	1	
Hanya bukin kopi kakek sama bikin susu nenek  .	1	
Hehe iya itu fto tahun bang pas acara ulang tahun nenek alhmdllah d kluarga aku kalo nnek atau kakek ultah suka di rayain kluarga aja sih makan makan doang ibarat nya syukuran gtu lah bang	1	
Hhmm kmu enak masih punya kakek aku mah dari kecil gk pernah ngerasain kasih sayang seorang kake nenek dari ayah ataupun mamah aku	1	
Ia kek nenek juga ngirimim foto kakek	1	
Idiiiih kakek ini maluuu yo maluu tp tar mlh nenek yg malu	1	
Info aja ke nenek aku juga agak bingung karena besok aku ke Bandung jemput kakek	1	
Itu nenek aku yang lubis tapi kakek aku bukan org batak oca	1	
Itu pun kakek tu yang suruah imi pakai baju seragam lo kakek tu adiak laki nenek	1	
Iy ini mah nenek lgi cri pngnti s kakek y hlang hanyut d laut	1	
Iya dy blg ma nenek klo udh ijin kakek pdahal ga  .	1	
Iya kakek juga sayang sama nenek	1	
#kakak/adik,	kakak/adik
#raja,	ratu
Chanakya Ambil ini ini adalah undang undang yang harus diterima raja dan dikatakan bahwa jika dia terlalu banyak waktu dengan satu ratu dia kemudian harus pergi dan tinggal dengan ratu lainnya juga sama Chandra telah tinggal dengan nandini dan cinta mereka meningkat tapi sekarang dia akan tinggal bersamamu  .	12	
Chanakya memberikan sebuah dokumen kepada Helena dan mengatakan ini adalah undang undang yang harus diterima raja dan dikatakan bahwa jika dia terlalu banyak waktu dengansatu ratu dia kemudian harus pergi dan tinggal dengan ratu lainnya juga sama  .	7	
Chandra mengatakan acharya saya tidak memihak dan Helina memenangkan persaingan dan dia menikah dengan saya jadi mengapa masalah orang asing sekarang Chanakya mengatakan bahwa Chandrabukanlah masalahnya padmanand mencoba menyebarkanberita ini dan jawaban politisnya adalah Nandini Umumkan ratu yang berkuasa orang orang menyukaiNandini karena dia adalah putri magma di mana kamuadalah raja dan itu akan membantu kami  .	7	
Hhaha iya lah raja aku do'a in semoga kmu dpet ratu yang cantik luar dlam Yang pasti org yg mencintaimu dialah org yang rela menerima kmu apa adanya  .	7	
Jare ktka qt mmperlakukn suami spt raja mka qt akn d perlakukan spt ratu  .	3	
Kai jadi raja ny ak jadi ratu ny	3	
datanglah ratu dari tasikmadu yang meminta pertolongan kepada bratasena untuk emnyirnakan raja raksesa bernama kala dahana  .	3	
keren lagunya Tata janeta ft maia estiantiSANG PENGGODA Hey para ratu jaga baik baik raja hatimu	3	
Baiklah aku yg jadi raja tp kau harus jadi ratu di hatiku sebagai pemilik istana di hatiku ini	2	
Jangan sia siakan orang Yang sayang kepadamu walaupun dia tak secantik ratu dan tak setampan raja  .	2	
Jangan sia siakan org yg sayang kepadamu walaupun tak secantik ratu dan tak setampan raja tapi hatinya yang bisa menerima apa adanya	2	
Jdih ntuak ratu a nan k indakBia bg jdi raja e	2	
Kau bocil raja na sama anggi ratu na	2	
Ktka kamu mmperlkukanKu sprti raja maka aku akn mmperlakukanMu sprti seorng ratu	2	
Ktka kamu mmperlkukanKu sprti raja maka aku akn mmperlakukanMu sprti seorng ratu Dan jka kamu memperlkukanKu sprti mainan maka aku akn menunjukan cara mainnya	2	
Leonel Mesi Adalah raja sepak bola Dan kamu adalah ratu bagi hidupku	2	
Biasane raja seng cinta mati mbi ratu  .	1	
Cukup tuhan yesus aja lah yg disebut raja Tapi kalau kamu ratu tungkik	1	
Curut raja typo nah elu ratu typi	1	
Curut raja typo nah elu ratu typo	1	
Dan adek akan tetap jadi ratu abang tanpa si jamila dana abng akan tetap jadi raja tanpa iyan kasella  .	1	
Dan aku adalah ratu dalam kerajaanku tak kan kubiarkan seorang pun mencoba masuk untuk menggoda raja	1	
Dan aku adalah ratu dalam kerajaanku tak kan kubiarkan seorang pun mencoba masuk untuk menggoda raja ku dan	1	
Dan aku adalah ratu dalam kerajaanku tak kan kubiarkan seorang pun mencoba masuk untuk menggoda raja ku dan merebut tahta ku sebagai ratu	1	
Dan aku adalah ratu dalam kerajaanku tak kan kubiarkan seorang pun mencoba masuk untuk menggoda raja ku dan merebut tahta ku sebagai ratunya	1	
Dan anak nya pun tumbuh besar sedangkan raja lambat laun semakin tua karena hatinya berhasil diluluhkan oleh ratu es	1	
Dan ratu es pun meninggal kan raja selama lamanya  .	1	
Dg dua itu kan ratu dandut malut bukang raja dandut	1	
Ehem ehem ratu ny lgi nyari raja nih	1	
Ganti mi jadi raja ubi kah IrinErira sy kira ratu ubi  .	1	
Hahaha ratu si syg bukan raja	1	
Hahahahaha raja arif dan nyai ratu eli	1	
Heeh sia mah eyy raja lain atu ges puguh ratu namah didie	1	
Hidup sang ratu tidak akan sempurna jika tidak ada sang raja yang menemani hidupnya	1	
Hmmm mana mgkn sang ratu mau tanpa sang raja	1	
Ibarat raja tuh ada tuan ratu  .	1	
Ihaha mna ada prempuan raja yg ada itu queen ratu	1	
Ingin menjadi & menjadi princess lalu ratu dan ingin mempunyai cowok raja	1	
Ini mslah acata di ratu lumba sama acara raja semut jamnya bentrok	1	
Iy deh kalu raja ad die tk tau ratu ke	1	
Iya yg fira cocok ratu nya kalo aldo cocok jadi raja kera hahhahahaa	1	
Jangan sia siakan Org Yg Sayang kepadamu walaupun tak secantik ratu dan tak setampan raja	1	
Jangan sia siakan Org Yg Sayang kepadamu walaupun tak secantik ratu dan tak setampan raja tapi hatinya	1	
Jangan sia siakan Org Yg Sayang kepadamu walaupun tak secantik ratu dan tak setampan raja tapi hatinya yg	1	
Jangan sia siakan Org Yg Sayang kepadamu walaupun tak secantik ratu dan tak setampan raja tapi hatinya yg bisa menerima	1	
Jangan sia siakan Org Yg Sayang kepadamu walaupun tak secantik ratu dan tak setampan raja tapi hatinya yg bisa menerima apa adanya	1	
Jangan sia siakan Org Yg Sayang kepadamu walaupun tak secantik ratu dan tak setampan raja tapi hatinya yg bisa menerima apa adanya Pagee	1	
Jangan sia siakan Org Yg Sayang kepadamu walaupun tak secantik ratu dan tak setampan raja tapi hatinya yg bisa menerima apa adanya PageeBL OrgOrgBeruntungJhyYgDapat	1	
Jangan sia siakan orang yang sayang kepadamu walaupun tak secantik ratu fan tak setampan raja tapi HATINYA yang bisa menerimamu	1	
Jangan sia siakan org yg sayang kepadamu walaupun tak secantik ratu dan tak setampan raja	1	
#anak laki-laki,	anak perempuan
#ayah,	ibu
Meskipun sosok seorng ayah brda di bwah seorng ibu kita tdak boleh mmperlakukan ayah seenaknya  .	40	
Keutamaan seorang ibu dalam islam sangat lah istimewa dia didahulukan tiga kali sebelum ayah kita  .	17	
Ayah mengapa ibu menangis Ibumu menangis tanpa sebab yang jelas sang ayah menjawab  .	15	
hatusnya ayah bersyukur karna ayah tidak tau menau urusan memasak dan tidak pernah tau kerjaan rumah yg setiap hari ibu kerjakan sepanjang jam bersama anak ayah  .	12	
jangan abaikan hak spele yg slaku ibu ingatkan demi kebaikan ayah  .	12	
Tapi tiba ayah kikis kprcaan tu hingga sulit bwt ibu membangun nya kmbali  .	11	
prcaya bahwa ayah yg bs menemani suka dan duka ibu  .	11	
Ayah nyerah bkn brrti ayah mundur bu ayah nyrah g mau brntm lagi sm ibu	9	
Ayah tanya ibu apa mash nyaman sm ayah	9	
Bukan ibu j nnti yg ayah tingglin tpi klwrga ayah smua y pun ayah akan tingglin bu	9	
Dia adalah AYAH Kadang dalam sebuah keluarga kita sebagai anak selalu lebih dekat dengan ibu bahkan kakak atau adik dibanding ayah  .	9	
G ada maksd apa ibu sekira y ngmng sprt itu ayah brani sumpah slma di sni ayah g macem sdkitpun ibu g prcya pun gpp cuman allah yg maha melihat dan maha adil	9	
Ibu kpn ngsi ke ayah klw ayah udh g ada bu ibu bru ngsih	9	
Ibu mau apa dri ayah bu ayah g mau cuekin trs am ibu	9	
Klw memang ayah g ykin ayah g akan ngjkin ibu tunangan	9	
Klw sprti itu nnti ayah sllu curiga sm ibu	9	
Makanya ayah selalu menutupi aja gk mau jg terlalu di liat ibu  .	9	
Tpi ayah pun hrus tau ibu ttp akun itu ayah yg ttp akun fb itu trs ibu pke fb dlu	9	
Y nntk ayah yg ttp trs ibu pke fb dlu	9	
ayah akan ttp buktiin sm ibu	9	
ayah naik motor ni ama ibu  .	9	
tadi kata ayah seharusnya aku punya tiga ibu karena sekarang baru satu jadi masih kurang dua  .	9	
Ibu bilang rumah di BSI ibu mau kasi ke ayah  .	8	
Keingginan dedek bawakan nya rindu trus sm ayah nya Jgn slahkn ibu nyaSlh kn sidedek yah	8	
Saya sadar ayah saya hanya penggali kuburan dan ibu berjualan intip di pasar jadi tidak mau kasih tahu takut jadi beban pikiran cukup niat yang kuat dalam hati ujarnya Senin  .	8	
Taukah sebenarnya gimana ayah kita dibalik sikap tegasnya Saat kita main sampai larut ayahlah yang mnyuruh ibu menelpon kita  .	8	
jadi skr pun ibu tdk ingin membuat ayah teringat k masalampau  .	8	
Gini yah Jjur sebenarnya nda enak jg ibu mw ngmong nya sm ayah cma ya mw gmana  .	7	
Jam berapa ayah nyampek di kerjaan ibu sayang Ngomng dari sekarang ya bu  .	7	
Seorang gadis yang berusia th sudah di tinggal dengan keluarga nya ibu nya meninggal dunia dan ayah nya menikah lagi dengan seorang wanita yang tidak pernah menerima dalam hidupnya  .	7	
Terakhir kali ayah mohon dan ngemis sama bunda buat kedepan'a keluarga kecil nihh dan masa depan dee nanti semua keputusan ada di bunda ayah ngga bisa maksain dan maaf klo terakhir ada kabar karna ayah ganti hp dan no wa'a baru jdi klo mau ketemu dee berubah jdi ibu yng baik buat dee kedepan'a maaf udah bikin bunda jdi kaya gini	7	
Hangat Pelukan serta Kasih sayang dari ayah sama seperti kasih sayang ibu  .	6	
Kamu tau sayang seorang ibu tetap seorang ibu terlepas kamu menikah at/pun menjadi seorang ayah  .	6	
Karena ibu ga perna jahat ama ayah tp dy yg jahat sm ibu	6	
Sdh ayah baca semuannya jgn ibu yg mengejar ngejar Hal hal yg saya paling  .	6	
Ya sekarang ibu bergantung sekali sama ayah	6	
Yakin ayah buat jadi imam ibu	6	
Aaaa its so sad your story hurt me a lot Yaaa tau sih gimana rasanya kalo ibu sakit ibu aku kan juga sakit tapi beda nya ayah aku sehat jadi ga terlalu drop  .	5	
Dalam ayat di atas Allah mewajibkan seorang ayah untuk memberi upah kepada istrinya atas pemberian ASI air susu ibu kepada anaknya  .	5	
Di mana ada KK ah ayah mls minta nya sma si ibu yah	5	
Innalilahiwainailaihi rojiun selamat jalan ibu semoga ibu di tempat kan disisi allah aminn yang tabah ya akak dan ayah dan kita hanya bisa berserah diri dan mendoa kan ibu semua yang diciptakan yang maha kuasa akan berbalik ke dia	5	
Pacaran cuma main main Cuma ngarep Cipok Ngentot Mending out aja deh Punya hati kan Punya ibu kan Punya adek kan Punya ayah kan nah mikir Ganteng punya pacar cantik belum seberapa bro Percuma cantik kalo hatinya busuk Sekarang itu jaman nya mencari pasangan yang bisa dibawa susah senang Bisa jadi calon ibu yang bisa ngertiin posisi kita tidak egois terutama yang bisa nerima kita apa adanya Yang bisa nerima kelebihan dan kekurangan kita Apalagi kalo dapat pasangan yang bisa ngejaga dan ngerawat lo Bisa bikin lo nyaman  .	5	
Slmt tgl yang ke ayah syng Smga sllu samawa yah sayang sama ibu nya Ttp tersegalanya  .	5	
ayah blm tentu bisa jadi ibu tp klo ibu pasti bs jadi ayah  .	5	
Ayahhh ibu curhat sama ayahhh hanya ayah yg tahu	4	
Bu mohon ayah jngn lakukan ini k ibu  .	4	
Dapet kado dari si ayah Tahya Rosada di hari ibu  .	4	
Dia marah karena di anggota grup ada yg laporin ibu mesra mesra an ktanya sama ayah	4	
Emng yg adek kakakan sama pak kanzor itu ayah nya nix apa ibu nya nix	4	
Gk ada acara opo mek ceramah komandan nanti kayak e sama ibu e jg untung ayah piket aman gk melok ngerungokno ceramah	4	
#pangeran,	putri
ingin seperti Cinderella yg mungkin sering teraniaya tapi pada akhirnya bahagia karena Ada pangeran yg menjemput sang putri untuk di bawa ke istana kebahagian  .	5	
Jika ingin diperlakukan seperti sang pangeran maka perlakukan wanitamu seperti sang putri  .	4	
Mat bobok ya syngku moga pacarmu yang ganteng ini akan datang di mimpi indahmu bagaikan pangeran yang akan menemui sang putri miss  .	4	
Pangeran cintaDisuatu desa ada seorang putri yg sangat cantik dan seorang pangeran tetapi pangeran itu tak sekaya yg disebutkan dan dia hanya kaya akan cinta  .	3	
pada suatu hari mereka bertemu dibukit asmara tepat di bagian patung mereka saling menyukai hingga akhirnya salah satu dari mereka harus menerima nasibnya yg sangan pahit karena pangeran yg disukainya adalah kakaknya sendiri yg hilang tahun lalu sang putri berkata''kalau memang berakhir tak sempurna kenapa cinta harus ada lalu pangeran berkata walau tak sempurna kita masih bisa bersama dan mereka kini hidup bahagia  .	3	
Aku memang tidak sesempurna pangeran tapi percayalah bahagiamu lebih dari putri kerajaan	2	
Bersama putri tapi tak bersama pangeran	2	
Nurdina bilangi itu tadi malam ta pangeran kodok nda na aktif mi dulu putri malu pa maui pigi	2	
Ada putri duyung kira apakah juga ada pangeran duyung yah  .	1	
Ah lamun dirimu jadi putri akuna w jadi pangeran nyah	1	
Aku maunya putri si woo bukan pangeran	1	
Aku memang tidak sesempurna pangeran tapi percayalah padaku bahagia mu melebihi putri kerajaan	1	
Aku memang tidak sesempurna pangeran tapi percayalah padaku bahagia mu melebihi putri kerajaan NurulPaok	1	
Andai kau putri raja aku kan jadi sang pangeran	1	
Apapun keadaan putri dan keadaan kita pangeran ttp sayang sama putri	1	
Berharap dn berdoa pangeran slalu di dkat putri	1	
Buat apa putri mahkota dia kn sdh bahagia bersama pangeran	1	
Dan aku putri adalah putri ayahanda ku yang memilih kamu menjadi pangeran untukku	1	
Dudok disamping putri satu hari aja terus punya pangeran kecil	1	
Ehh mau mulai berusaha tpi sang putri dah dijodoh in sma pangeran  .	1	
Emnk putri gk ap tp itu berat biar pangeran aj yg kangen am putri hihiihihi	1	
Ga ko siapa yang berlebihan berlebihan itu kan gabaik perempuan itukan emng tuan putri emng nya mau di bilang pangeran	1	
Gk dh amana oto apa lgi pangeran yg mau ngelamar putri itu otoan dia pas bacaib puisi yg pertama main	1	
Iji engko jd putri tidr bngun msih nubggu pangeran yg dtg	1	
Ingat itu Ajari dlu sih tuan putri caranya tata krama sma rakyat jgn kerjaannya hanya lihat pangeran sampai mahkota nya hilang ga tau kemana	1	
Isinya kamu jadi putri di khayangan dan datang seorang pangeran	1	
Itu gosenya putri yg pesan ap ud di pesan pangeran	1	
Itu pupuk putri ad j lh pacar pangeran ni  .	1	
Jadi intinya pangeran gak bisa ya ama putri	1	
Jadi pangeran harus gimana biar putri gak kecewa lagi putri	1	
Jangan di mimpiin pangeran mah pangeran aja gak mimpiin putri bidadari nya	1	
Jka kmu bersedia jdi putri khu maka aku bersedia menjadi pangeran mhu	1	
Kalau putri salju malah dakbangun nunggu pangeran dulu datang	1	
Kan suatu masa depan yg cerah dan cantik yg dipenuhi kupu kupu berkilauan hiduplah seorang putri Princess bernama IGES lalu ia bertemu dgn seorang pangeran tampan Lalu hidup bahagiaaaa selamanya  .	1	
Klinik putri salju sayang kan dia tidak bangun kalo tidak di cium pangeran	1	
Klo tuan putri itu biasany jadi anak ny sang raja yah pangeran kodok	1	
Kok pangeran kecil sich Bukannya putri kecil	1	
Kwkw pangeran buruk rupa ada si beast namanya klo putri mana ada	1	
Lalu putri bertanya kepada sang pangeran	1	
Mau la putri dipilihin lipstik sma pangeran  .	1	
Memang lama dp nama pangeran inn baru dp putri sama dng ana rambu pendek omg	1	
Mending lupakan mi pangeran ta yg slalu buat masalah d khidupanta tuan putri	1	
Mngkin pangeran a lagi berburu rusa untuk tuan putri  .	1	
Namun semua pangeran yang melamarnya tersebut gagal untuk mendapatkan hati sang putri tersebut  .	1	
Nanti juga ada yg putri cantik yg bersanding di sebelah seorang pangeran	1	
Ngak harus pangeran duluan lah chat putri pun bisa chat duluan hehe	1	
Ntr mlm sblm tidur dn sesudah baca doa sebut nama putri x ntr putri dtg ke mimpi pangeran truss kita ambil jatah deh	1	
Ntr siap di ambil esnya putri mau bobok lah pangeran	1	
Nurbaiti Iim ehhhh iim aku gak suka foto yg kamu ultah apa an kok yg ada kami nya gak dimasukin biar apa gt cuma mereka aja yg dimasukin ngerasa putri yg di kelilingi pangeran	1	
Nurdina Panggoai kaleng indo'o dibengi ta pangeran kodok nda bisa dulu diganggu putri malu di	1	
#laki-laki,	perempuan
#keponakan,	keponakan
#kakak/adik tiri,	kakak/adik tiri
#dia,	dia
#ayah,	ibu
Meskipun sosok seorng ayah brda di bwah seorng ibu kita tdak boleh mmperlakukan ayah seenaknya  .	40	
Keutamaan seorang ibu dalam islam sangat lah istimewa dia didahulukan tiga kali sebelum ayah kita  .	17	
Ayah mengapa ibu menangis Ibumu menangis tanpa sebab yang jelas sang ayah menjawab  .	15	
hatusnya ayah bersyukur karna ayah tidak tau menau urusan memasak dan tidak pernah tau kerjaan rumah yg setiap hari ibu kerjakan sepanjang jam bersama anak ayah  .	12	
jangan abaikan hak spele yg slaku ibu ingatkan demi kebaikan ayah  .	12	
Tapi tiba ayah kikis kprcaan tu hingga sulit bwt ibu membangun nya kmbali  .	11	
prcaya bahwa ayah yg bs menemani suka dan duka ibu  .	11	
Ayah nyerah bkn brrti ayah mundur bu ayah nyrah g mau brntm lagi sm ibu	9	
Ayah tanya ibu apa mash nyaman sm ayah	9	
Bukan ibu j nnti yg ayah tingglin tpi klwrga ayah smua y pun ayah akan tingglin bu	9	
Dia adalah AYAH Kadang dalam sebuah keluarga kita sebagai anak selalu lebih dekat dengan ibu bahkan kakak atau adik dibanding ayah  .	9	
G ada maksd apa ibu sekira y ngmng sprt itu ayah brani sumpah slma di sni ayah g macem sdkitpun ibu g prcya pun gpp cuman allah yg maha melihat dan maha adil	9	
Ibu kpn ngsi ke ayah klw ayah udh g ada bu ibu bru ngsih	9	
Ibu mau apa dri ayah bu ayah g mau cuekin trs am ibu	9	
Klw memang ayah g ykin ayah g akan ngjkin ibu tunangan	9	
Klw sprti itu nnti ayah sllu curiga sm ibu	9	
Makanya ayah selalu menutupi aja gk mau jg terlalu di liat ibu  .	9	
Tpi ayah pun hrus tau ibu ttp akun itu ayah yg ttp akun fb itu trs ibu pke fb dlu	9	
Y nntk ayah yg ttp trs ibu pke fb dlu	9	
ayah akan ttp buktiin sm ibu	9	
ayah naik motor ni ama ibu  .	9	
tadi kata ayah seharusnya aku punya tiga ibu karena sekarang baru satu jadi masih kurang dua  .	9	
Ibu bilang rumah di BSI ibu mau kasi ke ayah  .	8	
Keingginan dedek bawakan nya rindu trus sm ayah nya Jgn slahkn ibu nyaSlh kn sidedek yah	8	
Saya sadar ayah saya hanya penggali kuburan dan ibu berjualan intip di pasar jadi tidak mau kasih tahu takut jadi beban pikiran cukup niat yang kuat dalam hati ujarnya Senin  .	8	
Taukah sebenarnya gimana ayah kita dibalik sikap tegasnya Saat kita main sampai larut ayahlah yang mnyuruh ibu menelpon kita  .	8	
jadi skr pun ibu tdk ingin membuat ayah teringat k masalampau  .	8	
Gini yah Jjur sebenarnya nda enak jg ibu mw ngmong nya sm ayah cma ya mw gmana  .	7	
Jam berapa ayah nyampek di kerjaan ibu sayang Ngomng dari sekarang ya bu  .	7	
Seorang gadis yang berusia th sudah di tinggal dengan keluarga nya ibu nya meninggal dunia dan ayah nya menikah lagi dengan seorang wanita yang tidak pernah menerima dalam hidupnya  .	7	
Terakhir kali ayah mohon dan ngemis sama bunda buat kedepan'a keluarga kecil nihh dan masa depan dee nanti semua keputusan ada di bunda ayah ngga bisa maksain dan maaf klo terakhir ada kabar karna ayah ganti hp dan no wa'a baru jdi klo mau ketemu dee berubah jdi ibu yng baik buat dee kedepan'a maaf udah bikin bunda jdi kaya gini	7	
Hangat Pelukan serta Kasih sayang dari ayah sama seperti kasih sayang ibu  .	6	
Kamu tau sayang seorang ibu tetap seorang ibu terlepas kamu menikah at/pun menjadi seorang ayah  .	6	
Karena ibu ga perna jahat ama ayah tp dy yg jahat sm ibu	6	
Sdh ayah baca semuannya jgn ibu yg mengejar ngejar Hal hal yg saya paling  .	6	
Ya sekarang ibu bergantung sekali sama ayah	6	
Yakin ayah buat jadi imam ibu	6	
Aaaa its so sad your story hurt me a lot Yaaa tau sih gimana rasanya kalo ibu sakit ibu aku kan juga sakit tapi beda nya ayah aku sehat jadi ga terlalu drop  .	5	
Dalam ayat di atas Allah mewajibkan seorang ayah untuk memberi upah kepada istrinya atas pemberian ASI air susu ibu kepada anaknya  .	5	
Di mana ada KK ah ayah mls minta nya sma si ibu yah	5	
Innalilahiwainailaihi rojiun selamat jalan ibu semoga ibu di tempat kan disisi allah aminn yang tabah ya akak dan ayah dan kita hanya bisa berserah diri dan mendoa kan ibu semua yang diciptakan yang maha kuasa akan berbalik ke dia	5	
Pacaran cuma main main Cuma ngarep Cipok Ngentot Mending out aja deh Punya hati kan Punya ibu kan Punya adek kan Punya ayah kan nah mikir Ganteng punya pacar cantik belum seberapa bro Percuma cantik kalo hatinya busuk Sekarang itu jaman nya mencari pasangan yang bisa dibawa susah senang Bisa jadi calon ibu yang bisa ngertiin posisi kita tidak egois terutama yang bisa nerima kita apa adanya Yang bisa nerima kelebihan dan kekurangan kita Apalagi kalo dapat pasangan yang bisa ngejaga dan ngerawat lo Bisa bikin lo nyaman  .	5	
Slmt tgl yang ke ayah syng Smga sllu samawa yah sayang sama ibu nya Ttp tersegalanya  .	5	
ayah blm tentu bisa jadi ibu tp klo ibu pasti bs jadi ayah  .	5	
Ayahhh ibu curhat sama ayahhh hanya ayah yg tahu	4	
Bu mohon ayah jngn lakukan ini k ibu  .	4	
Dapet kado dari si ayah Tahya Rosada di hari ibu  .	4	
Dia marah karena di anggota grup ada yg laporin ibu mesra mesra an ktanya sama ayah	4	
Emng yg adek kakakan sama pak kanzor itu ayah nya nix apa ibu nya nix	4	
Gk ada acara opo mek ceramah komandan nanti kayak e sama ibu e jg untung ayah piket aman gk melok ngerungokno ceramah	4	
#paman,	bibi
Engga sayang da mamang bibi a nde pacarnya anggota paman sama siapa yh da dari partai tmnnya a nde terus yg orang mancagahar	2	
Engga sayang da mamang bibi a nde pacarnya anggota paman sama siapa yh da dari partai tmnnya a nde terus yg orang pmpk	2	
Lamin q angan foto sak sate qu olak bapak lo jakarta antat bibi abo tapi i senaket qu ke paman malik nongka jar	2	
Aqw ngrasa lebih tenang yank d bandingin d rumah bapa mendingan d rumah bibi di sini pada bisa ngertiin aqw sebagai anak laki dan paman pun mewajari gmna seorang laki	1	
Bilang bibi ku nnti bibiku mw bersih jga nnti malam bibiku disana ada paman ku juga  .	1	
Engga sayang da mamang bibi a nde pacarnya anggota paman sama siapa yh da dari partai tmnnya a nde terus yg orang mancagahar anak kecil ikit gera da anaknya anggota paman aku ayang dibawa	1	
Engga sayang da mamang bibi a nde pacarnya anggota paman sama siapa yh da dari partai tmnnya a nde terus yg orang mancagahar anak kecil ikit gera da anaknya anggota paman aku ayang dibawa d iya ayang mudah n gpp	1	
Itu no nya bibi fiska dimasukan juga paman	1	
Kemarin sy bertemu dg IMA dan Taufik dan hasil kesepakatan kita diantaranya adalah saat mereka jadi bibi harus jadi kepala dinas dan paman diamankan untuk maju dan lolos sebagai anggota DPRD  .	1	
Kl menurutku paman iku kerja di abah dl aja kaya bibi soleha itu yank  .	1	
Koe sih kadang ya kbr kbr bibi mu barang karo sepupu paman emang dia mau tau kbr kmu	1	
Lamin q angan foto sak sate qu olak bapak lo jakarta antat bibi abo tapi i senaket qu ke paman malik nongka jari qu berolahraga	1	
Low sni paman tu adik laki dr ibu low perempuan bibi	1	
Makasih bibi Nadila Queen dg paman sahril itu kadow	1	
Mas besok li bibi mau bikin kejutan ke paman anu enefeseri dede kpn di kasih kejutan	1	
Mau ngasuh dede bayi dulu bibi eka mau berobat sama paman eka	1	
Nanti saya minta di paman dulaLaman dula dnt bibi hari bnyak sendal di stanya	1	
Pasti bisa krna paman org sabar jd bibi harus sabar  .	1	
Semoga cepat sembuh n d'angkat penyakitx paman daeng anpa n bibi ati	1	
Semoga cepat sembuh n d'angkat penyakitx paman daeng anpa n bibi ati jga	1	
Skrng lagi paman aku baru datang dan bibi aku bibi aku tanya mama aku akuang udah dapat yang baru kah Mama bilang udah dag bibi aku tanya baik gak orang nya dan bagus gak Mama aku bilang bagus orang nya baik lagi Gak kayak yang dulu	1	
Sya ada si paman tau semamung selaki bibi saya	1	
Tadi sy bragkat kerja paman sama kak Mus di rumh bibi	1	
Tapi bibi Jgn kasih tau paman yah	1	
Tdk bibi aku tlfon penginapan liat paman kerja	1	
Waalaikumsalam nntlah paman bilang die paman sekeluarge mau ke rumah bibi tante kau	1	
Ya bibi aku anak nya paman aku	1	
Yang maaf ya sama kencan kita besok nih barusan aku di kabarin sma bibi aku kata nya paman aku meninggal trus aku di jemput dech sama bibi aku buat tahlilan maaf banget nich ya sayang jangan sedih ya aku mau kesono dulu	1	
knapa eko saat dekat dgn bibik lagi sama paman dak mau blg bibi kontak bibik	1	
mani kal ke umah paman gen mlli pas bibi teke	1	
moga bibi cepat atap sm paman awal ew	1	
pas d rumah bibi nyh mmh nya juga ngomong sama paman nya	1	
tpi kalo aku mau ikut sekarang aku mau mohon kesiapa bibi aku pergi nganterin anaknya si abang pergi paman udh berangkat kerja	1	
#anak laki-laki,	anak perempuan
#polisi,	polwan
Lain pulisi ton polisi jang lalaku kl perempuan polwan	4	
Amin yaa allah Semoga cita cita abg tercapai ya kalau nia insyaallah pengen jadi polwan bang soalnya pakuwo nia polisi insyaallah dia bisa bantu nia masuk spn di padang  .	2	
Ada gosip baru nek dia pacaran sama polwan seng pernah didketin rifki polisi intel	1	
Akhirnya besoknya ajak gw ke kantor polisi eh sepupu gw udah bonyok digebukin polwan	1	
Aq tidak suka dengan polisi yg aq suka adalah polwan  .	1	
Biar jo klo dpa tilang di jalang kan bagus so ada polwan yg mo bantu kase keluar itu motor dri kantor polisi	1	
Bt blng kalau sekian bnyk orng polisi yg ada di polres cuma satu orng polwan sj berbuat adil par bt	1	
Dulu aku kan pernah digodain polisi yak trus aku disuruh jadi polwan trus ga jadi garagara aku oendek wkwkw	1	
Iya lah malu pnya cita jd polwan sama pnya cwo polisi ari masih ga patuh sama peraturan lalin mah	1	
Kalau polwan saya gak takut bro saya keluarga besar polisi	1	
Kita p nene tete papa om tante yg di luwuk sruh ba dftar TNI sma Polwan kita p om yg di palu kan polisi bru dy ada plng k luwuk dy dpat jata orang dy sruh maso polwan kita bru so tlfn kita p mama so blng ksna tpi kita p mama tdk mau	1	
enek seh memang enek tapi yo kui kabeh kudu ditelusuri kelakuane polisi ki roto yo ngnui pkoke nk polwan geleman dijak metu yo kui gk pantes diperthankan	1	
#lengkap,	sama sekali
xioami note x / gb blackmate lengkap no minus mulus no lecet sama sekali  .	21	
Xiaomi note x / gb blackmate lengkap no minus mulus no lecet sama sekali  .	4	
xioami note x / gb blackmate lengkap no minus mulus no lecet sama sekali	4	
xioami note x / gb blackmate lengkap no minus mulus no lecet sama sekali ajukan aja nambahnya  .	4	
xioami note x / gb blackmate lengkap no minus mulus no lecet sama sekali kali aja cocok  .	3	
ado tim utk berbagi tugas jadi tolong bagi Kawan yg data PSD blom ngirim sama sekali atau yg belom lengkap disegerakanlah  .	2	
nih xioami note x / gb blackmate lengkap no minus mulus no lecet sama sekali  .	2	
punya dana xioami note x / gb blackmate lengkap no minus mulus no lecet sama sekali  .	2	
xioami note x / gb blackmate lengkap no minus mulus no lecet sama sekali ajuin nya	2	
Inna lillahi wa inna ilaihi raji'un maaf der aku tak tau sama sekali klu bapak uda gak ada minta nama lengkap bapak dan bin nya bro	1	
Iya pemilih sing data ne lengkap sing laka perubahan sama sekali mlebune ndi	1	
Masss sangat minta maaf sayang atas pertanyaan mas tadi mas nyesal udah tanya kaya gtu mas gak akan ulangi lagi pertanyaaan macam itu kamu wanita yg sudah sangat sempurna buat mas semua sudah lengkap ada di kamu gimanapun kamu mas tetap terima kekurangan kamu sama sekali gak ada niatan mas buat pindah ke lain hati mas minta maaf kalau udah buat hati kamu sakit mas gak pernah bermaksud sampai seperti itu	1	
Minat chat aja gees masik lengkap masik mulus semulus paha raisa belom ada dipakek sama sekali tq	1	
Oh blum sama sekali buku nya blum lengkap tak sedap klu bwt dulu	1	
Selain tak pernah diimunisasi sama sekali orang yang tidak mendapatkan DPT secara lengkap juga berpotensi terserang difteri bahkan setelah dewasa  .	1	
Udah lah Kepala rontok keluar teros dan uang pun menipis sama sekali gak ada seribu pun lengkap sudah	1	
Xiaomi note x / gb blackmate lengkap no minus mulus no lecet sama sekali ajukan aja dlu nambah nya kali aja cocok	1	
Xiaomi note x / gb blackmate lengkap no minus mulus no lecet sama sekali mas  .	1	
ada nih spek gahar juga xioami note x / gb blackmate lengkap no minus mulus no lecet sama sekali	1	
berani brp ke xiaomi note x / gb blackmate lengkap no minus mulus no lecet sama sekali	1	
brp kalu dri xioami note x / gb blackmate lengkap no minus mulus no lecet sama sekali  .	1	
kali minat naik spek ke xioami note x / gb blackmate lengkap no minus mulus no lecet sama sekali  .	1	
kalu ke xioami note x / gb blackmate lengkap no minus mulus no lecet sama sekali	1	
kawan ado tim utk berbagi tugas jadi tolong bagi Kawan yg data PSD blom ngirim sama sekali atau yg belom lengkap disegerakanlah  .	1	
kita xioami note x / gb blackmate lengkap no minus mulus no lecet sama sekali  .	1	
nambah brp xioami note x / gb blackmate lengkap no minus mulus no lecet sama sekali  .	1	
nih kli minat naik spek ke xioami note x / gb blackmate lengkap no minus mulus no lecet sama sekali	1	
pengen tau xioami note x / gb blackmate lengkap no minus mulus no lecet sama sekali  .	1	
sma kita jg masih baru xiaomi note x / gb blackmate lengkap no minus mulus no lecet sama sekali	1	
test jg enaknya di apain ke xioami note x / gb blackmate lengkap no minus mulus no lecet sama sekali	1	
xioami note x / blackmate lengkap no minus mulus no lecet sama sekali  .	1	
xioami note x / gb blackmate lengkap no minus mulus no lecet sama sekali ajuin nambahnya	1	
xioami note x / gb blackmate lengkap no minus mulus no lecet sama sekali ajuin nya kli aja cocok	1	
xioami note x / gb blackmate lengkap no minus mulus no lecet sama sekali ajuin nya mas	1	
xioami note x / gb blackmate lengkap no minus mulus no lecet sama sekali ajukan brp kli aja cocok	1	
xioami note x / gb blackmate lengkap no minus mulus no lecet sama sekali ajukan nambah nya	1	
xioami note x / gb blackmate lengkap no minus mulus no lecet sama sekali ajukan nmbahnya kali aja cocok	1	
xioami note x / gb blackmate lengkap no minus mulus no lecet sama sekali ajukanlah nya brp brp nya kali aja cocok	1	
xioami note x / gb blackmate lengkap no minus mulus no lecet sama sekali juga sama sama msih bru  .	1	
xioami note x / gb blackmate lengkap no minus mulus no lecet sama sekali kali minat	1	
#beruntung,	beruntung
#cepat,	dengan cepat
Kemoterapi meracuni sel kanker yang bertumbuh cepat juga menghancurkan sel sel sehat yang tumbuh dengan cepat di sumsum tulang saluran pencernaan dll dan dapat menyebabkan kerusakan organ seperti hati ginjal jantung paru paru dan lain lain  .	3	
Bukankah sebaiknya cinta baru datang lebih cepat dan mengobati luka luka yang menyisakan pedih dengan cepat pula	2	
Karena di saat perut kosong otak akan cepat menyerap kandungan yang ada dalam osb dengan cepat  .	2	
LAPISAN PEMBALUT HIBIS Lapisan Kain kapas yang lembut dan halus dibuat khusus dengan dianyam sehingga mampu menyerap dengan cepat serta dapat menahan/ menjaga permukaan agar cepat kering  .	2	
Makanan dengan GI tinggi mengandung karbohidrat sederhana atau cepat yang memberikan peningkatan level gula darah yang cepat dan tinggi yang dengan cepat menurun lagi sehingga menimbulkan rasa rendah energi  .	2	
Aku ada baca biar cepat tdr kedip kan mata dengan cepat bbrp mnt  .	1	
Dalam biocel mengandung STEMCELL APPLE yang mampu meregenerasi sel kulit kita dengan cepat serta membuat kulit kita menjadi kenyal cerah pori pori kecil dan cepat mengeringkan jerawat yang basah  .	1	
Jika sistem imun tubuh kita lemah maka HPV ini akan cepat sekali menginfeksi sel dan bekerja dengan cepat menggandakan diri sebanyak banyaknya dan semakin banyak mengambil alih sel sel tubuh lainnya  .	1	
Krna pastinya kamu jga minta kepastia cepat sama hal nya anda minta uang member dengan cepat sebaliknya kami jga minta di proses cepat  .	1	
Maka kerjakanlah skripsimu dengan cepat supaya bisa ngadain acara resepsi lebih cepat juga  .	1	
Sampeyan menyatakan dengan cepat dqn mutuskan juga terlalu cepat	1	
Setiap orang sudah ada jatah gagal dalam hidup dan akan cepat saya habiskan jatah tersebut dengan cepat	1	
Sultra cepat pada orang yang tepa Aman masuk surga it semua bsa terjadi dengan cepat apa bila  .	1	
Yang cepat datang kadang cepat pergi yang takan pergi biasanya tak datang dengan cepat	1	
Yang cepat datang kadang cepat pergi yang takkan pergi biasanya tak datang dengan cepat  .	1	
naiki tangga dengan cepat sampai depan pintu tekan pw cepat pintu terbuka jiyeon ah berteriak masuk	1	
ya saya terpengaruh dalam hal teknologi karena pada dasarnya sekarang teknologi lebih bekembang dengan cepat dan pesat sehigga dapat memberikan dampat positif pagi penggunnya sehingga memudahkan penguna lebih cepat mendapat infosmasi dari media massa	1	
#jarang,	jarang
#luar biasa,	luar biasa
#mungkin,	mungkin
#sayangnya,	sayangnya
#senang,	senang
#kebanyakan,	kebanyakan
#untung saja,	untung saja
#bebas,	dengan bebas
Ciri ciri sabun black walet asli yang perlu anda ketahui Warna sabun Hitam Gelap dus / box dan isinya Black Walet tidak memiliki segel jadi bisa dibuka dengan bebas namun bau harum tetap tidak berubah walaupun terbuka ditempat ruangan bebas  .	12	
#aman,	dengan aman
Alhmdulillah paket fleksol theraskin pcs sudah sampai ke alamat reseller dengan aman Fleksol itu cairan penghilang flek super ampuh dan aman karna sudah BPOM	1	
Ini bagian dari komitment kepada sesama offroader kalau jalur yang siauguhkan harus dibuktikan bisa dilawati dengan aman kalau masih belum aman harus diperbaiki	1	
Mohon ijin melaporkan untuk penjagaan area QNB Darmo sampai saat ini masih terpantau aman kendaraan kantor terparkir dengan aman	1	
#cepat,	dengan cepat
Kemoterapi meracuni sel kanker yang bertumbuh cepat juga menghancurkan sel sel sehat yang tumbuh dengan cepat di sumsum tulang saluran pencernaan dll dan dapat menyebabkan kerusakan organ seperti hati ginjal jantung paru paru dan lain lain  .	3	
Bukankah sebaiknya cinta baru datang lebih cepat dan mengobati luka luka yang menyisakan pedih dengan cepat pula	2	
Karena di saat perut kosong otak akan cepat menyerap kandungan yang ada dalam osb dengan cepat  .	2	
LAPISAN PEMBALUT HIBIS Lapisan Kain kapas yang lembut dan halus dibuat khusus dengan dianyam sehingga mampu menyerap dengan cepat serta dapat menahan/ menjaga permukaan agar cepat kering  .	2	
Makanan dengan GI tinggi mengandung karbohidrat sederhana atau cepat yang memberikan peningkatan level gula darah yang cepat dan tinggi yang dengan cepat menurun lagi sehingga menimbulkan rasa rendah energi  .	2	
Aku ada baca biar cepat tdr kedip kan mata dengan cepat bbrp mnt  .	1	
Dalam biocel mengandung STEMCELL APPLE yang mampu meregenerasi sel kulit kita dengan cepat serta membuat kulit kita menjadi kenyal cerah pori pori kecil dan cepat mengeringkan jerawat yang basah  .	1	
Jika sistem imun tubuh kita lemah maka HPV ini akan cepat sekali menginfeksi sel dan bekerja dengan cepat menggandakan diri sebanyak banyaknya dan semakin banyak mengambil alih sel sel tubuh lainnya  .	1	
Krna pastinya kamu jga minta kepastia cepat sama hal nya anda minta uang member dengan cepat sebaliknya kami jga minta di proses cepat  .	1	
Maka kerjakanlah skripsimu dengan cepat supaya bisa ngadain acara resepsi lebih cepat juga  .	1	
Sampeyan menyatakan dengan cepat dqn mutuskan juga terlalu cepat	1	
Setiap orang sudah ada jatah gagal dalam hidup dan akan cepat saya habiskan jatah tersebut dengan cepat	1	
Sultra cepat pada orang yang tepa Aman masuk surga it semua bsa terjadi dengan cepat apa bila  .	1	
Yang cepat datang kadang cepat pergi yang takan pergi biasanya tak datang dengan cepat	1	
Yang cepat datang kadang cepat pergi yang takkan pergi biasanya tak datang dengan cepat  .	1	
naiki tangga dengan cepat sampai depan pintu tekan pw cepat pintu terbuka jiyeon ah berteriak masuk	1	
ya saya terpengaruh dalam hal teknologi karena pada dasarnya sekarang teknologi lebih bekembang dengan cepat dan pesat sehigga dapat memberikan dampat positif pagi penggunnya sehingga memudahkan penguna lebih cepat mendapat infosmasi dari media massa	1	
#tampaknya,	tampaknya
#efisien,	dengan efisien
#cepat,	dengan cepat
Kemoterapi meracuni sel kanker yang bertumbuh cepat juga menghancurkan sel sel sehat yang tumbuh dengan cepat di sumsum tulang saluran pencernaan dll dan dapat menyebabkan kerusakan organ seperti hati ginjal jantung paru paru dan lain lain  .	3	
Bukankah sebaiknya cinta baru datang lebih cepat dan mengobati luka luka yang menyisakan pedih dengan cepat pula	2	
Karena di saat perut kosong otak akan cepat menyerap kandungan yang ada dalam osb dengan cepat  .	2	
LAPISAN PEMBALUT HIBIS Lapisan Kain kapas yang lembut dan halus dibuat khusus dengan dianyam sehingga mampu menyerap dengan cepat serta dapat menahan/ menjaga permukaan agar cepat kering  .	2	
Makanan dengan GI tinggi mengandung karbohidrat sederhana atau cepat yang memberikan peningkatan level gula darah yang cepat dan tinggi yang dengan cepat menurun lagi sehingga menimbulkan rasa rendah energi  .	2	
Aku ada baca biar cepat tdr kedip kan mata dengan cepat bbrp mnt  .	1	
Dalam biocel mengandung STEMCELL APPLE yang mampu meregenerasi sel kulit kita dengan cepat serta membuat kulit kita menjadi kenyal cerah pori pori kecil dan cepat mengeringkan jerawat yang basah  .	1	
Jika sistem imun tubuh kita lemah maka HPV ini akan cepat sekali menginfeksi sel dan bekerja dengan cepat menggandakan diri sebanyak banyaknya dan semakin banyak mengambil alih sel sel tubuh lainnya  .	1	
Krna pastinya kamu jga minta kepastia cepat sama hal nya anda minta uang member dengan cepat sebaliknya kami jga minta di proses cepat  .	1	
Maka kerjakanlah skripsimu dengan cepat supaya bisa ngadain acara resepsi lebih cepat juga  .	1	
Sampeyan menyatakan dengan cepat dqn mutuskan juga terlalu cepat	1	
Setiap orang sudah ada jatah gagal dalam hidup dan akan cepat saya habiskan jatah tersebut dengan cepat	1	
Sultra cepat pada orang yang tepa Aman masuk surga it semua bsa terjadi dengan cepat apa bila  .	1	
Yang cepat datang kadang cepat pergi yang takan pergi biasanya tak datang dengan cepat	1	
Yang cepat datang kadang cepat pergi yang takkan pergi biasanya tak datang dengan cepat  .	1	
naiki tangga dengan cepat sampai depan pintu tekan pw cepat pintu terbuka jiyeon ah berteriak masuk	1	
ya saya terpengaruh dalam hal teknologi karena pada dasarnya sekarang teknologi lebih bekembang dengan cepat dan pesat sehigga dapat memberikan dampat positif pagi penggunnya sehingga memudahkan penguna lebih cepat mendapat infosmasi dari media massa	1	
#tepat,	dengan tepat
Kenapa jafra menyediakan Jenis Dynamics Advanced karna kebutuhan setiap orang berbeda beda bukan satu prodak untuk semua jenis ini yg sering banyak orang mengeluh karna pemakaian prodak yg tidak tepat dan benar Mulai sekarang mari benahi perawatan harimu dengan tepat jangan sampai salah ya Free konsultasi wa  .	4	
Lakukan apapun dengan tepat bukan hanya cepat keberhasilan tidak bisa d halangi jika yang kamu lakukan telah tepat  .	2	
Masyarakat pada umumnya belum mengetahui cara mencegah dan mengobati bisul dengan tepat karena keterbasan informasi dan kebiasaan turun temurun yang dianggap kurang tepat misalnya memecahkan secara langsung yang sebenarnya dapat menghasilkan infeksi lain  .	1	
Yg terbaik mungkin tidak datang dengan tepat tapi percayalah ia akan datang di waktu yg tepat	1	
#enggan,	enggan
#serius,	dengan serius
Aku serius mbak demi allah jalin hubungan dengan dia dengan serius	1	
Dan aku juga udah janji sama diriku dan allah untuk serius jalanin hubungan ini dengan serius yang	1	
Dia bertanya saya menjawap saya ketawa dia marah saya sakit perrut dia sakit hati saya mules dia mati Siapa yg bodoh menurut kalian terlalu serius dalam menghadapi masalah tida semua masalah harus dihadapi dengan serius nanti cepet mati lhoo buat dia yg jauh disana	1	
Kamu tau Kalo aku mau mutusin kamu Sekarang juga bisa yang Di pikir pikir mah aku dapet toket kamu Bibir kamu Kamu pegang kontol aku Aku pegang memek kamu dari luar Karna aku emang jalin hubungan ini dengan serius Dan aku udah berjanji Aku udah serius sama kamu aku udah nyaman sama  .	1	
Masik mau serius uda d hadapi cobaan yg berat emang ya setiap hal yg d lakukan dengan serius pasti ada aja cobaan ny Hehehe	1	
Orang enggak suka dengan serius tapi kalau udah serius jangan bercanda  .	1	
aku mmng gini orngnya suka buat orng ketawa krna aku suka ketawa buat yg lucu sering becanda motto nya becandalah dengan serius tp kdng lupa serius lah dengan yg lain  .	1	
situasi saat ini akan menjadi persoalan serius bila tidak disikapi dengan serius dan	1	
#tenang,	dengan tenang
Pikiran jadi lebih tenang & rilaks mampu menangani masalah yg dihadapi dengan tenang & tidak mudah marah tidur lebih nyenyak  .	10	
Istrinya duduk di hadapannya dengan tenang mendengar alasan perceraiannya mata istrinya pun terlihat tenang  .	6	
Hemmbb mawar akhu gk mw ngomong kasar lg akhu cpek akhu udh lmes baca chatmu nkok lmes war tape nkok la tenang onggu nkok bisa dengan tenang alepas aghi bkn war rahman lalkek se tpak war dia mmng mnnggu km dr dlu ptus ma akhu dia dlu waktu kta pcran kita putus dia mnta no mu heheh akhu bru tau rasax ketikung sahabat  .	2	
Masalah itu seperti air yg mengalir di sungai yang selalu penuh rintangan hadapin dengan tenang seperti air yang mengalir tenang hingga akhirnya sampai ke muara	2	
Hemmbb mawar akhu gk mw ngomong kasar lg akhu cpek akhu udh lmes baca chatmu nkok lmes war tape nkok la tenang onggu nkok bisa dengan tenang alepas aghi bkn war rahman lalkek se tpak war dia mmng mnnggu km dr dlu ptus ma akhu dia dlu waktu kta pcran kita putus dia mnta no mu heheh	1	
Kesalahan mey sampe abang kecewa bangty sama mey mey yg salah dan mey pngn lupain abang dengan tenang hati mey gak bisa tidur tenang hati dan fikiran terus gelisah	1	
Terkadang kita harus menjernihkan pikiran kita dengan tenang seperti air yg sejernih bergerak dgn tenang	1	
Terserah mnh rk ngomong naon tentang masa lalu urang urang teu paduli kunaon sebab urang moal kembali ka masa lalu urang urang harap mnh dewasalah ngahadapi masalah ieu Urang hayang masalah ieu selesai lah beh urang bisa ulangan dengan tenang teu mikiran masalah urang off oge bisa tenang mnh hyang kn ningali urang bahagia sok masalah ieu tong dk gede keun maafnya sayang urang ayna off selama ulangan berlangsung di Senin nepi ka kamis jumat oge aktif nepi minggu senin jng selasa urang off deui jaga diri mnh baik baik rikhaa sayang restu mwahh I love you	1	
Tumit menjadi licin & pecah pecah hilang wajah bertambah cerah dan bercahaya Haid menjadi teratur membersihkan dan mengharumkan vagina Tubuh menjadi lebih kuat terhadap berbagai macam penyakit Pikiran jadi lebih tenang & relaks mampu menangani masalah yg dihadapi dengan tenang & tidak mudah marah tidur lebih nyenyak Menghilangkan kesemutan Menjadikan berat badan anda idealLebih bertenaga lebih gesit dan badan terasa ringan Menyembuhkan sakit maag perut menjadi lega tidak lagi perih menghilangkan sembelit pembuangan kotoran berjalan lancer Menghilangkan rasa was was atau gelisah Petunjuk PenggunaanBerbentuk serbuk dalam sachet diminum x sehari dengan cara ditaruh di bawah lidah  .	1	
papa pikir waktu buat kita akan datang dengan tenang kalo saat ini kita tetap tenang mam  .	1	
tenang selagi di twank ada saya emvie bisa kerja dengan tenang  .	1	
#bahagia,	dengan bahagia
Bagi kalian yang pernak ke prank jenis kata mematikan maafkan mereka mulai lah hidup mu dengan bahagia dan doakan mereka yang menyakiti kalian bahagia	3	
Bagi kalian yang pernak ke prank jenis kata mematikan maafkan mereka mulai lah hidup mu dengan bahagia dan doakan mereka yang menyakiti kalian bahagia love you guys	2	
Inget yaa jngan sampe oranglain itu tau kalo kamu lagi kesusahan karna apa Gak sedikit dari mereka yg bahagia atas kesusahan mu dan merasa susah dengan bahagia mu So  .	2	
Bukan dengan bahagia kita bersyukur tapi dengan bersyukur kita bahagia	1	
Hiduplah dengan bahagia karena kita memang berhak bahagia  .	1	
Hiduplah dengan bahagia karena kita memang berhak untuk bahagia	1	
Hiduplah dengan bahagia karena kita memeng berhak untuk bahagia	1	
Inget yaa jngan sampe oranglain itu tau kalo kamu lagi kesusahan karna apa Gak sedikit dari mereka yg bahagia atas kesusahan mu dan merasa susah dengan bahagia mu	1	
Jika kita sebagai orang tua sudah memahami cara menjalani hidup dengan bahagia maka secara otomatis anak pun juga akan bahagia  .	1	
Senyumlah tinggalkan sedihmu bahagia lupakan takutmu sakit yg kamu rasakan tak setara dengan bahagia yg akan kamu dapatkan	1	
Tipe kebahagiaan orang lain berbeda dengan bahagia kita SO syukuri kita hari ini tanpa harus bahagia seperti mereka	1	
#biasanya,	biasanya
#marah,	dengan marah
Anak yang dibesarkan dengan marah maka jangan salahkan mereka jika besok lusa mereka marah dengan kita  .	2	
Banyak pressure disalurinnya ya dengan marah tapi karena mungkin ga mungkin marah ke semua orang jadinya marahnya ke orang yg dianggep deket  .	1	
Kalo nda ada maslah kapan dewasa masa kamu slsaikan masalah dengan marah baru desi berduka kmu marah lagi dia beban sudah itu de nnti dia bunuh diri de kami aja semalman jaga dia takut dia bunuh diri kasihan bha de	1	
Pernah dia photo ama cwek tu trus kulike dengan marah trus dchat nya aku kawan kerja ku nya tu jangan langsung marah ya tu kata nya ama ku	1	
Tapi kalo masalah ngatur memang iya aq gak suka cara kamu ngatur begitu sampe marah sekali dua kali marah gak masalah tapi setiap kali ngatur harus dengan marah aq gak suka	1	
terkadang elen pngn marah k rudi tpi elen gk mau ngototin hati elen dengan marah k dia	1	
#kadang,	kadang
#segera,	dengan segera
Assalamu'alaikum mohon untuk arisan yg belum bayar segera mentransfer ke elmita dengan segera hri ini saya tunggu smp jam siang  .	1	
Juli saat umat muslim sedang menjalankan rutinitas Mudik saya melihat berita di televisi bahwa ada seorang Dokter di Mataram yang meninggal Dunia akibat kelelahan lalu Sontak saya kaget dan segera ambil HP saya untuk memastikan kebenaran berita tersebut Dan apa yang menjadi kekhawatiran saya benar benar terjadi berita tersebut benar dan dengan segera saya mencari tiket penerbangan dari Surabaya menuju Mataram untuk segera bertemu dengan anggota keluarga nya  .	1	
Kemudian ia segera bergegas beranjak kembali pulang ke rumahnya dengan segera  .	1	
Semoga yg di grup kita ini bisa segera brngkat smua untuk menjemput ilmu di KDI jogja dan meraih sukses dengan segera  .	1	
#profesional,	dengan profesional
Tapi transaksional beda dengan profesional ya maksudnya jadilah engineer yang profesional dan juga manajemen yang profesional jadi sisi sama pro	2	
Tapi transaksional beda dengan profesional ya maksudnya jadilah engineer yang profesional dan juga manajemen yang profesional jadi sisi sama profesional	1	
#jelas,	jelas
#tiba-tiba,	tiba-tiba
#tipikal,	khas
#diam-diam,	diam-diam
#jarang,	jarang
#pelan-pelan,	pelan-pelan
#jelas,	tidak jelas
Tapi perlu diingat bahwa anda juga tidak boleh sembarangan memilih produk karena saat ini begitu banyak produk ilegal yanng tidak jelas kandungan yang terdapat didalamnya jadi pilihlah produk yang sudah jelas aman yaitu yang sudah memiliki ijin edar dari BPOM  .	4	
Hal yang sudah jelas dan pasti saja kadang berakhir menyakitkan Apalagi yang tidak jelas dan tidak pasti  .	3	
A tdk jelas kaya sya mtr pun tidak jelas	1	
Apabila mengadakan rapat harus jelas tujuan rapat tsb jngan sampai tidak jelas tujuan nya sekian terimakasih  .	1	
Apakah tidak jelas dengan penyampai'an ceramah bliau dengan sangat jelas ke shohihan nya  .	1	
Bukan saya tdk jelas dia ji yg tidak jelas	1	
Dari situ sudah jelas laki laki anda yg tidak jelas  .	1	
Enak ambek yg jelas be Abdoel Khatar Al Ghazali bersega kito kalau tidak jelas  .	1	
Hal yang sudah jelas dan pasti saja berakhir menyakitkan apalagi yang tidak jelas dan tidak pasti tinggalkanlah begegas ada banyak hal	1	
Hal yang sudah jelas dan pasti saja berakhir menyakitkan apalagi yang tidak jelas dan tidak pasti tinggalkanlah begegas ada banyak hal lebih penting yg harus segera di urus jangan habiskan waktu sia sia Selamat siang Semalat	1	
Hal yang sudah jelas dan pasti saja berakhir menyakitkan apalagi yang tidak jelas dan tidak pasti tinggalkanlah begegas ada banyak hal lebih penting yg harus segera di urus jangan habiskan waktu sia sia Selamat siang Semalat menunaikan sholat jum'at sobat ku	1	
Hal yang sudah jelas dan pasti saja berakhir menyakitkan apalagi yang tidak jelas dan tidak pasti tinggalkanlah begegas ada banyak hal lebih penting yg harus segera di urus jangan habiskan waktu sia sia Selamat siang Semalat menunaikan sholat jum'at sobat kuSalam Kompak BFFBuat paket Iksan Firianto	1	
Hal yang sudah jelas dan pasti saja berakhir menyakitkan apalagi yang tidak jelas dan tidak pasti tinggalkanlah begegas ada banyak hal lebih penting yg harus segera di urus jangan habu	1	
Hal yg sudah jelas dan pasti saja kadang berakhir menyakitkan Apalagi yg tidak jelas dan tidak pasti Bergegaslah  .	1	
Harus toh harus tidak jelas di dunia yg tak jelas krn banyak penipuan sepertinya anda tipe pernah ditipu lwt medsos	1	
Ingatan ku tentang seseorang itu tidak jelas sehingga aku tidak mampu mengingat dengan jelas siapa dia	1	
Jangan abaikan yang jelas karena engkau suka mengharapkan yang tidak jelas  .	1	
Kalau ada info yang jelas kasi tau nah soalnya tidak jelas kalau saya cari di YouTube	1	
Kalau menurut papa apa itu wakaf atau apapun namanya sebaiknya berhubungan langsung dengan penerimanya yg jelas ijab kabulnya tanpa dgn perantaraan yg kita sendiri tidak jelas seperti apa pelaksanaannya dit  .	1	
La itu harus diperjelas perjanjiannya solnya sejak awal perjanjian tidak jelas sama sekai makanya gak jelas semuanya  .	1	
Maling yang tidak jelas pelakunya pangsung dicari dan dipenjarakan lah itu yang sudah jelas pelakunya malah di santaikan  .	1	
Mas Agus tolong di tempel IK nya dan di panel juga di tempel keterangan yg jelas mcb/breaker unt apa di gudang hammermill baru juga tidak jelas mcb nya	1	
Picture sudah jelas tertera tulisan ijin sudah online tidak perlu ribet dan tanpa pungutan yang tidak jelas hahahahaa	1	
Saya memang tidak jelas jadi kehadiran kamu di hidup ku itu agar membuat hidup ku lebih jelas	1	
Saya tanya Bank apa nama asih apa yang jelas jangan seperti sms pembohong yang hanya kirim nomor rekening tidak jelas	1	
Saya tidak tau dan jelas apakah saya hsrus kasih uang saudara saya sama orang yang tidak jelas	1	
Terkadang yang tidak jelas itu bisa menjadi jelas	1	
Tidak perlu dijelaskan berulang ulang ya cukup informasi dan pengumuman saya waktu Lalu sdh cukup jelas jangan paksakan kehendak tidak jelas datang di kampus	1	
pak virgo monitorjadi gini pak hasil rapat musawarah kemarin kopdar para admin dan member mereka menuntut struktur organisasi kepengerusan dan anggota yang jelas dan bukan berarti struktur skrang tidak jelas cuma setidaknya mereka ingin diakuin klo mereka member resmi sebagai komunitas SFPPjadi saya mengajukan kepada ketua pak virgo klo mau gampang kontrol dan para member alangkah baiknya tahap pertama kita adakan nomer regist untuk member kita bagikan dari mulai dan untuk	1	
pak virgo monitorjadi gini pak hasil rapat musawarah kemarin kopdar para admin dan member mereka menuntut struktur organisasi kepengerusan dan anggota yang jelas dan bukan berarti struktur skrang tidak jelas cuma setidaknya mereka ingin diakuin klo mereka member resmi sebagai komunitas SFPPjadi saya mengajukan kepada ketua pak virgo klo mau gampang kontrol dan para member alangkah baiknya tahap pertama kita adakan nomer regist untuk member kita bagikan dari mulai s/d sekian dan untuk s/d itu untuk admin kepengurusan grupbagaimna pak virgo tangapan pak virgo atas usulan saya	1	
pak virgo monitorjadi gini pak hasil rapat musawarah kemarin kopdar para admin dan member mereka menuntut struktur organisasi kepengerusan dan anggota yang jelas dan bukan berarti struktur skrang tidak jelas cuma setidaknya mereka ingin diakuin klo mereka member resmi sebagai komunitas SFPPjadi saya mengajukan kepada ketua pak virgo klo mau gampang kontrol para anggota bahwa dia telah resmi sbagai anggota SFPP dan para member alangkah baiknya tahap pertama	1	
