#manis,	paling manis
makasih juga papa udh hadir di hdp mama smpe skrng masih ttp orang yang paling disayang sama mama lafyou to sayang suamiku yang paling nyebelin paling manis gula ge eleh manis na lah	3	
makasih juga papa udh hadir di hdp mama smpe skrng masih ttp orang yang paling disayang sama mama lafyou to sayang suamiku yang paling nyebelin paling manis gula ge eleh manis na lah terheuras kepala egois	3	
makasih juga papa udh hadir di hdp mama smpe skrng masih ttp orang yang paling disayang sama mama lafyou to sayang suamiku yang paling nyebelin paling manis gula ge eleh manis na lah terheuras kepala egois tp da nyaah	3	
makasih juga papa udh hadir di hdp mama smpe skrng masih ttp orang yang paling disayang sama mama lafyou to sayang suamiku yang paling nyebelin paling manis gula ge eleh manis na lah terheuras kepala egois tp da nyaah sama papa nyaah pisan	3	
Buah manis samasama manis untuk simanis yang paling manis	2	
Coklat berkata kepada wafer Kita ini mmg beruntung terlahir manis sehingga banyak org yg ska pada kita wafer mejawab Kamu sangka kita yg paling manis Tidak sadarkah kamu  .	2	
sangat manis buat simanis dri yg paling manis	2	
Aku aja banyak mkn manis ga papa biasa aja apa lagi ngeliat kamu yg paling manis gpp toh	1	
Ema dah paling manis gue mah gak mau manis takut sama semut lah	1	
Salam manis dr dinda mu yg paling manis yaa	1	
Sama kita juga paling manis apalagi kalau pake Jersey nya Real madrid ededeh manis ta luar biasa	1	
Siang sayank ku yang paling manis di siang yang terasa manis ini	1	
Wafer berkata pada coklat Qita ni sungguh manis khan Coklat menjawab U pikir qita yg paling manis apa	1	
Wafer berkata pada vanila Kita ini sungguh manis kan Vanila menjawab Kamu pikir kita yg paling manis apa Kamu liat dong orang yg baca	1	
Wafer berkata pada vanila Kita ini sungguh manis kan Vanila menjawab Kamu pikir kita yg paling manis apa Kamu liat dong orang yg baca chatting iniLebih Manis Liat  .	1	
Yg di tengah paling manis Hera tobu ma manis na	1	
Yg paling manis disitu maknek yg lain siso dari manis e	1	
#Thailand,	orang Thai
#India,	orang India
Favorit ku memang India tapi bukan berarti kelakuanku ky orang India	2	
#Portugal,	orang Portugis
#Belarus,	orang Belorussian
#Swedia,	orang Swedia
#Spanyol,	orang Spanyol
#Meksiko,	orang Meksiko
#Brazil,	orang Brazil
#China,	orang China
Berarti kalau penduduk yg padet berarti di China donk neng jangan jangan asal muasal nya dari orang China lagi	1	
#Peru,	orang Peru
#Argentina,	orang Argentina
#Korea,	orang Korea
Tu lh apaan cba salah Korea Emng dalam sejarah ada orang Korea menjajah Indonesia	1	
duh pcrnya gntng jga nong uuh psti lah kirain fto si aa orang Korea ya bkn si aa kan gntng mukanya kaya orng Korea idih gntng ktnya	1	
#Mesir,	orang Mesir
#Ukraina,	orang Ukraina
#Australia,	orang Australia
#Rusia,	orang Rusia
#Jepang,	orang Jepang
Ok Pak silakan piping inlet steam di connect saja kemudian kita lanjut final alignment hasilnya akan kita kirim ke Jepang utk evaluasi Flushingnya nanti bareng dengan orang Jepang nya saja  .	1	
Pasti orang Jepang lah karna kebangsaan Jepang yg dominan suka ikan	1	
#Kambodia,	orang Kambodia
#Yunani,	orang Yunani
Mora mengatakan kepada dadi ma mora adalah wakil Yunani yang ditangkapnya tidak dihibur oleh orang Yunani tapi saya dengan chandra dia tidak akan pernah mengambil keputusan yang salah  .	2	
Mora mengatakan kepada dadi ma mora adalah wakil Yunani yang ditangkapnya tidak dihibur oleh orang Yunani tapi saya dengan chandra dia tidak akan pernah	1	
#Belanda,	orang Belanda
Apakah Anda tahu isi dari perjanjian Kapitulasi Tuntang tersebut Adapun isi dari perjanjian Kapitulasi Tuntang adalah Belanda harus menyerahkan seluruh daerah jajahannya di Indonesia Tentara Belanda menjadi tawanan bangsa Inggris dan orang orang Belanda yang tinggal di Indonesia bisa menjadi pegawai Inggris  .	1	
#Inggris,	orang Inggris
Akukan orang Indonesia gk orang Inggris aku cinta Indonesia gk Inggris	1	
#Polandia,	orang Polandia
#Irlandia,	orang Irlandia
Tradisi ini berasal dari Irlandia dan dibawa oleh orang Irlandia yang beremigrasi ke Amerika Utara  .	1	
#Slovakia,	orang Slovakia
#Albania,	orang Albania
#Chile,	orang Chile
#Jerman,	orang Jerman
Masa orang Jerman Nda tau bahasa Jerman  .	1	
#Austria,	orang Austria
#Italia,	orang Italia
#Norwegia,	orang Norwegia
#Swiss,	orang Swiss
#Malta,	orang Malta
#Israel,	orang Israel
Jerusalem Merupakan Pusat Pemerintahan Israel Di bawah Kepemimpinan Raja DaudTertulis dalam kitab Raja raja bunyinya Dan Daud memerintah orang Israel selama empat puluh tahun di Hebron ia memerintah tujuh tahun dan di Yerusalem ia memerintah tiga puluh tiga tahun  .	3	
Tawarikh berbunyi Pada waktu itu Salomo menyuruh para tua tua Israel dan semua kepala suku para pemimpin puak orang Israel berkumpul di Yerusalem untuk mengangkut tabut perjanjian TUHAN dari kota Daud yaitu Sion  .	3	
Injil Matius Bahkan Alkitab mengisahkan Yesus hanya mau mendo akan orang orang Israel saja orang orang diluar Israel Yesus tidak mau mendo akan Aku berdoa untuk mereka  .	2	
Ternyata pernyataan Al Qur an tersebut didukung oleh kenyataan sejarah nabi Isa Alaihissalam Yesus yang hanya memiliki umat dari orang orang Israel saja pengikut Yesus tak ada satupun yang berasal dari orang orang non Israel  .	1	
#Moldova,	orang Moldova
#Kolombia,	orang Kolombia
#Bulgaria,	orang Bulgaria
#Makedonia,	orang Makedonia
#Kroasia,	orang Kroasia
#Denmark,	orang Denmark
#Islandia,	orang Islandia
#Perancis,	orang Perancis
#warna,	warna
#mimpi,	mimpi
#mangga,	mangga
#gajah,	gajah
#monyet,	monyet
#elang,	elang
#tangan,	tangan
#botol,	botol
#wanita,	wanita
#melon,	melon
#awan,	awan
#singa,	singa
#tikus,	tikus
#babi,	babi
#keledai,	keledai
#mesin,	mesin
#jalan,	jalan
#tikus,	tikus
#bawang,	bawang
#ular,	ular
#mobil,	mobil
#bangunan,	bangunan
#pria,	pria
#nanas,	nanas
#kucing,	kucing
#burung,	burung
#sapi,	sapi
#kambing,	kambing
#kuda,	kuda
#anak,	anak-anak
#komputer,	komputer
#dolar,	dolar
#pisang,	pisang
#tangan,	tangan
#anjing,	anjing
#pir,	pir
