#Tokyo,	Hapon
#Helsinki,	Finland
#Madrid,	Espanya
#Paris,	Pransya
#Havana,	Cuba
#Tehran,	Iran
#Cairo,	Ehipto
#Islamabad,	Pakistan
#Bern,	Suwisa
#Canberra,	Australya
#London,	Inglatera
#Berlin,	Alemanya
#Kabul,	Afghanistan
#Atenas,	Gresya
#Mosku ,	Rusya
#Estokolmo ,	Suwesya
#Ottawa,	Canada
#Roma,	Italya
madalang dito sa Roma kasi mababang lugar ito ng Italya  .	1	
#Hanoi,	Biyetnam 
#Beijing,	Tsina
#Bangkok,	Thailand
#Oslo,	Noruwega 
#Baghdad,	Iraq
#Funafuti,	Tuvalu
#Madrid,	Espanya
#Paris,	Pransya
#Nassau,	Bahamas
#Maputo,	Mozambique
#Tehran,	Iran
#Vientiane,	Laos
#Bamako,	Mali
#Ankara,	Turkiya 
#Vaduz,	Liechtenstein
#Asmara,	Eritrea
#Roseau,	Dominika
#Dushanbe,	Tajikistan
#Sofia,	Bulgarya
#Bukarest,	Rumanya
#Tunis,	Tunisia
#Lusaka,	Zambia
#Quito,	Ecuador
#Hartum,	Sudan
#Montevideo,	Uruguay
#Antananarivo,	Madagascar
#Kiev,	Ukranya
#Roma,	Italya
madalang dito sa Roma kasi mababang lugar ito ng Italya  .	1	
#Hanoi,	Biyetnam 
#Damasco,	Syria
#Oslo,	Noruwega 
#Vilnius,	Litwaniya
#Alher,	Alherya
#Taskent,	Uzbekistan
#Tokyo,	Hapon
#Helsinki,	Pinlandya
#Dublin,	Irlanda
#Kisinau,	Moldova
#Managua,	Nicaragua
#Paramaribo,	Surinam
#Biskek,	Kyrgyzstan
#Cairo,	Ehipto
#Aman,	Hordan
#Budapest,	Unggarya
#Doha,	Qatar
#Astana,	Kazakhstan
#Kabul,	Afghanistan
#Monrovia,	Liberya
#Dhaka,	Bangladesh
#Mogadiscio,	Somalya
#Bujumbura,	Burundi
#Valeta,	Malta
#Nouakchott,	Mauritanya
#Kingston,	Hamayka
#Beirut,	Lebanon
#Beijing,	Tsina
#Bangkok,	Thailand
#Harare,	Zimbabwe
#Maskate,	Oman
#Baghdad,	Iraq
#Conakry,	Ginea
#Tallin,	Estonya
#Georgetown,	Guyana
#Taipei,	Taiwan
#Rabat,	Morocco
#Yerevan,	Armenya
#Havana,	Cuba
#Timbu,	Bhutan
#Nuuk,	Greenland
#Baku,	Azerbaijan
#Kigali,	Rwanda
#Dakar,	Senegal
#Suva,	Fiji
#Belmopan,	Belize
#Banjul,	Gambiya
#Atenas,	Gresya
#Riga,	Latbiya
#Zagreb,	Kroasya
#Skopje,	Masedonya
#Ashgabat,	Turkmenistan
