#tapat,	sinungaling
Bhe good evez wag kang mag alala hndi ka niloko nang Bf tapat sya hndi sya nag sinungaling sayo nag chat kmi kasi na share lang nya nag yari sayo nag advace lang sa knya	1	
Naging tapat k nmn kaya sinabi ko din n my gf ako masama kung mag sinungaling p ako s panahon ngaun kalat ang mga manloloko kaya ayaw ko maging biktima	1	
Ok pag kasama ung lalaki call mo agad ako plz plzz mahal wag ka mg sinungaling sakin mas gusto ko ung tapat ka sakin	1	
Sorry Kung Hindi ako Ideal Boy mo hane maks Wala sakin Yung mga Gusto mo sa Lalaki wala sakin Yung Gusto mong ugali sa lalaki wala sakin Yung tapat na lalaki na gusto mo Sorry Kung napaka sinungaling ko at hindi nag sasabi sorry Kung hindi ako Yung ideal boy mo sorry	1	
Syempre nmn basta tapat ka po sakin hnd sinungaling	1	
Totoo yan ayaw na ayaw ko sa taong sinungaling at totoo yan tapat talaga ako	1	
Ung hindi sinungaling ang gisto ko ubg tapat at hindi sinsabi n mahal aq pinaparamdam	1	
basta tapat ka lang sakin ayaw ko ng sinungaling	1	
#marahil,	imposible
#nagpasya,	nag-aalinlangan
#maaari,	imposible
maaari aayaw ka pero imposible lage ayaw mo  .	1	
#maginhawa,	nakasasagabal
#responsable,	iresponsable
#masarap,	nakapipinsala
#masuwerte,	kapus-palad
#madali,	pinakamadali
#kakaiba,	pinakakakaiba
#malamig,	pinakamalamig
#matalim,	pinakamatalim
#mainit,	pinakamainit
At kapag mainit naman dyos me qatar din ang pinakamainit sa buong mundo huhuhuh	1	
#malakas,	pinakamalakas
Sobrang lakas daw nun , mas malakas pa daw yun sa pinakamalakas	1	
#kakaiba,	pinakakakaiba
#mababa,	pinakamababa
#malawak,	pinakamalawak
#maliit,	pinakamaliit
Basta maliit lng , ung pinakamaliit	1	
Sis mgkno maliit n macaroni spag ung pinakamaliit	1	
Wala pong nabibiling maliit na labis gown dito pinakamaliit na yung binili ko po noo	1	
at special ginamos bka meron dyan bili mo ako konte lng yong pinakamaliit lng na lagayan hanapan mo ako maliit na isda na bagoong isda	1	
#malamig,	pinakamalamig
#magaling,	pinakamagaling
Kami dalawa ni Ace kung sino pinakamagaling salin dalawa ako o siya pipili si mam ng magaling tapos sino magaling sa english siya yung makakasali	1	
#mainit,	pinakamainit
At kapag mainit naman dyos me qatar din ang pinakamainit sa buong mundo huhuhuh	1	
#mahaba,	pinakamahaba
#mahina,	pinakamahina
#simple,	pinakasimple
#matalino,	pinakamatalino
#mataas,	pinakamataas
Nung 2nd grading dapat pinakamataas na grade sa english c faye 95 tapos binabaan nila kac masyado daw mataas	1	
#matangkad,	pinakamatangkad
#masarap,	pinakamasarap
pigilan masarap kaya yun sa pkiramdam yun yung pinakamasarap yun lng kpg nasaktan kulang na l g magpakamatay sa saket	1	
sabi kc nila baby ko masarap daw ang sex un daw ang pinakamasarap sa lahat kaya ung iba ng rape nalang	1	
#bata,	pinakabata
#masama,	pinakamasama
Oo ako na ang masama ako na ang pinakamasama na kapatid pinakapangit pinaka bobo	1	
sinabi ko lang na masama ugali mo pero di ikaw pinakamasama tanga	1	
#mabilis,	pinakamabilis
#matanda,	pinakamatanda
#mabilis,	pinakamabilis
#maliwanag,	pinakamaliwanag
#malaki,	pinakamalaki
Madam mace ung sunod lng s malaki ung supot wla ng pinakamalaki	6	
Di pa kc sure kung may malaki kami kasi 4r lang ung pinakamalaki dito	2	
Bilhin mo yung pinakamalaki neh besssss mas masarap kapag malaki alam mo yan	1	
Dalawang malaki Mommy US in pinakamalaki	1	
tanchico kagabi naku pinapapalitan ng malaki yung upright freezer sabi check ko kung anong size ang pinakamalaki kasi yung luma nya daw 10cu  .	1	
#malaki,	pinakamalaki
Madam mace ung sunod lng s malaki ung supot wla ng pinakamalaki	6	
Di pa kc sure kung may malaki kami kasi 4r lang ung pinakamalaki dito	2	
Bilhin mo yung pinakamalaki neh besssss mas masarap kapag malaki alam mo yan	1	
Dalawang malaki Mommy US in pinakamalaki	1	
tanchico kagabi naku pinapapalitan ng malaki yung upright freezer sabi check ko kung anong size ang pinakamalaki kasi yung luma nya daw 10cu  .	1	
#mabagal,	pinakamabagal
#maikli,	pinakamaikli
#mabuti,	pinakamabuti
#madilim,	pinakamadilim
#masuwerte,	pinakamasuwerte
