#Sakramento,	California
#Portland,	Oregon
#Glendale,	California
Namalas ang hilig sa pagsayaw ng mga Filipino-American sa isinagawag concert ng Fil-Am Symphony Orchestra na ginanap sa Glendale Hilton sa Los Angeles , California kamakailan lamang  .	1	
#Jacksonville,	Plorida
#Shreveport,	Luwisiyana
#Lexington,	Kentucky
#Tulsa,	Oklahoma
#Glendale,	Arizona
#Tucson,	Arizona
@pilotjamesf It's Arizona , Sabino Canyon in Tucson	1	
Original K 64 slide Arizona ANG F-16C 85-1405 AZ , AATC , Tucson , 1998	1	
#Mesa,	Arizona
Baby Rocks Mesa near Kayenta , Arizona OC 2592x1936	1	
#Spokane,	Washington
#Memphis,	Tennessee
#Oxnard,	California
#Tacoma,	Washington
#Lubbock,	Texas
#Worcester,	Massachusetts
#Miami,	Plorida
#Cleveland,	Ohayo
#Scottsdale,	Arizona
#Louisville,	Kentaki
#Stockton,	California
#Detroit,	Misigan
#Phoenix,	Arizona
#Philadelphia,	Pensilbanya
#Huntsville,	Alabama
#Cincinnati,	Ohayo
#Honolulu,	Haway
#Nashville,	Tenesi
#Oakland,	California
#Houston,	Tehas
#Fremont,	California
#Orlando,	Plorida
#Arlington,	Tehas
#Omaha,	Nebraska
#Laredo,	Tehas
#Chicago,	Ilinoy
#Baltimore,	Maryland
#Anchorage,	Alaska
#Plano,	Tehas
#Modesto,	California
#Garland,	Tehas
#kanya,	kanya
#lalaki,	babae
Nung isang gabi nanood kami ng MANG KEPWENG tapos nung nandun na kami sa intense na part , yong titingnan na ni vhong yong sa pagitan ng hita niya sakto naman na pagkakita niya sa multo is yong kaibigan ko na lalaki ay ginulat ng kaibigan kong babae  .	48	
Ang pangarap naming mga babae yung ipapakilala kami ng mga lalaki sa kanilang mga barkada at lalo na sakanilang pamilya Feeling namin kami na yung pinaka maswerteng babae sa mundo  .	37	
Ginawa kayong mga lalaki para alagaan ang mga babae at yun dapat ang hindi niyo kinakalimutan  .	29	
Isang gabi , naglalakad ang isang lalaki sa may tulay nang may makita siyang babae na nasa gilid nito at nagtatangkang magpatiwakal  .	27	
Pag kinilig ang babae Tumitili Nanghahampas ng katabi Mag-iingay ng mag iingay Pag kinilig ang lalaki Pigil smile May tinatawag din sila mini heart attack  .	22	
Ako po ang panganay na anak at may dalawa akong kapatid , ung kasunod po ay lalaki at yung kasunod po ay babae  .	20	
Balang araw , may lalaki ding magsasabi na ako ang pinakamagandang babae sa mundo at kaya nya kong ipagmalaki kahit kanino  .	19	
Take Note Hindi lang lalaki ang nanloloko at hindi lang din babae ang nasasaktan  .	19	
Lalong lalo na kapag sinabi ng babae na Pare-pareho lang ang mga lalaki  .	17	
Binuksan ang pangatlong kuwarto isang matandang lalaki nakakadena habang bini-bj ng isang magandang babae  .	15	
A perfect relationship is compose of mapangasar na lalaki and pikon na babae  .	13	
Ang tunay na lalaki pinapaiyak ang mga babae sa salitang Will you Mary MAYWARD DeterminedToWin	13	
Kahit pa sobrang ganda ng isang babae kung basura naman ang ugali , magsasawa pa rin ang lalaki  .	11	
Wag nyo ding idahilan na sya ay babae , dahil kung sa ibang kandidato lamang mas lalaki ang katapangan at katarungan ni MDS/ Walang inuurungan/ walang kasinungalingan/ Walang pinoprotektahan SERBISYONG TOTOO lang  !	11	
Ang mga lalaki LIKAS NA MAPAGMAHAL- Oo sabihin na natin na ang daming babae ang umiiyak ngayon  .	10	
Ang mga lalaki MAGALING MAGTAGO- Magtago ng babae  ?	10	
Ang mga lalaki MOODY- Gaya din ng mga babae  .	10	
Minsan maski ang mga babae hindi nila alam kung mahal na ba talaga nila ang lalaki , dahil madalas iniisip nila mahal na nila pero ang totoo , iniisip lang nila yun kaya nabubulag sila sa katotohanang mahal nga nila ang lalaki  .	9	
Sa gusto pong tumulong sa Tatlong bata e contact nyo nlng po si Mam Ivy Cleope na adviser ng dalawang batang lalaki at naging adviser din nung batang babae  .	9	
Ang tunay na lalaki , kikilalanin muna at kakaibiganin ang babae bago ligawan  .	8	
Paano magmahal ang mga lalaki Hindi man ipakita sa inyong mga babae ang Full effort , Pero sa tahimik nilang pagkimkim ng sakit lalo na kapag nagseselos , sobrang sakit na  .	8	
Sa pangit naman , pangit siya kaya kunti lalapit sa kanya pero kung siya ang lalapit sa mga lalaki jusko mahiya ka , dito naman matetest ang isang lalaki kung totoo talaga siya sa pangit na babae , kasi kahit hndi sya pandisplay eh yung pangit pa din pinili niya , kasi panatag siya na siya lang magmamhal sayo , yung iyong iyo ka lang  .	8	
Ang tunay na lalaki , Hindi takot sa magulang ng babae  .	7	
Ang tunay na lalaki , hindi sumasabay sa galit ng isang babae  .	7	
A Sad Story May isang lalaki na mahal na mahal ang isang bulag na babae  .	6	
Ang Paghihiganti Isang gabi , naglalakad ang isang lalaki sa may tulay nang may makita siyang babae na nasa gilid nito at nagtatangkang magpatiwakal  .	6	
Ang mga lalaki ayaw sa PAKIPOT- Ayaw namin yung babae na sobra kung makapagisip kung ayaw ba kami o hindi  .	6	
Ang pinakamatindi Aanhin mo ang babae kung mukha namang lalaki  ?	6	
Bago umalis , nag-iwan ng mga kataga ang lalaki na ikinagulat ng babae  .	6	
Kaya mga lalaki , tandaan niyo na lang ang mga katagang ito Ang mga babae parang bulaklak  .	6	
Kayong mga babae , pwede kayong magpaligaw sa benteng lalaki  .	6	
Mga babae gusto ng ma-effort na lalaki  .	6	
Nagdonate ang lalaki ng dugo sa kanyang gf nang sila y magbreak , gusting bawiin ng lalaki ang dugo ibinato ng babae and napkin at sinabi Ayan  !	6	
Sa china po yan water splash festival yung mga kalalakihan po kase pinagtripan ung mga babae tinatanggalan nila ng damit at bra , buti nga po tinulungan siya nung lalaki para takpan  .	6	
Ung mga ng holdap sa may dala ng pera isa isa n po pinag hahanap ng mga nagpapakilalang mga pulis pero nga naka takip ang mukha mga 1 30pm ng tanghali at isang may lalaki 20years old at isang babae na kasama sa holdapan ang nagturo ngayon kung saan ang ibang mga kasamahan nila  .	6	
babae man at mga lalaki  .	6	
halimbawa , kapag nagaway kayo tapos walang ginawa yung lalaki para magkabati kayo , parang mawawalan ng gana yung babae , yung parang manlalamig ba  ?	6	
isang lalaki ang nanliligaw sa isang babae  .	6	
mistulang sandalyas ito ng babae pero kadalasang suot ng mga lalaki  .	6	
27 Ganoon din ang mga lalaki ; ayaw na nilang makipagtalik sa mga babae , at sa kanilang kapwa lalaki sila nahuhumaling  .	5	
Ang hindi lang alam ng mga babae , kapag may kausap na iba ang mga girlfriend nila , kahit ba babae din yon ay nagseselos rin ang mga lalaki  .	5	
Ang hindi lang alam ng mga babae , kapag may kausap na iba ang mga girlfriend nila , kahit ba babae din yun ay nagseselos rin ang mga lalaki  .	5	
Ang tunay na lalaki , hindi naghahanap ng comfort zone sa ibang babae  .	5	
Ang tunay na lalaki , pinapaiyak ang babae sa salitang WILL YOU MARRY ME , di sa salitang I WILL SET YOU FREE	5	
E maya maya hindi na yata nakatiis yung babae inilabas na yung suso at sinuso bigla nung lalaki  .	5	
Ewan ko pero may mga babae yung gusto yung ganitong klaseng lalaki  .	5	
Ganoon din ang mga lalaki ; ayaw na nilang makipagtalik sa mga babae , at sa kanilang kapwa lalaki sila nahuhumaling  .	5	
Ginawa tayong mga lalaki para alagaan ang mga babae at yun dapat ang hindi natin kinakalimutan  .	5	
Hindi lang lalaki ang manloloko at hindi lang babae ang nasasaktan  .	5	
Ipinagpalit ng mga babae ang natural na pakikipagrelasyon nila sa lalaki sa pamamagitan ng pakikipagrelasyon sa kapwa babae  .	5	
#asawa,	asawa
#lolo,	lola
Bata 1 Kasi narinig ko lola ko kagabi sabi sa lolo ko , Hon  !	4	
Kaya't miss na miss na ni lola maria and intimate relationship nila , hangang isang gabi , para mapansin sya ni lolo hugo ay naghubad si lola maria sa kanilang kwarto aakitin nya si lolo  .	4	
Masyado na pong mahina ang lola namin para alagaan ang lolo po namin mag isa  .	4	
Pagpasok ni lolo at napatingin kay lola  .	4	
Kanina noong nakaupo ako sa upuan at echahcharge ko ang cellphone ko narinig ko si lolo may sinasabi kang lola  .	3	
Kaya naging close ako sa lolo , lalo na sa lola ko  .	3	
kasi si lola may tamang sweldo , si lolo naman ay matagumpay sa pagsasaka niya ng mais , minsan din ng niyog , meron din siyang palayan , maraming baboy , kambing at baka  .	3	
Alam nyo ba yung lolo ko araw-araw dinadala sa sinehan ang lola ko  !	2	
Bossing Pare alam mo ba yung lolo ko napakasweet sa lola ko , akalain mo simula nung ikasal sila , 4 times a year nyang dinadala sa parlor ang lola ko para magpaayos  !	2	
Joey Wala yan pare , kasi yung lolo ko monthly kung dalhin ang lola ko sa parlor  !	2	
Kaya , kapag naglalaro ang bata sa labas , at napapagawi sa bandang likuran ng bahay nakikita niyang nakatingin ang kanyang mahal na lola sa kanya na nasa dampa , at tinatawag siya nito , ngunit hindi siya lumalapit dahil sa bilin ng kanyang ama , kaya kumakaway na lamang siya sa kanyang lolo Iska , at napapansin niyang umiiyak na lang ang kanyang mahal na lola Iska na nag-aalaga sa kanya noon  .	2	
LOLA Apo , sabihin mo sa lolo , pahilot si lola at antok na antok na  .	2	
Yung tito ko nmatay xia s skit n dystonia namana nya s lolo nila carier yung lola ko n nanay nla ngaun nman yung anak ng kapatid ng lola ko n tito ko n din tinamaan n din ng dystonia  .	2	
hati sila sa food pero si lola lang ang kumakain , nanonood lang si lolo  .	2	
huminto sandali si lola Basyang para magpahid ng luha buhay pa sana si lolo inggo nyo kundi dumaan yung nagtitinda ng sorbetes  !	2	
lolo sabhin mo sa lola m wla aq sa mood tlog na  !	2	
nung namatay lolo ko di na nakakain lola ko kahiga nalang sya hanggang sa araw na libing ng lolo ko nang umagang yun namatay narin lola ko bago pa ilibing lolo ko huhu	2	
pagkaupo , hinati ni lolo ang burger , ibinigay kay lola  .	2	
sumulat po ako sa inyo dahil gusto ko pong makatulong sa aking lola Irene Ferrer at lolo Benjamin Ferrer Senior kahit sa pamamagitan ng pagsulat sa inyo  .	2	
28 lola ko tapos 25 lolo ko nung nagsama sil	1	
5 na ginawa ang face 2face kc ang rami ko po talagang natutunan lalo n poh ang tita , lolo , mama , at lola kuh sabay namin itong pinapamood maraming aral laming napupulot	1	
57 years of marriage pero si lola tawang tawa as in naiiyak level pa rin sa jokes ni lolo  ?	1	
@ALDUBLOLANIDORA lola c yaya pak n lang kunin m masaya cyang ksama pls lolo tinidora /nidora	1	
@LoloBabesHD @majjo0123 @IdioJacqueline si lola tidora alaga nya si lolo tom at ng magkaanak si tatay garfield at si nanay hello kitty 1 aq	1	
@LoloBabesHD @naliza01212 lola oh hinaharana ka ni lolo eihhhh pinapakilig mu c lola ha	1	
@RFAULKERSoN Daddy bae , nagkaroon na po ba ng ganitong meet &amp ; greet with you , his lolo &amp ; his lola  ?	1	
@RysherC hahaha aw oo btaw nkalimot ko SORRY NAGD hahahaha doh kung naa tay lolo tae , kinsa puy lola  ?	1	
@ShernieME @Prinsenggg uwe nakayo namatay si lolo dalhin nyo yung charger ni lola tas pati yung sapatos ko ne thank you	1	
@aleckziii or di kaya mangayo na lang ko kanday mama , lola , daddy , lolo but weakness ko mangayo kwarta  .	1	
@iamronaG07 hi lolo hello kitty lang po para kay lola masaya na yan HAHAHAHA	1	
@kathrengford paker kung maka lola ka eca ah pinaninindigan talaga haha conyo ka pa leche your lolo danilo will be the one to sundo you dyan	1	
@nayeontrbl ang ganda naman ng lola ko teka oo nga lolo ko nga pala si aura  !	1	
@noellegiman Sorry lola ako daw mahal ni lolo HAHAHAHHAAH	1	
@ray gargoles dahil sa isang concern cetizen inapload sa fb ung pic ni lola na naghahanap sa knyang asawa marami nakapansin at nakilala c lolo kaya NATAGPUAN NA PO nI LOLA C LOLO  .	1	
@zckej @pokieeify @joyllove @wolffia Queen of Cannes tawag ng iba kay lola ah hahaha yung kay lolo ngayon ko lang narinig hahahaha	1	
Aba , may kasamang lolo ni alden si lola baba  .	1	
Ako pud siya tambagan if ever naa na siyay mga problema sa balay or family like katong namatay iya lola late September as well as katong nag-away silas iya lolo  .	1	
Anak din ng haciendero si lola Maritess at sa ugali ni lolo Andres na walang pinipiling tao basta mahal lang anak niya kaya sila nakasal at nagsimulang magtayo ng negosyo sa pilipinas at ngayon na ang negosyong dinadala ni mommy  .	1	
Ang Saya Saya namin dati kaming lahat kasama ang Lolo at Lola ko at isa pang lolo na bading kapatid ng lola ko , limang anak nila kasama si papa nakabukod dahil sa nagasawa at naiwan ako at walo kaming magpipinsan magkkasama sa iisang bahay , yung halos hindi kami mag hiwahiwalay pag naapi yung isa sugod lahat , pag may party party walang maiiwan , mahilig dn kaming mag party party minsan kahit walang okasyon basta magkakasama kami ok na  .	1	
Ang galing pala sumayaw ng mga bangkay kuwando 2x ni lolo tinidora love u poh galing nyo poh mga lola hataw at galaw talaga	1	
Ang kyut talaga ng mga lola't lolo na ganyannn 3 kinakausap ko rin yang mga cute na lola kahit di ko kilala haha	1	
Ang mga taohan puro patay unahin kay carmen pinatay kc my problema sa mata kailangan mag pahinga tpos si glenn nagpaalam kc ang nanay my sakit sa puso nawala din tpos ngayon c benny kc my sakit daw sa susunod cnu nman ang mawala si ate yolly tpos c elmo tpos c lola flora tpos c lolo delfin tpos c billy tpos c jerome tpos c choy eh d wow tpos na kc naubos ang characters THE END	1	
Ang sweeet Ngayon 20 yrs mahigit na sila nagsasama , sabi pa ni lola kung nagkaroon daw sila anak gusto nya katulad ni lolo  .	1	
Anq payat pala ni mr , marcelo ala dinq ilonq umppp tiga tangos kdin mr marcelo , hehehe joke sna nqa laht nq pag luha ko at pag hihirap na dka mkita at mksama sna maramdman mo , kht sa hangin lng mis na mis na kita , gno pa ba ktgal 10 years paba ko mag hihintay baybie bka 15 years pa oi lola nko nun 38 nko nun 47 ka na nun lolo kna	1	
Anu ba yan mamatay n si alyanna kc papasok na sa pbb tpos alis na rin c hugot queen punta kunwari sa dubai sa nanay nya tpos nsa loob pla ng bahay ni kuya at kunwari nag aaral c jp sa japan un pla nsa kapit bhay ni kuya tpos mamatay c lolo delpine tpos mabaril si lola flora tpos mamatay nman si yolly tpos ung asawa nya papatayin din ni jaquin tpos sasalihin ni mak mak si mak mak ang patay kc bz na sa your face sounds familiar  ?	1	
Apo bakit po yoya lola Lola Puntahan mo ang lolo mo at sabihin mo na hilutin ang likod ko  .	1	
Apo opo yoya pumunta na ang apo sa lolo niya Apo yoyo lolo iyutin mo daw si yoya patayikod Lolo ayoko nga , sabihin mo sa lola mo na wala ako sa mood  .	1	
At nagtataka ako kung bakit si lolo lang ang kumakain at hindi si lola  .	1	
Awa ng diyos ung lola ko n my nunal s daluyan ng luha mas nauna pang mamatay s lolo ko  .	1	
BATA lolo , binayara mo na ako LOLO galing sa lola mo yan	1	
#nobyo,	nobya
Ang mga lalaki nga biskan my nobya na ma biga gyapon sa iban kag dira pa sa babaye nga my nobyo na  .	2	
Guys si Anne Marie Quinn nobya ni sa sang kawatan nga napatay gna depensahan ya gid iya nobyo sa comment kasabwat ni sa guro sa mudos ka nobyo ya te kamu nani bahala sa iya tani madakpan man ni sa parehos sang migo ya nga kawatan	1	
Hindi alam ni Glenda ang bagay na iyon at ang alam lang ay walang nobya ang lalaki na kanyang nobyo sa palasyo  .	1	
Kwento ng isang nobya na nakaranas ng pangha-harass sa kamay ng kaniyang nobyo ang hatid ng Papa Jack's mamayang ala-una ng hapon kasama sina Kristine Dera at Tanya Chinita  .	1	
Sa mga nobya ukon asawa tuon kmu mgdala ka motor para kn hubog bana nyo ukon nobyo kmu dala motor  .	1	
Tinakbuhan ako makaraan ng isang oras na paghihintay galit na galit ang nobya at bumalik na ang nobyo at tinanung na  .	1	
at baka naguguluhan lamang ang ito ngunit di pumayag ang nobyo nya na makipagbalikan dahil sa ayaw nyang masaktan ang nobya  .	1	
ikalawang araw n pasko lalasunin q nobyo q kc my nobya n dw xang iba  .	1	
todays later c labada galit na galit kc gnamit nobya un tapal ni nobyo  .	1	
#lolo,	lola
Bata 1 Kasi narinig ko lola ko kagabi sabi sa lolo ko , Hon  !	4	
Kaya't miss na miss na ni lola maria and intimate relationship nila , hangang isang gabi , para mapansin sya ni lolo hugo ay naghubad si lola maria sa kanilang kwarto aakitin nya si lolo  .	4	
Masyado na pong mahina ang lola namin para alagaan ang lolo po namin mag isa  .	4	
Pagpasok ni lolo at napatingin kay lola  .	4	
Kanina noong nakaupo ako sa upuan at echahcharge ko ang cellphone ko narinig ko si lolo may sinasabi kang lola  .	3	
Kaya naging close ako sa lolo , lalo na sa lola ko  .	3	
kasi si lola may tamang sweldo , si lolo naman ay matagumpay sa pagsasaka niya ng mais , minsan din ng niyog , meron din siyang palayan , maraming baboy , kambing at baka  .	3	
Alam nyo ba yung lolo ko araw-araw dinadala sa sinehan ang lola ko  !	2	
Bossing Pare alam mo ba yung lolo ko napakasweet sa lola ko , akalain mo simula nung ikasal sila , 4 times a year nyang dinadala sa parlor ang lola ko para magpaayos  !	2	
Joey Wala yan pare , kasi yung lolo ko monthly kung dalhin ang lola ko sa parlor  !	2	
Kaya , kapag naglalaro ang bata sa labas , at napapagawi sa bandang likuran ng bahay nakikita niyang nakatingin ang kanyang mahal na lola sa kanya na nasa dampa , at tinatawag siya nito , ngunit hindi siya lumalapit dahil sa bilin ng kanyang ama , kaya kumakaway na lamang siya sa kanyang lolo Iska , at napapansin niyang umiiyak na lang ang kanyang mahal na lola Iska na nag-aalaga sa kanya noon  .	2	
LOLA Apo , sabihin mo sa lolo , pahilot si lola at antok na antok na  .	2	
Yung tito ko nmatay xia s skit n dystonia namana nya s lolo nila carier yung lola ko n nanay nla ngaun nman yung anak ng kapatid ng lola ko n tito ko n din tinamaan n din ng dystonia  .	2	
hati sila sa food pero si lola lang ang kumakain , nanonood lang si lolo  .	2	
huminto sandali si lola Basyang para magpahid ng luha buhay pa sana si lolo inggo nyo kundi dumaan yung nagtitinda ng sorbetes  !	2	
lolo sabhin mo sa lola m wla aq sa mood tlog na  !	2	
nung namatay lolo ko di na nakakain lola ko kahiga nalang sya hanggang sa araw na libing ng lolo ko nang umagang yun namatay narin lola ko bago pa ilibing lolo ko huhu	2	
pagkaupo , hinati ni lolo ang burger , ibinigay kay lola  .	2	
sumulat po ako sa inyo dahil gusto ko pong makatulong sa aking lola Irene Ferrer at lolo Benjamin Ferrer Senior kahit sa pamamagitan ng pagsulat sa inyo  .	2	
28 lola ko tapos 25 lolo ko nung nagsama sil	1	
5 na ginawa ang face 2face kc ang rami ko po talagang natutunan lalo n poh ang tita , lolo , mama , at lola kuh sabay namin itong pinapamood maraming aral laming napupulot	1	
57 years of marriage pero si lola tawang tawa as in naiiyak level pa rin sa jokes ni lolo  ?	1	
@ALDUBLOLANIDORA lola c yaya pak n lang kunin m masaya cyang ksama pls lolo tinidora /nidora	1	
@LoloBabesHD @majjo0123 @IdioJacqueline si lola tidora alaga nya si lolo tom at ng magkaanak si tatay garfield at si nanay hello kitty 1 aq	1	
@LoloBabesHD @naliza01212 lola oh hinaharana ka ni lolo eihhhh pinapakilig mu c lola ha	1	
@RFAULKERSoN Daddy bae , nagkaroon na po ba ng ganitong meet &amp ; greet with you , his lolo &amp ; his lola  ?	1	
@RysherC hahaha aw oo btaw nkalimot ko SORRY NAGD hahahaha doh kung naa tay lolo tae , kinsa puy lola  ?	1	
@ShernieME @Prinsenggg uwe nakayo namatay si lolo dalhin nyo yung charger ni lola tas pati yung sapatos ko ne thank you	1	
@aleckziii or di kaya mangayo na lang ko kanday mama , lola , daddy , lolo but weakness ko mangayo kwarta  .	1	
@iamronaG07 hi lolo hello kitty lang po para kay lola masaya na yan HAHAHAHA	1	
@kathrengford paker kung maka lola ka eca ah pinaninindigan talaga haha conyo ka pa leche your lolo danilo will be the one to sundo you dyan	1	
@nayeontrbl ang ganda naman ng lola ko teka oo nga lolo ko nga pala si aura  !	1	
@noellegiman Sorry lola ako daw mahal ni lolo HAHAHAHHAAH	1	
@ray gargoles dahil sa isang concern cetizen inapload sa fb ung pic ni lola na naghahanap sa knyang asawa marami nakapansin at nakilala c lolo kaya NATAGPUAN NA PO nI LOLA C LOLO  .	1	
@zckej @pokieeify @joyllove @wolffia Queen of Cannes tawag ng iba kay lola ah hahaha yung kay lolo ngayon ko lang narinig hahahaha	1	
Aba , may kasamang lolo ni alden si lola baba  .	1	
Ako pud siya tambagan if ever naa na siyay mga problema sa balay or family like katong namatay iya lola late September as well as katong nag-away silas iya lolo  .	1	
Anak din ng haciendero si lola Maritess at sa ugali ni lolo Andres na walang pinipiling tao basta mahal lang anak niya kaya sila nakasal at nagsimulang magtayo ng negosyo sa pilipinas at ngayon na ang negosyong dinadala ni mommy  .	1	
Ang Saya Saya namin dati kaming lahat kasama ang Lolo at Lola ko at isa pang lolo na bading kapatid ng lola ko , limang anak nila kasama si papa nakabukod dahil sa nagasawa at naiwan ako at walo kaming magpipinsan magkkasama sa iisang bahay , yung halos hindi kami mag hiwahiwalay pag naapi yung isa sugod lahat , pag may party party walang maiiwan , mahilig dn kaming mag party party minsan kahit walang okasyon basta magkakasama kami ok na  .	1	
Ang galing pala sumayaw ng mga bangkay kuwando 2x ni lolo tinidora love u poh galing nyo poh mga lola hataw at galaw talaga	1	
Ang kyut talaga ng mga lola't lolo na ganyannn 3 kinakausap ko rin yang mga cute na lola kahit di ko kilala haha	1	
Ang mga taohan puro patay unahin kay carmen pinatay kc my problema sa mata kailangan mag pahinga tpos si glenn nagpaalam kc ang nanay my sakit sa puso nawala din tpos ngayon c benny kc my sakit daw sa susunod cnu nman ang mawala si ate yolly tpos c elmo tpos c lola flora tpos c lolo delfin tpos c billy tpos c jerome tpos c choy eh d wow tpos na kc naubos ang characters THE END	1	
Ang sweeet Ngayon 20 yrs mahigit na sila nagsasama , sabi pa ni lola kung nagkaroon daw sila anak gusto nya katulad ni lolo  .	1	
Anq payat pala ni mr , marcelo ala dinq ilonq umppp tiga tangos kdin mr marcelo , hehehe joke sna nqa laht nq pag luha ko at pag hihirap na dka mkita at mksama sna maramdman mo , kht sa hangin lng mis na mis na kita , gno pa ba ktgal 10 years paba ko mag hihintay baybie bka 15 years pa oi lola nko nun 38 nko nun 47 ka na nun lolo kna	1	
Anu ba yan mamatay n si alyanna kc papasok na sa pbb tpos alis na rin c hugot queen punta kunwari sa dubai sa nanay nya tpos nsa loob pla ng bahay ni kuya at kunwari nag aaral c jp sa japan un pla nsa kapit bhay ni kuya tpos mamatay c lolo delpine tpos mabaril si lola flora tpos mamatay nman si yolly tpos ung asawa nya papatayin din ni jaquin tpos sasalihin ni mak mak si mak mak ang patay kc bz na sa your face sounds familiar  ?	1	
Apo bakit po yoya lola Lola Puntahan mo ang lolo mo at sabihin mo na hilutin ang likod ko  .	1	
Apo opo yoya pumunta na ang apo sa lolo niya Apo yoyo lolo iyutin mo daw si yoya patayikod Lolo ayoko nga , sabihin mo sa lola mo na wala ako sa mood  .	1	
At nagtataka ako kung bakit si lolo lang ang kumakain at hindi si lola  .	1	
Awa ng diyos ung lola ko n my nunal s daluyan ng luha mas nauna pang mamatay s lolo ko  .	1	
BATA lolo , binayara mo na ako LOLO galing sa lola mo yan	1	
#hari,	reyna
gusto mo bsng malaman kung ano na ang kaganapan sa atong mahal na hari at mahal na reyna  ?	2	
-db't ikw nga ung reyna &amp ; aq ang yong hari  .	1	
@AlDubBigBoyz prang sagala nakasunod sa reyna maine ksma ang kanyang hari alden  .	1	
Airing Date August 04 , 2012 Saturday Buena manong sabado pasabog ng Face to Face , hari diumano ng pangboboso , nahuling sinisilipan ang reyna ng banyo  !	1	
Ako ang reyna at ikaw ay hari	1	
Ang hari ay bale wala sa mga PAWN na naging reyna  .	1	
Ang tatlong hari at ang knlang nag iisang reyna ahehe KISSES AngSunshineNamin	1	
At kahit kailan hindi papayagan ng hari na magkaroon sya ng dalawang reyna kung totoong lalaki talaga sya  .	1	
At syempre mas magkaroon pa ng maraming kilig scenes ang mahal na hari at mahal na reyna  .	1	
Bitayin ang tatlong hari ng magnabakaw at reyna ng magnabakaw  !	1	
Dapat lang gawing kaming reyna dahil taung mga reyna sila lng ang hari  .	1	
Dati by Sam Concepcion Di ba't ikaw nga yung reyna at ako ang yong hari Akong yong prinsesang sagip mo palagi Ngunit marami ng nabago't nangyari ngunit di ang pagtingin Na gaya pa rin ng kakakaka kanin kakakaka kanin Na gaya pa rin ng kanin	1	
Di ba ikaw nga yong reyna at ako ang iyong hari  .	1	
Di ba t ikaw nga yung reyna at ako ang iyong hari Ako yung prinsesang sagip mo palagi Ngunit ngayo y marami ng nabago t nangyari Ngunit di ang pagtingin na gaya pa rin ng dararada dati Dararatda dati Dararatda dati Na gaya pa rin ng Dati-rati ay palaging sabay na mag-siesta At sabay ring gigising ng alas kwatro imediya Sabay manonood ng paboritong programa O kay tamis namang mabalikan ng alaala  .	1	
Di ba't ikaw nga yung reyna at ako ang iyong hari	1	
Di ba't ikaw nga yung reyna at ako ang iyong hari Ako yung prinsesang sagip mo palagi MY LIZQUEN HEART HAY	1	
Di bat ikaw nga yung reyna at ako ang yong hari  .	1	
Diba ikaw ung reyna , at ako ang iyong hari  .	1	
Diba't ako ang yong reyna at ikaw aking hari hehe RYLEBIE For UKG	1	
Diba't ikaw nga yung reyna at ako ang iyong hari  .	1	
Diba't ikaw nga yung reyna at ako ang yong hari  .	1	
Diba't ikaw nga yung reyna at ako ang yong hari Guys , meet my Queen  .	1	
Diba't ikaw nga yung reyna at ako ang yong hari NashLene On ASAP 4U	1	
Dibat ako ang yong reyna at ikw ang hari  .	1	
Dibat ikaw na yong reyna at ako iyong hari ako yong prinsesa sagip mo palagi ngunit ngayon marami nang nabagot nangyari  .	1	
FANZONED Minahal kita lubos , Ngunit dimoko Kilala , Matatawag kitang hari ko , PERO dimoko maituturing na reyna , Kilalang kilala ka , Tiyak na madami akong kaagawa sayo Tila ibigay ko na nga ang aking sarili sayo , Matawag nakong disperada , Okay lang basta para sayo , Tawagan nakong Assumera dahil sa Kakaisip ko na ikaw ang boyfriend ko  .	1	
For the 3rd time happy 25th mahal na reyna @bernardokath at mahal na hari @imdanielpadilla	1	
Grabe takot sa hari kaya puro kasinungalingan pinapairal ng malanding reyna  .	1	
Haha an 0ng silbi ng pagaaral kung ang tatay m 0 hari ng england at ang nanay m 0 syempre reyna tap 0s ikaw ang tagapagmana ng lahat at ikaw susun 0d na magiging hari tahaha  ?	1	
Hahaha napasayaw ang hari at tuwang tuwa ang reyna	1	
Hindi mgiging reyna si jang geum at di mgging hari si kapitan  .	1	
Hnd talaga sila pwd manalo sa xfactor uk monarcy sila ganyan sila k solid gaya ng respito nila sa reyna nila hnd sila pwd masapawan lalo n dayuhan dahil sila ang mga hari n hnd pwd palitan magpakailan man pero mabubuti sila at mabait sadya ngalang solid tlga sila hnd pwd matalo yan ang history nila basta sa teretoryo nila pero sa labas ng bansa nila patas sila at mababait hnd sa sinasabi n dinaya sila hnd yun ang batas at history ng nakagisnan nila ang monarcy hnd papatalo sa teretoryo nila  .	1	
Ikaw and reyna at ako and hari char  !	1	
Ikaw na ang reyna ng buhay ko At akala koy ako na rin ang hari ng buhay mo , ngunit biglang natapos ng hindi man lang na umpisahan	1	
Ikaw nga yung reyna at ako ang iyong hari at ikaw yung prinsesang sagip ko parati  .	1	
Ituring mo siyang reyna , at ikaw lang naman ang hari ng buhay niya  .	1	
Kung gusto mong tratuhin ka niya na parang reyna , itrato mo siya na parang hari , hindi utusan  .	1	
Kung si pandak ang reyna ng kawalanghiyaan , si baboy naman ang hari  .	1	
Kuya Daniel sobrang gwapo nyo Opo ikaw ang hari ng kagwapuhan at c ate Kathryn nmn ang reyna ng kagandahan DBA bagay po	1	
LizQuen singing Di ba't ikaw nga yung reyna at ako ang iyong hari was today's highlight I love it  !	1	
Lumuhod ang reyna para sa tigasing hari  .	1	
Naalala rin ni so ang tinuran ng inang reyna sa kanya na ginagamit lamang sya ng hari KapusoBrigade	1	
Nakadungaw sa terrace ang hari na tila ba hinihintay ang kanyang reyna na nasa Maynila DJP PrideOfIlocos 2	1	
Nakaka Inis talaga yang reyna na yN hndi namn nya gusto ung hari gusto nya lang magkaroon ng pwesto sa Palasyo Tskk Grabe talaga aya	1	
O , sabi ng hari iboto daw ang reyna  .	1	
Oo hari nga ako , reyna siya , pero parang chess ang laban , siya ang may kapangyarihan  .	1	
Para sayo ikaw ang hari at ako ang reyna  .	1	
Parang makuha ang hari at ipatumba kailangan magsakripisyo ng isang reyna o taohan  .	1	
Pero kung may reyna , diba , dapat may hari rin  ?	1	
Previous Dahil nga Ministro si Sejong , may chance na maging sya ang susunod na hari sakali man na mawala ang kasalukuyang hari na wala pang pagpapasahan ng trono , mas may chance na maging reyna sya  .	1	
#ama,	ina
Ang magulang ko po nagkasakit po dati na operahan dati ang aking ina sa matres kaya hindi na nakapag work ulit , at ang aking ama ay naoperahan sa mata kaya hindi na nakapagwork  .	68	
Ang magulang ko po nagkasakit na operahan dati ang aking ina sa Matres at ang aking ama ay naoperahan sa Mata kaya hindi na sila nakapagwork  .	64	
Sa record ng kaso , nabulgar ang rape case nang lapitan ng ina ni Pepsi Paloma si Atty Rene Cayetano ama ng senatorial candidate na si Pia Cayetano para hingan ng tulong para makamtan ng kanyang anak ang katarungan na umanoy minolestiya ng tatlong host ng Eat Bulaga  .	23	
Ito ang mga katatagang hindi na maaalis sa isip ni gaby , at dahil na rin sa takbo ng kaniyang buhay kasama ang ina at tumayo na ring ama sa kaniya  .	8	
pumunta sya kwarto ng knyang magulang ngunit humihilik na ang knyang ina at wala naman doon ang kanyang ama  .	8	
At ang lumait sa kaniyang ama , o sa kaniyang ina , ay papataying walang pagsala  .	7	
At ang sumakit sa kaniyang ama o sa kaniyang ina , ay papataying walang pagsala  .	7	
Nang tangkain namang kuhanin ng ina sa puder ng ama , nauwi sa sampalan at sabunutan ang eksena  .	6	
Istriktong ama , mapagmahal na ina  .	5	
Wala na po trabaho ang aking ama dahil dati po sya driver at nabenta na po ang aming sasakyan para pang enroll ko dati , nagkasakit po sa kidney failure ang aking ama at ang aking ina naman ay dati ofw ngunit hindi na naka balik sa ibang bansa n 0on elementary pa lang ako  .	5	
FACE THE PEOPLE 20 ULIT NAGLASLAS SA PAMBUBUGAW NG INA PART 1 / 2 Inabandona silang magkakapatid matapos ibugaw ng ina , inapi ng tiyahin habang nakakulong ang ama , naglaslas ng 20 ulit pero nakaligtas pa  .	4	
May bigla akong narealized kaya gusto ko na iboto sina at Nakita ko sa kanila ang tatay at nanay ko , isang matapang pero may malasakit na ama at isang mapag-aruga , tapat at matulungin na ina  .	4	
Ang aking ama ay isa lang tricycle driver at ang aking ina naman ay nagpaparepa lamang  .	3	
Bago tuluyang masira ang kanilang pamilya , pinatawad ni Alex ang kanyang ama at nagsikap tapusin ang pag-aaral para patunayan sa ina na hindi niya ito kailangan  .	3	
Gumuho ang buhay ni Alex nang sumama ang kanyang ina sa ibang lalaki dahil nagsimulang malulong sa droga ang kanyang ama  .	3	
Mula sa pagpanaw ng kanyang ama hanggang sa maaga niyang pagiging ina , matapang na hinaharap ni Lyn ang lahat  .	3	
Ngunit mas susubukin ang kanyang katatagan niya nang matuklasang may breast cancer ang kanyang ina at may sakit sa puso ang kanyang ama  .	3	
Wala na po trabaho ang aking ama dahil dati po sya driver at nabenta na po ang aming sasakyan para pang enroll ko dati , nagkasakit po sa kidney failure ang aking ama at ang aking ina naman ay dati ofw ngunit hindi na naka balik sa ibang bansa at naoperahan sya dati sa matres , n 0on elementary pa lang ako  .	3	
malamang ndi mo mabasa tong comment q pero sa dami ng nag cocomment ngeon seo at sa MALDITAH mong ina malaman humingi ka ng tawad sa ama mo  !	3	
Ako ang ina at alam ko Kung Cno talga ang ama  .	2	
Ang magulang ko po nagkasakit na operahan dati ang aking ina sa matres at ang aking ama ay naoperahan sa mata kaya hindi na sila nakapagwork  .	2	
Dahilan para magduda ang kanyang ina sa ipinapakita niyang ka-sweetan sa kanyang ama  .	2	
Dumating akong taglay ang pag hihiwalay ng tao laban sa kanyang ama , ng anak na babae sa kanyang ina , ng ma nugang sa kanyang biyenan  .	2	
INA , IPINAMBAYAD SA UTANG SA 5-6 ANG ANAK BILANG GANTI SA SELOS Pinagselosan siya ng ina dahil malambing sa ama , pinagtulungang bugbugin ng mga kapatid at ng ina sa loob ng tatlong taon , saka pilit ipinakakasal para pambayad-utang sa nagpa-5-6 na lalake  .	2	
Isipin nyo nalang kung ang batugan na parents , lasingong ama at puro chismis na ina ay manganganak nang marami  .	2	
Kapatid si Yna sa ama at kapatid si Angelo sa ina  .	2	
Maraming pinagdaanan ang aking ama nang di nya makita nag kanyang ina  .	2	
Okay lang maging batang ina basta si Angelito ang ama HAHAHA	2	
Pero ang totoo po , sa Cebu ang dami po naming utang , nangungupahan lang kami at palipat-lipat ng bahay , pahayag ni JK na mula nang ipinanganak ay hindi nakikilala ang kanyang Aleman na ama at nakapiling ang ina na mayroon nang sariling pamilya  .	2	
Sa labis na pagiging mapagmahal sa pamilya , nagsilbi siyang ama sa kanyang mga kapatid matapos pumanaw ang kanilang ina  .	2	
bata palang siya wala na siyang ama and ilang taon palang siya ng nawalan ng ina  .	2	
, magtiwala kayo sa ama , wag sa mag ina  .	1	
, para matustosan yong pangangailangan ng aming pamilya , house wife lang ang aking ina at driver lang po ang aking ama  .	1	
-Survey Question- Backtracks Nung sanggol palang si Bidam ay hindi sya tinanggap ng kanyang ama at ang kanyang ina naman na si Lady Mishil ay iniwan na lang syang umiiyak sa palasyo at umalis  .	1	
-nkakatuw un tatay ngayon ang alalay n Kobe sana nga mgtagumpay si Kobe un looks s ina un galing s bola s ama	1	
1 yr ako dito sa abroad nung nawala komunikasyon namin ng live in partner ko , dahil sa isang dahilan na napakasakit para sa isang ina na maririnig mula sa isang ama na feeling ko iresponsable that time  .	1	
2 1993 ang svi ng aking ama anak nandyn na ang aking ina at ang iyong kpatid sinusundo na nila ako akoy napaiyak at ang svi ko cge ama mgpahinga kna ksama mo cla  .	1	
3 Bata pa kami ng naulila sa ina , pinabayaan kmi ng aming ama , lola namin ang nag aruga sa amin , 2nd ako sa 7mgkakapatid  .	1	
3cycle driver ang ama at manicurista ang ina  .	1	
5 Parangalan mo ang iyong ama at ang iyong ina upang ang iyong mga araw ay tumagal sa ibabaw ng lupa na kung saan ang Panginoon iyong Diyos ay nagbibigay sa iyo  .	1	
7 Huwag kayong makipagtalik sa inyong ina , iyan ay kahihiyan sa inyong ama  .	1	
9 Huwag kayong makipagtalik sa inyong kapatid na babae , maging siya'y anak ng inyong ama o ng inyong ina , ipinanganak man siya sa inyong lupain o sa ibang bayan  .	1	
@MohaJichoPevu umetulia sana bro ama ni twitter yangu ina filter your tweets hehehe , mzima lakini  ?	1	
@PEPalerts ang isang anak na mapagmahal sa ina ay asahan mong magiging mabuting asawa at ama	1	
@labaanshabaan @kellyogome @realpinchez where is the party ama tukam na maji ina matope	1	
@ryanagonciLLo it looks like family vla tlga dto , na hwak ng ama ung anak na bbae at si ina nmn ay ang bunsong lalaki , ALDubEBTamangPanahon	1	
ANAK Nay , sabi ng titser ko ang ina ay ILAW NG TAHANAN , Eh ano naman po tawag sa ama  ?	1	
Abs cbn , ang galing talaga ninyo maghanap ng anak anakan tatay tatayan , parang too mag ina , toong mag ama , believe ako sa inyo , magkamuk ha talaga cla sa mga drama ninyo , malingaw ko mawala sad ako probs  .	1	
Agad syang tumakbo sa kwarto ng magulang ngunit humihilik na ang kanyang ina at wala naman doon ang kanyang ama  .	1	
Agree ako dyan bakit ayaw nia maging maligaya ang kanyang ama sa kanya naman ina hindi siya naging masaya at maligaya niloko pa siya at pineperahan ganyan ba ang mabuti ina	1	
#prinsipe,	prinsesa
Nagsama ang bakla at ang prinsipe sa gubat Bakla Dati akong prinsesa , sinumpa lang ako na maging bakla  .	12	
Parang ikaw ang prinsesa at siya ang prinsipe  .	4	
Kung kayo gusto niyong ituring namin kayong prinsesa , kami rin , gusto naming ituring niyo rin kaming prinsipe  .	3	
At higit sa lahat , wag na wag kang magsasawa sakaniya at tratuhin mo siya na parang prinsesa mo para tratuhin ka rin niyang parang prinsipe niya  .	2	
CHAPTER 4 Sa Gitna ng bulwagan ay isinayaw niya ang prinsesa , halata ng prinsipe na pinagtitinginan sila ng nasa paligid , lalo na si Prinsipe Frankie na kulang na lang ay lamunin sya ng buhay sa tingin nito sa kanya  .	2	
Refresh FROG mahal na prinsesa , ako'y dating prinsipe na isinumpa  .	2	
isang araw , nilapitan ako ng prinsipe sabi nya gagawin daw nya akong prinsesa nya bibigay daw nya lahat ng gusto ko paliligayahin daw nya ako pero , and di nya alam di ako liligaya ng wala ka dahil IKAW ang prinsipe ko  !	2	
@BarrettoJulia Isang prinsesa sa paningin ng prinsipe si @iamjoshuagarci we always support u both no matter what	1	
@MarVoreeOFCLP @itsMayWard hahahaha dami mo ng nsbi prinsipe marco pero c prinsesa viv wla naintidhan hehehe  .	1	
@MarydaleEntrat5 we do Maymay @MarydaleEntrat5 , si Edward ang prinsipe at ikaw naman ang prinsesa , ayeeeh	1	
@odettecostelo hahaha para kang prinsesa tas ako yun prinsipe loveu too yie	1	
A DAMSEL IN DISTRESS Paano kaya maililigtas ang ating prinsesa , gayong dinukot din ang ating prinsipe  ?	1	
Ako ang iyong prinsipe at ikaw ang aking prinsesa at hayaan mo akong mahalin ka habang buhay  .	1	
Ang prinsesa at ang kanyang prinsipe  .	1	
Ang prinsesa hinihintay ang pagdating ng prinsipe  .	1	
At hindi rin lahat ng lalaki prinsipe dahil yung Iba prinsesa na rin po  .	1	
BAKLA AT PRINSIPE Bakla Mahal na prinsipe , ako'y isang prinsesa na isinumpa  .	1	
CHUUPPPiiii ndi ka ang prinsipe para sa katulad niyang prinsesa  .	1	
Goodnight na mga prinsesa pati sa mga prinsipe natin  .	1	
Hindi naman ito isang ponytail kung saan sasagipin ng magiting na prinsipe ang nanganganib na prinsesa  .	1	
Horse Mahal na prinsesa wag kayong matakot dati akong prinsipe na isinumpa  .	1	
Huwag mo silang ituring na prinsesa kung hindi ka naman handang maging prinsipe nila  !	1	
Ito ang fairy tale na kung saan ang prinsesa ang magliligtas sa isang prinsipe  .	1	
Kung ang babae gustong gustong tinuturing na parang prinsesa , ang ibang lalake naman ay gustong tinuturing silang mga prinsipe , mga prinsipe ng buhay nyo girls  .	1	
Kung gaano ka kulit ang prinsesa , ganoon din ka kulit ang prinsipe  .	1	
Kung kayong mga babae ay prinsesa , ang mga lalake naman ay prinsipe  .	1	
Kung mahal mo pamilya mo at may takot ka sa DIYOS kahit sino pang prinsesa ang mag split at prinsipe na maglatag ng salapi sa harapan mo hindi mo papatulan  .	1	
Kung saan ang prinsesa andun din ang prinsipe dapat  !	1	
May prinsipe ka na , may prinsesa ka pa  !	1	
Mukang prinsesa si Maine at muka namang prinsipe si Alden	1	
Nagkasama ang isang bakla at isang prinsipe sa gubat Bakla Dati akong prinsesa , sinumpa lang ako kaya ako  .	1	
Nagsama ang bakla at ang prinsipe sa gubat Bakla Dati akong prinsesa , sinumpa ako na maging  .	1	
Oh my God ang ganda ng prinsesa at gwapo ng prinsipe  .	1	
Oo naman dto sa bayan ko ang prinsesa namin di nya sinunod na ang pakasalan nya prinsipe ordinariong tao lang pinaglaban nila ang pag ibig nila hay ang sarap ng ganoon feelings kahit na maraming hadlang kinaya nila basta alam nila na mahal nila ang isat isa di nakukuha sa yaman sa hirap sa totoong pag ibig ang sinusukat yung damdamin yun na talaga	1	
Para sya prinsipe , si baby girl syempre ang prinsesa &lt ; 3	1	
Philip Ang prinsipe , dapat alam nya kung sino ang kanyang prinsesa  .	1	
Si Yaya prinsesa si Alden ang prinsipe  .	1	
Silang dalawa lang walang storbo Haha Go naman agad ang prinsesa sa utos ng kanyang prinsipe	1	
Sobrang ganda ng prinsesa at gwapo ng prinsipe TEN MONTHS WITH MCLISSE	1	
Tinuring kitang prinsesa kahit alam kong prinsipe ka  .	1	
Umaasa kami na nagising na ang prinsesa at siya ang sasagip sa prinsipe niya for a change  .	1	
Wag mo silang ituring na prinsesa kung hindi ka man handa na maging prinsipe niya- Vice G  .	1	
Wag mong ituring na prinsesa kung wala ka namang balak maging prinsipe niya	1	
Yumuko ang prinsipe at tumingala ang prinsesa  .	1	
Yung grabe ha , alam mong prinsesa ka , pero hindi siya yung prinsipe mo , at never mo siya magiging  .	1	
ako ang iyong prinsipe , pero ngayon pareho na tayong prinsesa  .	1	
at mas lalo pa kaming sasaya dahil magkasama na nman po ang prinsesa kris bernal at prinsipe aljur abrenica  .	1	
deserve ng bawat babae na maging NAG-IISANG prinsesa sa piling ng ISANG prinsipe  .	1	
happy daw po ang prinsesa natin while watching for sure happy din ang prinsipe natin LABAN MAYWARDS	1	
hello prinsesa ko @angelicaj andito na ang prinsipe mo wag kana iiyak ha  ?	1	
#siya,	siya
#ama,	ina
Ang magulang ko po nagkasakit po dati na operahan dati ang aking ina sa matres kaya hindi na nakapag work ulit , at ang aking ama ay naoperahan sa mata kaya hindi na nakapagwork  .	68	
Ang magulang ko po nagkasakit na operahan dati ang aking ina sa Matres at ang aking ama ay naoperahan sa Mata kaya hindi na sila nakapagwork  .	64	
Sa record ng kaso , nabulgar ang rape case nang lapitan ng ina ni Pepsi Paloma si Atty Rene Cayetano ama ng senatorial candidate na si Pia Cayetano para hingan ng tulong para makamtan ng kanyang anak ang katarungan na umanoy minolestiya ng tatlong host ng Eat Bulaga  .	23	
Ito ang mga katatagang hindi na maaalis sa isip ni gaby , at dahil na rin sa takbo ng kaniyang buhay kasama ang ina at tumayo na ring ama sa kaniya  .	8	
pumunta sya kwarto ng knyang magulang ngunit humihilik na ang knyang ina at wala naman doon ang kanyang ama  .	8	
At ang lumait sa kaniyang ama , o sa kaniyang ina , ay papataying walang pagsala  .	7	
At ang sumakit sa kaniyang ama o sa kaniyang ina , ay papataying walang pagsala  .	7	
Nang tangkain namang kuhanin ng ina sa puder ng ama , nauwi sa sampalan at sabunutan ang eksena  .	6	
Istriktong ama , mapagmahal na ina  .	5	
Wala na po trabaho ang aking ama dahil dati po sya driver at nabenta na po ang aming sasakyan para pang enroll ko dati , nagkasakit po sa kidney failure ang aking ama at ang aking ina naman ay dati ofw ngunit hindi na naka balik sa ibang bansa n 0on elementary pa lang ako  .	5	
FACE THE PEOPLE 20 ULIT NAGLASLAS SA PAMBUBUGAW NG INA PART 1 / 2 Inabandona silang magkakapatid matapos ibugaw ng ina , inapi ng tiyahin habang nakakulong ang ama , naglaslas ng 20 ulit pero nakaligtas pa  .	4	
May bigla akong narealized kaya gusto ko na iboto sina at Nakita ko sa kanila ang tatay at nanay ko , isang matapang pero may malasakit na ama at isang mapag-aruga , tapat at matulungin na ina  .	4	
Ang aking ama ay isa lang tricycle driver at ang aking ina naman ay nagpaparepa lamang  .	3	
Bago tuluyang masira ang kanilang pamilya , pinatawad ni Alex ang kanyang ama at nagsikap tapusin ang pag-aaral para patunayan sa ina na hindi niya ito kailangan  .	3	
Gumuho ang buhay ni Alex nang sumama ang kanyang ina sa ibang lalaki dahil nagsimulang malulong sa droga ang kanyang ama  .	3	
Mula sa pagpanaw ng kanyang ama hanggang sa maaga niyang pagiging ina , matapang na hinaharap ni Lyn ang lahat  .	3	
Ngunit mas susubukin ang kanyang katatagan niya nang matuklasang may breast cancer ang kanyang ina at may sakit sa puso ang kanyang ama  .	3	
Wala na po trabaho ang aking ama dahil dati po sya driver at nabenta na po ang aming sasakyan para pang enroll ko dati , nagkasakit po sa kidney failure ang aking ama at ang aking ina naman ay dati ofw ngunit hindi na naka balik sa ibang bansa at naoperahan sya dati sa matres , n 0on elementary pa lang ako  .	3	
malamang ndi mo mabasa tong comment q pero sa dami ng nag cocomment ngeon seo at sa MALDITAH mong ina malaman humingi ka ng tawad sa ama mo  !	3	
Ako ang ina at alam ko Kung Cno talga ang ama  .	2	
Ang magulang ko po nagkasakit na operahan dati ang aking ina sa matres at ang aking ama ay naoperahan sa mata kaya hindi na sila nakapagwork  .	2	
Dahilan para magduda ang kanyang ina sa ipinapakita niyang ka-sweetan sa kanyang ama  .	2	
Dumating akong taglay ang pag hihiwalay ng tao laban sa kanyang ama , ng anak na babae sa kanyang ina , ng ma nugang sa kanyang biyenan  .	2	
INA , IPINAMBAYAD SA UTANG SA 5-6 ANG ANAK BILANG GANTI SA SELOS Pinagselosan siya ng ina dahil malambing sa ama , pinagtulungang bugbugin ng mga kapatid at ng ina sa loob ng tatlong taon , saka pilit ipinakakasal para pambayad-utang sa nagpa-5-6 na lalake  .	2	
Isipin nyo nalang kung ang batugan na parents , lasingong ama at puro chismis na ina ay manganganak nang marami  .	2	
Kapatid si Yna sa ama at kapatid si Angelo sa ina  .	2	
Maraming pinagdaanan ang aking ama nang di nya makita nag kanyang ina  .	2	
Okay lang maging batang ina basta si Angelito ang ama HAHAHA	2	
Pero ang totoo po , sa Cebu ang dami po naming utang , nangungupahan lang kami at palipat-lipat ng bahay , pahayag ni JK na mula nang ipinanganak ay hindi nakikilala ang kanyang Aleman na ama at nakapiling ang ina na mayroon nang sariling pamilya  .	2	
Sa labis na pagiging mapagmahal sa pamilya , nagsilbi siyang ama sa kanyang mga kapatid matapos pumanaw ang kanilang ina  .	2	
bata palang siya wala na siyang ama and ilang taon palang siya ng nawalan ng ina  .	2	
, magtiwala kayo sa ama , wag sa mag ina  .	1	
, para matustosan yong pangangailangan ng aming pamilya , house wife lang ang aking ina at driver lang po ang aking ama  .	1	
-Survey Question- Backtracks Nung sanggol palang si Bidam ay hindi sya tinanggap ng kanyang ama at ang kanyang ina naman na si Lady Mishil ay iniwan na lang syang umiiyak sa palasyo at umalis  .	1	
-nkakatuw un tatay ngayon ang alalay n Kobe sana nga mgtagumpay si Kobe un looks s ina un galing s bola s ama	1	
1 yr ako dito sa abroad nung nawala komunikasyon namin ng live in partner ko , dahil sa isang dahilan na napakasakit para sa isang ina na maririnig mula sa isang ama na feeling ko iresponsable that time  .	1	
2 1993 ang svi ng aking ama anak nandyn na ang aking ina at ang iyong kpatid sinusundo na nila ako akoy napaiyak at ang svi ko cge ama mgpahinga kna ksama mo cla  .	1	
3 Bata pa kami ng naulila sa ina , pinabayaan kmi ng aming ama , lola namin ang nag aruga sa amin , 2nd ako sa 7mgkakapatid  .	1	
3cycle driver ang ama at manicurista ang ina  .	1	
5 Parangalan mo ang iyong ama at ang iyong ina upang ang iyong mga araw ay tumagal sa ibabaw ng lupa na kung saan ang Panginoon iyong Diyos ay nagbibigay sa iyo  .	1	
7 Huwag kayong makipagtalik sa inyong ina , iyan ay kahihiyan sa inyong ama  .	1	
9 Huwag kayong makipagtalik sa inyong kapatid na babae , maging siya'y anak ng inyong ama o ng inyong ina , ipinanganak man siya sa inyong lupain o sa ibang bayan  .	1	
@MohaJichoPevu umetulia sana bro ama ni twitter yangu ina filter your tweets hehehe , mzima lakini  ?	1	
@PEPalerts ang isang anak na mapagmahal sa ina ay asahan mong magiging mabuting asawa at ama	1	
@labaanshabaan @kellyogome @realpinchez where is the party ama tukam na maji ina matope	1	
@ryanagonciLLo it looks like family vla tlga dto , na hwak ng ama ung anak na bbae at si ina nmn ay ang bunsong lalaki , ALDubEBTamangPanahon	1	
ANAK Nay , sabi ng titser ko ang ina ay ILAW NG TAHANAN , Eh ano naman po tawag sa ama  ?	1	
Abs cbn , ang galing talaga ninyo maghanap ng anak anakan tatay tatayan , parang too mag ina , toong mag ama , believe ako sa inyo , magkamuk ha talaga cla sa mga drama ninyo , malingaw ko mawala sad ako probs  .	1	
Agad syang tumakbo sa kwarto ng magulang ngunit humihilik na ang kanyang ina at wala naman doon ang kanyang ama  .	1	
Agree ako dyan bakit ayaw nia maging maligaya ang kanyang ama sa kanya naman ina hindi siya naging masaya at maligaya niloko pa siya at pineperahan ganyan ba ang mabuti ina	1	
#tiyo,	tiya
May mga pinsan din tau s baguio , mga anak ni tiyo talyo emelo at jan s naic cla tiya lita emelo roding emelo  .	1	
This story was happened more than 21 yrs ago na pinas pa ako , yong Tiyo ko nag abroad din , diyan sa Dubai wala namang alam ang Tiya ko na may babae si tiyo , so nag holiday si tiya sa Dubai , na shocked siya doon sa daming mga open minded na pinoy , normal na daw ang kabitan kabi kabila wala ng social norm , sinabi niyang siguro daw ang tiyo ko eh meron ding babae for sure  .	1	
papaoperhn q ang aswat ank q n my dperensya s mata para magng maauz knbuksn nla at mkpagtrbhu ng aus aswa q , tpus 22lungn q tiya q kc mtanda n cla n tiyo wla ng trbho tpuz my 3 mli 2it n apo p clang inaalagaan yung isa bulag p wla aman ibng 22l0ng s knla kundi kming pmilya nla  .	1	
#kumpleto,	ganap
@ElleMarieJamie oo nga te antagal ng nganga sa ganap ng JoshAne sana sa promo ng BloodyCrayons kumpleto na tayo JOSHANE For ESPERANZA	1	
Kasi di ako nkapan 0od kanina ng eat bulaga kung ana ang ganap kaya bawi nlng ako dto kht di kumpleto	1	
Mmk the movie meron with aiko melendez ganap n tlaga siya actor dhil nkapag mmk n din siya sabi hindi kumpleto ang pagiging artista kung hindi ka magmmk kya mga lumipat sa ch 2 gusto agad mkpagmmk  .	1	
Oo nga kahit walang masyadong ganap basta makita ko pang yung dalawa kumpleto na araw ko  .	1	
Pumasok sa Islam ng ganap , ng buo , ng kumpleto , ng buong pagpapasakop  .	1	
kaloka ang mga ganap sa Jane The Virgin haha kumpleto ulit ang araw ko	1	
#mabilis,	mabilisang
naisip ni superman na dahil may super speed siya , kaya nya si wonder woman ng mabilis na mabilis at di mamamalayan ni wonder woman kuya bumulusok si superman at mabilisang at umalis  .	2	
Sali na sa mabilisang batian para ikaw ay mabilis labasan ng ngiti sa mukha  .	1	
gsto k mabilis , utak wangn wang ung panay reklamo png mabilis ang kaso , un ang dapt gawin mabilisang aksyon , wag pa bagl bagal	1	
naisip ni Superman na dahil may super speed siya , kaya nyang isex si Wonder Woman ng mabilis na mabilis na di mamamalayan ni wonder woman Kaya bumulusok si Superman at mabilisang gumalaw at umalis  .	1	
naisip ni superman na dahil may super speed siya , kaya nya kantutin si wonder woman ng mabilis na mabilis at di mamamalayan ni wonder woman kuya bumulusok si superman at mabilisang kumantot at umalis  .	1	
#bihira,	bihirang
#kahanga-hanga,	kahanga-hangang
#maaari,	marahil
Ikaw lng naman un nglagay sa pamilya mo sa panganib , at kng totoo nangaganib ang buhay mo at maaari ka ikamo mapatay e marahil kng may gagawa nun e bka isa sa mga pinagalanan mong mga tao at hindi dawit ang pangulo tulad ng ipinipilit mo	1	
#masayahin,	masayang
#karamihan,	karamihang
Kung maka pag comment ang karamihan wagas mas mabuti naman si manny kesa karamihang politiko halos lahat mga tulisan at kung totoo man siguro na meron syang absent at least nagdadala sya ng karamgalan sa bansa Hindi tulad ng karamihan puro kahihiyan at pangungulimbat sa kaban ng bayan ang ginagawa at kayong mga mahilig bumatikos matanong ko lang ano ang nai ambag nyo sa pagsulong ng bayan  ?	1	
Nag mamagaling kna nmn mga ipinasa mong batas puro palpak ngaun dahil sa juvenile mo karamihang sakot sa krimin menor di edad na hnd makasuhan karamihan mga menor mga balasubas mga bastos at walang pag galang tapos kung magsalita ka kala mo nmn kung may matino kang naipasang batas  !	1	
Si melay ay naging idol ko kasi sya napaka realistic Nya totoo syang tao karamihan talaga na action Nya ay totoo talagang nakikita sa karamihang tao	1	
Yung nagsabi na gayagaya walang alam sa mga nangyayari Or in short tanga or bobo lang Donation nga ehh para sa mga may sakit Bitter naman yung iba Kaya di umaasenso ang pilipinas dahil sa ugali ng karamihang pinoy crab mentality Masaya ang karamihan na may mahihila pababa	1	
galit ang karamihang tao sa administrasyon kung saan andun ang kalaban nyang si Mar at karamihan sa mga tao galit kay Mar lalo na sa mga Yolanda Victims  .	1	
karamihang sinasabi o pinoPinopost ng karamihan kinidnap si YayaDub oh ano naman Ngayon	1	
pag presindente na kayo ng pilipinas alisin nyo na mga senador na yan karamihan kasi magnanakaw mas gusto ng karamihang pilipino na ang mag nanakaw pinapatay para umasinso na ang pinas	1	
#malaya,	malayang
Ang plataporma nya , ualang kasilbisilbi , anu daw yun , malaya sa gutom , malayang mangarap , eh paranG , malaya lahat , panu pagnagugutom n malaya pa rin , sa pagnanakaw , kci uala syang ggwin sa mga mhihirap , malayang mangarap , anu yun nkashabu lang , wow ipakain ko kya tsinelas ni korimaw koring sanchinelas , ahahAha	1	
Anu pa kaya ang ipinaglalaban nang mga ito , nagsasayang lang kayu nang pagod at sayang ang buhay ninyo na sanay malaya ninyong tinatamasa sa mundo na ito habang kayu ay nabubuhay tinoldokan ninyo ang malayang pamumuhay na walang kinatatakutan kahit sino , sayang ang buhay magbago na kayu  .	1	
Dahil tayo ay nasa malayang bansa kuno kaya malaya kang magsalita  .	1	
Hindi tayo malaya dahil sa patuloy na pag-angkin ng China sa ating nasasakupan at ang malayang pagnanakaw ng mga GAHAMAN Pulitiko sa kaban ng bayan	1	
Ito ba ang tunay na motibo ni PINOY SA PAGPASA SA BANGSAMORO BASIC LAW , ang gawing malaya ang mga rebelde malayang maghasik nang lagim , ang pumatay nang mga PULIS AT SUNDALO TAPOS ANG MGA UNIFORMS AT MGA BARIL NANG MGA NAPATAY NA PULIS IBEBENTA PA SA GOBYERNO  .	1	
Kaya pinauso ang demokrasya , para malayang mabenta ang alak at sigarilyo ng malaya at sa kayang halaga  .	1	
Mar Roxas By 2022 , nakikita ko ang isang Bansa na malaya sa kahirapan at takot at malayang mangarap	1	
Masyado na tayong naging malaya , malaya sa pagpapahayag ng saloobin , malaya na magsalita , malayang kumilos , subalit sa pagkakataon na ang kalayaan natin ay bumagsak mula sa taas , ay isinisisi natin ito sa nakatataas  .	1	
Mga kababayan wag nyo naman kalimutan na naging malaya ang pilipinas nung panahong na paalis si Marcos malayang MAGNAKAW , MAGTAAS ANG BILIHIN AT DUMAMI KRIMINAL , DROGA at hangang ngayun yan na ang problema ng bansa yan ang KALAYAANG sinasabi nila  .	1	
Nakikita ko ang bukas na malaya sa gutom , malaya sa takot at malayang mangarap  .	1	
Panahon na para magising ang mga tao , ayoko ng malaya kagaya ng kalayaan ngyn , malayang magnakaw sa kaban , mga pulis holdaper na legal , mga rapist nagkalat , riding in tandem parang manok lang kung pumatay , magnanakaw sa loob ng bahay , wala ng sinasanto at takot ang mga kriminal yan ba ang gusto nilang kalayaan  ?	1	
Sakop ng demokrasya ang malayang pagpapahayag ng saloobin diba kaya malaya ang mga mamamayang pilipino na iboto kagaya ni senador bongbong	1	
Tunay na may pagmamahal na lider pero pilit tinatago ng MEDIA gusto nila kalayaan malaya , malaya naman yata noon na nunungkulan sya pwera lang ang malayang mang bugok sa kapwa pilipino	1	
ceguro kasi khit labag sa batas malayang ginagawa o khit batas malaya din  .	1	
dahil malayang bansa tayo at lahat tayo ay may karapatan para maging malaya may kasalanan man o wala dapat bigyan ng sapat na pangangailangan	1	
dapat mabuhay tayong malaya sa lahat ng pasanin sa buhay upang malayang magamit ng Diyos  .	1	
gayunpaman , sa pagkitil sa malayang pamamahayag ay isang indikasyon na sinasakal mo ang mamamayan sa pagiging malaya  .	1	
malayang lumilipad katolad nang pilipinong malaya rin  .	1	
malayang pumatay , magnakaw , mang rape , at malaya na taung mag papahirap sa mga kapwa nating pilipino  .	1	
sa malayang bansa , kung saan malaya ang lahat ng pulitikong magnakaw  .	1	
sobra kasing malaya ang mga tao ngayon , malayang gagawa ng kasamaan sa kapwa  .	1	
walang Martial Law kaya malaya tayung mag pahiwatig ng malayang opinion  !	1	
#ligtas,	ligtas
#mabilis,	mabilisang
naisip ni superman na dahil may super speed siya , kaya nya si wonder woman ng mabilis na mabilis at di mamamalayan ni wonder woman kuya bumulusok si superman at mabilisang at umalis  .	2	
Sali na sa mabilisang batian para ikaw ay mabilis labasan ng ngiti sa mukha  .	1	
gsto k mabilis , utak wangn wang ung panay reklamo png mabilis ang kaso , un ang dapt gawin mabilisang aksyon , wag pa bagl bagal	1	
naisip ni Superman na dahil may super speed siya , kaya nyang isex si Wonder Woman ng mabilis na mabilis na di mamamalayan ni wonder woman Kaya bumulusok si Superman at mabilisang gumalaw at umalis  .	1	
naisip ni superman na dahil may super speed siya , kaya nya kantutin si wonder woman ng mabilis na mabilis at di mamamalayan ni wonder woman kuya bumulusok si superman at mabilisang kumantot at umalis  .	1	
#malinaw,	tila
Iniba lang ng kaunti ang paraan ng pagkuha at tila pa walang magiging malinaw na paper trail  .	1	
Sa Singapore tila may tutoong respect of Separation of Church and State at may malinaw na patakatan o batas kung saan maaaring Maghimasok ang gobyerno  .	1	
kung patuloy lang ang administrasyong ito sa PAGHAHANAP NG BAHO AT PUTIK ng nakaraang pamamahala , tila mananatiling WALANG DIREKSYON , walang malinaw na landas  .	1	
#episyente,	episyenteng
#matulin,	matuling
#tumpak,	tiyak
#nag-aatubili,	atubiling
#seryoso,	seryosong
@OFCALDUBAUS seryoso ang mukha ni papi- seryosong kilig  !	1	
Bkt b ganun sir ang babae gusto ng seryosong lalaki pero pag nging seryoso n tsaka babliwalain  ?	1	
Hanap ka na lang ng iba kasi parang hindi pa siya handa sa mga seryosong bagay , o sa'yo mismo siya hindi seryoso  .	1	
Kapag gusto nyo ng seryosong sagot lagyan nyo ng seryoso  .	1	
Kasi kailangan ng mga malalandi at babaero yung mga seryosong tao , malay natin pag may nakatuluyan silang gan 0n maging seryoso na sila  .	1	
Kung talagang gutom ka hindi ka aalis maghihintay ka kahit madaming umoorder at kung talagang seryosong nanililigaw ka hindi ka maggi-giveup papatunayan mong seryoso ka kahit madaming nakapila  !	1	
Mag hahanap ka ng seryosong Girlfriend e hindi mo nga magawang maging seryoso sa buhay mo  .	1	
Naging seryoso si Ryzza kasi seryosong tao ang kausap niya  .	1	
Nakakapagod man at naiisip mong hindi ka mahalata or hindi niya pinahahalagahan tandaan mo hindi lahat agad agad binibigay ang halaga kasi ang tiwala hindi basta basta binibigay ng isang tao yan may time din na ibibigay niya yon pag alam niyang seryoso ka , if i'm not mistaken madalas to sa seryosong babae kaya kahit nakakapagod sa huli masayang masaya tayo pag nakuha natin ang tiwala nila oo hindi to ganon ka connected sa conversation or whatever it is pero gusto ko lang ipaalam na wag agad tayong susuko sa taong mahal na mahal natin  .	1	
Presently i am 56 years old , ngayon ko lamang nakikita ang tapat na pamumuno dito sa ating bansa , alam kong marami rami pa rin ang nasa gobyerno na hindi seryoso sa kanilang tungkulin , pero sa seryosong pamumuno ni digong , marami ang nabago sa mahal nating bansa  .	1	
Punta kalang s tesda tol , seryoso ka naman nag tanong , pro ang iba kc d 2 hindi seryosong mag mag advise , kaya doon kna lang mismo s tesda mag tanong  .	1	
Sa aking tingin ay parang seryoso ang usapan nila , seryosong pambobola nitong si Estong  .	1	
Wag mong paglaruan ang taong may seryosong nararamdaman dahil baka dumating ang araw na seryoso kana pero sya may mahal ng iba	1	
Wala na daw seryosong lalaki , oh baka naman te di ka lang ka seryo seryoso  ?	1	
if seryoso talaga kayo when it comes to relationship at gusto nyo din ng seryosong relasyon wag muma ulit kayo makikipag sex Why  ?	1	
ikaw seryosong nagmamahal , siya naman seryoso sa pang gagago sayo  !	1	
seryoso , hindi manloloko more like seryosong manloko hayyyy hahahahahaaaaa	1	
yung time na nang gugulo ako sa chat list ko pag sinabi kong may seryosong tanong ako tapos reply nila kung kelan daw baako naging seryoso	1	
#kalmado,	kalmadong
#masaya,	masayang
KATHNIEL ang isa sa mga dahilan bakit maraming masayang tao dito sa mundo lalo na pagnakikita namin kayong masaya kath  .	2	
, and most especially po malulusog malakas at masaya , salamat po , masayang malamig lamig na mainit din po sa ating lahat	1	
10-5 Cooperative Ang pinaka masayang Section na walang Cooperation pagdating sa mga Competition pero masaya parin kasi pag dating ng Examination nagkakaroon ng Cooperation  .	1	
Ako yung unang unang tao na magiging masayang makitang kumpleto at masaya ang family mo  .	1	
Alam ko masaya sila kasama at madaming alam na masayang bagay  .	1	
Ang gusto kong treat simple lang Makita kolang masaya ang pamilya ko nasa Philippines yon na ang pinaka masayang matatangap kong treat  .	1	
Ang mahalaga yun masaya ka at may masayang familya na forever  .	1	
Ang masayang buhay kc d cla naging masaya kc d sila na kuntento eh  !	1	
Ano pa nga bang mas masayang matanggap na biyaya tuwing Pasko kundi ang isang masaya at boung pamilya  .	1	
Ansabe Pilipinas , masayang malungkot , malungkot na masaya Nasa comment yung isang link	1	
Araw araw nga masaya kyo bka nman ung masayang araw n un may kapalit n kalungkutan	1	
As a kdrama fan , masaya akong kahit hindi sila nagkatuluyan , may kanya-kanya silang masayang love life  .	1	
Bago mag-type ng comment mag-isip muna , dahil hindi porket may anak na wala na karapatan maging masaya at magkaroon ng masayang relasyon  .	1	
Bakit ba laging may ganyan king saan tayo masayang manuod right nating lahat yan wala ng pintasan salitaang hindi maganda aminin natin hindi tayo perpektong tao hindi natin masasabing wala tayong nagagawang kasalanan at nasasabing hindi maganda sa kapwa natin kaya kong saan tayo masayang nanunuod respetuhin na lng natin ang bawat isa kong saan tayo masaya dba	1	
Biniyayaan po kami ng tatlong maganda at gwapong mga anak at masaya kong itinaguyod ang masayang pamilya namin nang may respeto at pagmamahal  !	1	
Buti na nga lang po may movie na ang SefLex , masaya na ulit yung mga supporters namin , masayang pahayag ng binata  .	1	
Di ba cla masaya na nakikita nila na ang mga tao ay masayang nabubuhay sa mundo na nagmamahalan at nagtutulungan  .	1	
Everyone of us ay may kanya kanyang taong nakatakda para sa atin , sabi nga sa quotation na nabasa ko NV Lahat ng kwento ay may masayang katapusan , kaya kung hindi ka pa masaya , ibig sabihin hindi pa katapusan ng kwento mo masasaktan at masasaktan tayo kung minamadali natin ang paghahanap sa ating the right one , pero kung hahayaan lang natin si Lord na mag guide sa atin papunta kay the right one , e di hindi tayo masasaktan  .	1	
From masayang TAYO noon to masaya na KAYO NGAYON realquick  .	1	
Gusto mo laing brownout kc masayang mag PATINTERO o TAGUAN basta masaya  .	1	
Gusto nila lahat ng tao katulad nila na walang makain at walang masayang love-life kaya hindi nila magawang maging masaya para sa iba hahahahahahahahahahahah	1	
Hindi kasi sumasama si papa pag umaalis kami gusto nya lagi nasa bahay or nasa shop kaya nung sumama sya samin mag swimming lahat ay naging masaya dahil na kumpleto din kami sa isang masayang Family Bonding	1	
Hindi na masayang kumain ng lucky me pancit canton , mas masarap at mas masaya padin yung dati	1	
Iba ka talaga @Patricia022397 thank you ha , masaya kmi kasi nakikita naming masayang magkasama ang MW ngayon MAYWARD InSingapore 15DaysToGo	1	
Isang bgay lng ang aking iniisip , masayang kapiling na nila ang ating Poong Maykapal kaya masaya nating tanggapin ang kanilang paglisan  .	1	
Isip pa kasi ng isip ayaw pang mag sabi at ng matupad ng wish mong mag ka GF ngayung 2015 at ng masayang pasko mo at New Year para kami masaya din  .	1	
Ito nayata ang masayang pamilyang nakita ko na masaya , nakakatawa , my marami ding malalaman tungkul sa pamumuhay huwag sana itong iputol ang pepito manaloto ipangakong habang buhay na ang programa k love u gma	1	
Kawawa naman ang pamilya nya na sana Ay masaya pa sila at magkasama yung mga anak nya yung asawa nya baka masayang pamilya pa sila tapos pinatay lang ng walang kasalanan ng dahil lang sa pera na kanya naman sigurong pinaghirapan saklap sa pamilya to  .	1	
Kaya kung may balak kang lokohin cxa , hiwalayan mu nalang kysa paasahin mu ng isang masayang pamilya , mas mabuti pang masaktan nalang sa isang katotohanan kysa maging masaya sa isang kasinungalingan  .	1	
Kong saan kayo masayang dalawa kaming mga fan's ninyo masaya din kami para sa inyo sana Hindi kayo magbabago Kong saan na kayo nakatungtung ngaun Aldub Nation love you both  .	1	
Kung ang mag asawa ay nagtutulungan sa hirap at ginhawa , at sa kaunting mayroon ay masaya na , iyan ang masayang pamilya , ngunit kung may pamila na nag hahangad na mag karoon ng pera , at sakauntingmayroon ay hindi masaya , so ito ang wawasak sa iyong pamilya , PERA , so kung sino ang nag kakasya sa kaunti iyon ang pinag papala ng Panginoon ,	1	
Kung saan masaya ang anak nyo dapat suportahan nyo at gabayan tungo sa maayos at masayang pagsasama  .	1	
Kung sinasabi nyo na hindi ko kailangan maging ganito o maging malungkot parati dahil mas may malungkot at may pinagdadaanan pa ang ibang tao maliban sakin , parang sinabi nyo na rin na wag akong maging masaya kasi mas maraming masayang tao kaysa sakin  .	1	
Kylangn ntn pareho yan ang pera at masayang pamilya hindi rin masaya ang pamilya kpag wlng pera hndi rin masaya kung wla kng pamilya kht may pera kya parehas na kylngan yan	1	
Lahat ng kwento ay may masayang katapusan , kaya kung hindi ka pa masaya , ibig sabihin hindi pa katapusan ng kwento mo worth it ung pagbabasa ko	1	
Long day pero masaya naman I hope you all had a masayang araw	1	
Marahil lahat ng pamilya ay nagnanais ng maginhawa at masayang pamilya , ngunit kahit walang pera bastat magkakasama ay masaya na  .	1	
Mas masaya ang Pasko kapag masayang mga tao at mga bata ang masisilayan mo  .	1	
Mas masaya ang buhay kapag tayo ay masayang nagbibigay  !	1	
Mas masaya ang summer vacation dahil makakasama natin sa isang masayang hapon ang Hi-5 Philippines  !	1	
Nag-expect ako ng masayang high school life dahil sabi ng iba , masaya daw  .	1	
Nkakawala ng pagod ang showtime masayang pno 0rin kc masaya at masigla lhat ng mga host  .	1	
Oo nga walang masaya pag wala nun dun din nabubuo ang lahat ng masayang nakaraan	1	
Pag good night masaya kasi tagalog ng good night masayang gabi haha  .	1	
Pagkatapos ng kanyang performance , masayang humarap si Michael Christian Martinez sa buong manunood na masaya at proud na maging Pinoy  !	1	
Sa mga ofw kasi malaman lang natin na nakakapag aral sa skwelahan at kumakain tatlo o higit pa sa isang araw ang mga mahal natin sa buhay Masaya na tayu , wala man tayung limpak lipak na dolyares atleast masaya naman tayu sa payak at masayang pamuhay mula sa marangal nating pag susumikap di po ba  !	1	
Sana Kahit paano naging masaya ka na naging bahagi ako ng masayang mundo mo , na kahit wala na ako MAALALA mo na minsan may isang simpleng pasaway ng naging istorbo sa buhay mo	1	
Sana kahit paano naging masaya ka na nakilala mo ako , na naging bahagi ako ng masayang mundo mo , na kahit na wala na ako MAALALA mo na minsan may isang simpleng pasaway na naging istorbo sa buhay mo  .	1	
Sana khit paano naging masaya ka at nakilala mo ako , na naging bahagi ng masayang Mundo mo na khit wala na ako MAALALA mo na minsan may 1sang simpleng pasaway na nging istorbo sa buhay mo  .	1	
Sana nga forever na kayo Sana nga kayo na talaga para hindi masayang yung friendship at relationship na nasira , masaya na ako ngayon para sainyo Future F  .	1	
#karaniwan,	kadalasang
Sobrang buhok sa mukha o katawan karaniwan sa mga parte na kadalasang walang buhok ang babae , tulad ng sa ibabaw ng labi parang bigote o sa dibdib 6  .	1	
#paminsan-minsan,	paminsan-minsang
#kaagad,	kaagad
#propesyonal,	propesyonal
#halata,	halatang
1 , slamat PEP khit n halatang byaran k ng abs at yang KANTAR n yan pra ndi halata	1	
@OFCALDubKoTo d halatang egxoyted tisoy d tlga halata	1	
@angelamaygrc halata ko nga be halatang daming pinagdaanan ha	1	
Alam mo si heart di plastik na tao halata saknya na napilitan lng dahil ang iniinterview nya halatang sinungaling  .	1	
BOYS kasi , ang pag seselos ng boys indi halata , kya indi rin halatang nasasaktan  .	1	
Ba't halatang wla namang gusto si Alden ke Maine mesyedow nmang halata ba't gano'n niloloko lang ng mga fans ang sarili nla sa kilig wes nman at kitang kita sa sapilit ang kiss anyari nwala na ang magic ng Love kuno	1	
Gets ko , ung mga butas sa bilog sa pants ng tatay nilagay sa anak para di halatang cra cra ung pants ni tatay , at para di rin halata na butas pantalon c anak  .	1	
Haha dun kc sila naniniwala sa kantar eh halata naman kantarantaduhan ang ratings nun kaht my bagyo 40percent parin sila sa kantar halatang gawa gawa di katulad ng agb na talagang pinagkakatiwalaan	1	
Halatang halata ka guingona ah ka allies mo lng parang halatang paninira lng yung pagaakusa kay binay niyan  ?	1	
Hay nako wag na nyang maglokohan , masyado ng scripted at halata , wag ng ipilit ang ayaw , palabasin na kc HND nya deserve halata LNG na bago pumasok yang talent nyo halatang pinagaralan na lahat at pati kayo , may ayaw tlga alabasin Nung last week yang talent na SNA nla ang nakalabas kaso sinama nanaman no ayung iba na kahit tig 2pts LNG nla eh cnalo cla PRA masave nanaman sya , kung ako ang taing bayan wla nlng manunuod at magtangkilk all I thought thus is reality show , gosh  !	1	
I saw them sa buzz last sunday halata naman talagang nag pretend c diana na ok , at yung lalaki halatang guilty bakla nnakit ng babae kapal ng mukha  .	1	
Kaya kay kuyang grabe umakbay naiintindihan kita kasi halatang sabaw ka talaga at halata sa mukha mo ang kahihiyan  .	1	
Msarap un pulutan s kanto Yeyks Sarap 2 n sarap c frnd ko s kknguya ng mapansin nyang d n crunchy c 0rn k 0ndi cigar butts ewwW mula nun sinumpa n ung safari Tz ung isa s sardinas K 0nteng tela n halatang pinagtali s sugat tz halata p dw ung mantsa ng dugo Ewan k lng anu brand ng sardinas un	1	
Naloloka ako s height ni suga di kasi halata pramis lalo na sa save me di halatang 5'9 height niya	1	
Niluluto na ang pag kapanalo ni maymay , kitang kita padalak lageng mayward ang panalo pangalawa lang ang kissyong samantalang lampaso ni kisses sa voting si maymay , halatang niluluto talaga para pagdating ng BN d halata ang pandaraya  !	1	
Noong umagang iyon ay halatang hindi siya pagod , noong nakaraang araw ay halata kasing puyat siya pero ngayon ay parang bagong gising pa yata  .	1	
Oo halatang favoritism ka pero sana naman hinaan masyado , halata na eh  .	1	
Saka yung mga addict pow sana wag na kayong mag comment halata kayo dto ehh addict din ma ka comment halatang di nag iisip  .	1	
Siguro kinahihiya na yan ng pamilya nya kasi halata eh walang plataporma sa pagiging public servant , halatang bayaran ba Yong tipong nanggugulo lng para may pagUsapan  .	1	
at para di halata hahaluan nila ng kapuso artist para di halatang bias  !	1	
bigyan nang jacket tapos hataw mo sa mukha mo yung jacket atlist alam nang mga tao na scripted yung sa ALDUB sakanila halatang script ayaw pang aminin aahahaha halata naman tapos binubugaw pa ni vice si pastillas girl eto pa matindi si pastillas pang kantutan lang yan si maine nakatapos i kumpara mo sa rili mo kay maine ahahah pastillas ano natapos mo	1	
halata naman eh ika nga kahit grade 1 lang natapos eh halatang may pinipili ang hustisya sa pinas  .	1	
halatang dismayado , desperado , stress ang mukha , halatang hindisya masaya nakasama nya ang mga hindi nya ka alyado ayan ohh halata talaga oh ung ngiti prngngiti ng nandidiri  !	1	
halatang natatakot niyang tanong , halata kasi sa boses niya  .	1	
halatang naturuan na at pati Diyos isasangkalan pa sa ganyan e halata naman na alam niya iisa lang ang kahulugan noon at alam niya  .	1	
halatang pulitika hindi tulong , damit pa lang sobrang halata na , pwe	1	
hindi naman mga original halatang FAKE kahit pa sabihin mong overruns yan dapat halata pa din sa logo or may mga konting scratches lang pero hindi eh  .	1	
i asked them kung gwapo ba , sabi nila oo gwapo daw bakit daw bigla umiba taste ko and napalingon daw ako sa totoong gwapo hindi yung gwapong tambay lang daw sa kanto kaso daw halatang may gf na , then i said to myself na oo nga halata naman din may gf na talaga  .	1	
ito nmang si robert garcia ayaw tumigil kasasalita halatang nang iinis , e halata nmang sipsip kahit wala sya kaya ng FILIPINO FLASH yan  .	1	
kac c julia kayang mkipag sabayan xa mga mas naka 2tanda xa kanya , c kathryn naman eh halatang batang bata pa , halata xa pag arte , c julia kya pa niang gampanan lahat ng maggng karakter nya , c kathryn halux puru l 0ve story ang alam gawn , d pa halatang nag madjurd na xia eih ,  .	1	
kunyari kapa pingris patay malisya kapa diehard pf fans pa nman aq kaso nilinlang nyo kami e halatang nagsipag rehearse kayo ng ginebra bago pa ang game sobrang halata yung ginawa nyo ng ginebra sa mga fans nyo	1	
lol halatang hindi maganda pag gawa nito halata behind green screen lol at least make abit more real sumabog na nga ang linis parin ng mga damit nila kunti lang ang dumi sa katawan  .	1	
ngek , nahilo kami sa mga sagot mo , ang layo sa pinag uusapan , halatang inililigaw mo at halata ang pag sisinungaling mo day , ay ambot saimo  .	1	
one time around 2 59 nagising ako , syempre unang titignan ko ung orasan pero dahil madilim kukunin ko sana ung phone ko na nakacharge tinignan ko kung asan ung phone ko ng biglang , may nakaputi , halatang damit ng babae , medyo matangakad at halata mo ung kamay niya , tinignan ko ito pataas , bigla akong pinagpawisan pero nakaharap pa xkn ung electricfan  .	1	
pero halata namang d scripted noh duhhh wala sa script and halatang hatala na nagulat si karylle	1	
pero halatang kay Mar lang ang matino hahaha xD wag masyadong halata abs  .	1	
sus , halatang may anomalya pilit pang i-deny , halata na nga eh  .	1	
uy pliers talaga oh nakaupo para hindi halatang sakang naka side view para hindi halata wHAT DO U FUCKING WANT HER TO DO  ?	1	
yung interview kay deniece sa chanel 7 , halatang nagsisinungaling sya , sa kamay pa lang halata na di sya confident , at di nagsasabi ng totoo , parang nakikipagdebate , mali yung answer sa question ahahaha  !	1	
#bigla,	biglang
Tapos bigla mo siyang nakita , then biglang nag-flash back lahat ng mga memories niyo together  .	5	
Nagpalakad lakad siya para pakalmahin sarili niya , at dun na biglang lumabas sila Kats para pakalmahin si Dj , nagtatatalon sila , bigla na ding lumabas si Kath at pinakalma si Dj , inakbayan na lang ni Dj si Kath at tumalon na rin , binigay ni Dj yung mic kay Khalil para siya na lang yung kumanta , naiinis siya eh  .	3	
6 parang syete din , pero mas matagal bago mo napansin , usually nung biglang nag-iba manamit , o bigla mong nabosohan at nasilip mo na uy shet PWEDE  !	2	
Hanggang sa parang huminto ang Mundo ko bigla , nawala ako sa mood tinapos ko bigla yung work ko at biglang umuwi , may usapan pa sana kami ng mga workmates ko na kakain after work pero bigla akong nawala , Pinatay ko yung cellphone ko para di nila ako macontact  .	2	
Kaya nga phenomenal star dahil biglang sikat , pati ang ratings ng Showtime ay bigla ding tumaas dahil kay vice  .	2	
Kumakalat ngayon online ang video ng isang beki na naka-sexy attire at bigla na lang hinaharangan ang mga dumadaang sasakyan para biglang sayawan  .	2	
One time nag-kaayaan mga JBAC team na magunwind after ng duty closing time tapos biglang sa hinde inaasahang pagkakataon bigla nalang akong nag-tanong kung sino ba ang crush nya sa JBAC ewan ko ba hinde naman kami close at first time lang namin nagusap that time para lang mag bumulong sakin na tanungin ko sya bigla ba naman nyang sinabi ako daw  .	2	
Pagkasakay pa lang nya eh bigla nya hinulog sa harap ko yung 5 peso coin and biglang sabi na boss yung barya nahulog  .	2	
Tapos bigla mo siyang nakita , biglang nag-flash back lahat ng mga memories niyo together  .	2	
09 / 24 / 15 Yung tipong nakatulala ka tapos bigla siyang dadaan sa harap mo with matching slowmo tapos biglang lingon sayo  .	1	
15 yun ng bigla kong mag laro biglang pag jump eh di na sya na laglag tapos mayamaya nasira yung app  .	1	
@ALDUBNation How come na biglang Less than 1M na lang bigla ang lamang  ?	1	
@RyuTedder @sabishihan same huhu but bigla ko naisip parents ko biglang lumakas ulit loob ko	1	
@UDJJLP Nagttweet ako tapos biglang sanaaaaa dalawa ang puso koooo napatingin ako bigla sa tv  .	1	
@boishette nung me itatanong na sya salin bigla ko syang iniwasan ulit nung umpisa naman di ako ganun kaso nunh biglang inopen yun , yun na	1	
@magnayeaaron @bryanremosas hahahaha bigla ngang nagbago ihip ng hangin nung nagsenior high biglang naging seryoso lahat  .	1	
@trvmnblack Yes bigla umakyat lahat ng teachers at stufents habang nagpapapractice kmi tas biglang sabi magpw perform daw bawat grade	1	
@xxxheartbeats pagkabasa ko to bigla nlang gumuho mundo ko at biglang bumilis yung tibok ng puso ko yun pla jk lng	1	
ALAM MO YUNG feeling na nagpapahinga ka tapos biglang dadating yung bestie mo tapos bigla kang yayayain  .	1	
Abay meron pong biglang pumasok sa kwarto ko at bigla nalang humilata hahahaha like a boss	1	
Admin Grys Part 4 grabe , ng bigla kong naisipang tumambay dito sa BBKACCM kasi nga biglang tumumal sa INKA , nakita ko andito rin sya , sabi ko pa nga  .	1	
After school , tahimik at mag isa kang naglalakad pauwi nang biglang may nasalubong kang batang pulubi at nanghihingi sayo ng pagkainin at bigla mong naalala na may isa ka paplang Quake Overlaod n natira sa iyong bag kinuha mo iyun at ibingay sa batang pulubi  .	1	
Akala ko ito na , akala ko ikaw na Pero hindi , bakit bigla kang nawala , bakit biglang nag-iba Nasaan na , Wala na ba talaga  ?	1	
Ako din umiyak n tlga biglang abot ni Alden ung komot natawa ako bigla mga kalokohan ng dalawa tlga	1	
Ako doc lagi masakit balikat ko pero bigla naman ito nawawala pero umuulit uli walang lakas minsan biglang bumabagsak pag tibataas ko  .	1	
Ako lang nakakita dahil nakatalikod sa kanya yung mga kaibigan ko ng biglang kumuha si manong ng plastic cup , nagtaka ako eh kasi wala naman bumili kaya naisip ko na baka gusto nya kainin yung tinda nya pero biglang tinapat niya kay junior at nilabas bigla , walang hiya putangina  !	1	
Alam mo bang bigla ka na lang pumasok sa isip ko p tapos biglang nagpop-up name mo sa notif q sa fb ang galing iMissYou @katkat06	1	
Alam mo yung biglang daming tao tapos bigla ding umalis lahat so ang tahimik ng bahay  .	1	
Although kami yung same block with a few added people , nagkaroon kami bigla ng unity , parang biglang nagkaroon ng teamwork yung block namin  .	1	
Always pray ; naranasan ko din yan ako naman natutulog sa bahay ng tita ko mga 1am yun tapos gising ako ang panaginip ko nun ay nasa isang ilog daw ako at bigla nalang ako lumbog ng napaka lalim at gusto ko gumising hndi ako maka gising at bigla nalang ako hndi maka hinga at biglang dumilat ang  .	1	
Andaming mga taong parang mushroom out of nowhere biglang susulpot then mawawala din bigla parang bula	1	
Andyan kmi kitang kita nmin pano inanod yun tatlong namatay bigla kc lumakas ang current yun malinaw n tubig biglang naging kulay chocolate  .	1	
Ang mas malala , nawala bigla yung usapan , ung mga boses biglang nawala  !	1	
Ang sakit sa heart kasi prepared ako pero biglang nag-wander yung utak ko so nung bigla akong tinawag ayun , nganga	1	
Ang saya saya ko na nagka-Internet na kame , tapus biglang nagChat si EX bigla din NAGBROWN-OUT- Anung ibigsabihin nun  ?	1	
Ang tagal ng katahimikan sa lab kasi nagsasagot sila ng exer then bigla akong nagsalita for some reminders biglang may nagulat at sumigaw	1	
Ano ang ma feel niyo na gusto niyong kainin ang mang juan tapos may biglang mag sabi na huwag at after lunch mo bigla niyang sabi na kainin na natin ang mang juan  .	1	
Ano pong saklo Yung dumadaan na mga parang lagayan nang bato , diretso nun sa may Rizal Cement pero dati pang wala yun , dami na kasi naganap na aksidente kasi yung iba , biglang nalalag ung daldalang bato , yung iba naman , bigla na lang titigil , kaya tinigil na din ni mayor yung operasyon nun  .	1	
Anong pagkukulang ko , Oh bakit bigla mo nalang nilisan Di ko maintindihan Ikaw ay biglang nagpaalam  .	1	
Assurance na hindi magsasara bigla ang review center dahil biglang kumonti ang enrolees  .	1	
At nag hintay tapos bigla sya lumabas sa kwarto nya at tumabi sakin tapos biglang hinwakan kamay ko at tinanong kung gusto ko daw sya sabi ko nmn mag pinsan tayo pero sabi ng puso ko parang iba eh parang dahil sa palagi ko syang dinadalaw eh iba ang nararamdam ng katawan ko kontra sa isip ko eh hanggang sa mga sumunod na araw eh parang magugustohan ko nga sya  .	1	
At nun dumating c Maine sa buhay nya dun biglang na boom career nya at in bigla  .	1	
Ayoko sa lahat yung biglang hindi ako itetext ng ilang days or weeks tapos bigla ka imemessage like nothing happened	1	
Ayyy hinimatay bigla c girl crying emote pa naman tas biglang propose ganun  !	1	
BBM Well something is happening because at that point in time biglang nagbago hindi dahan-dahan na pagbabago kundi bigla at minsanan  .	1	
Baby Choco Choco Yung biglang nag FASTFORWARD ako bigla  ?	1	
Baka biglang my kurot at hampas ka bigla	1	
Bakit nag lalag bigla sa mga online games tapos biglang nawawala  .	1	
Bakit naman ganun ate girl every time comeback ng oppas ko biglang andun ka din bigla lol k bye	1	
Bat biglang nawawala yung mga tweets ko and bigla na lang nauunfriend yung iba kong friends sa fb  ?	1	
#tipikal,	kadalasang
#Madalang,	madalang
Madalang lang ang asong nagdadiet at madalang lang ang lalaking matino  .	5	
#mabagal,	dahan-dahang 
