#Tokio,	Japan
#Helsinki,	Finnland
#Madrid,	Spanien
Madrid ist die Hauptstadt von Spanien	2	
Es ist auch nh Unterschied zwischen Madrid und Barcelona , ist trotzdem Spanien	1	
Haja man aber auf was ich mich freue wenn mir in Final spiel gegen Real Madrid spielen und das in Spanien mega geil man	1	
Ich flieg mal mit dir nach Spanien und dann k nnen wir ja ein real Madrid spiel schauen	1	
Madrid ist die hauptstadt von Spanien aber wieso ist dann doch auch Barcelona einezeichnet	1	
#Paris,	Frankreich
Also wir fahren übernacht durch und in Paris sind wir in ner jugendherberge und in Frankreich dann ja auch	1	
Das is halt wieder die andere Geschichte Ja definitiv schon filmcharakter Aber ansonsten sehr lahm bei cod 2 war die Normandie so heftig umk mpft hier war das einfach ein run Die Panzerschlacht in Frankreich war stark In Paris das Battle war geil Die sneaky mission mit der roussue war cool Aber das Ende g hnend langweilig	1	
Die ist alleine oder mit einer Freundin in Frankreich die hat heute Storys gemacht von Haxton und Paris	1	
Frankreich lohnt sich nicht wirklich nur mal ein tag Paris oder so und England war ich glaube auch noch nicht	1	
Tamara Oh nein wir holen sachen aus Paris nimmt nagisas arm und teleportiert sie nach Frankreich	1	
Zum Thema Frankreich hast du mal Paris gesehen , das ist schlimm	1	
#Havanna,	Kuba
#Teheran,	Iran
#Kairo,	Ägypten
#Islamabad,	Pakistan
#Bern,	Schweiz
Ein stiefvater arbeitet in die Schweiz , in der N he von Bern	2	
Hauptsache der Pisser muss dann seine eigene schei Praxis in der Schweiz machen und das auch noch in Bern  .	1	
#Canberra,	Australien
#Berlin,	Deutschland
Berlin ist meine zweit liebste Stadt in Deutschland  .	1	
Das gr te Einkauf Center Deutschland bis Mall of Berlin kam was dann zum gr ten Europas wurde	1	
Gut dann bis morgen und einen guten Start ins Wochenende in Berlin und hat sich auf dem Weg nach Deutschland zu kommen weil wir freunde sein aber ich	1	
In gewisser Hinsicht ist das Onlineshopping auch sicher , denn was für Gefahren in den Innenst dten lauern sieht man ja am Anschlag in Berlin und anderen St dten in Deutschland und der Welt  .	1	
Ja Berlin ist die Hauptstadt aber auch die gr te in Deutschland Ankara ist die hauptstadt doch Istanbul ist die gr te stadt oder wieso sind bei russland die zwei Punkte einfach nur weil schilabins ziemlich gro ist und wieso ist wol bei Irland keine hauptstadt drinne  ?	1	
Ja f nde ich auch nicht schlecht dann kenne ich schon mal jemanden und das Vegane Angebot in Berlin soll auch sehr gut sein und es gibt so ein Veganes Stra enfest und wenn Stars nach Deutschland kommen , dann gehen die meistens auch immer nach Berlin	1	
Ja f nde ich auch nicht schlecht dann kenne ich schon mal jemanden und das Vegane Angebot in Berlin soll auch sehr gut sein und es gibt so ein Veganes Stra enfest und wenn Stars nach Deutschland kommen , dann gehen die meistens auch immer nach Berlin dann muss ich nicht mehr hin fahren	1	
Ja f nde ich auch nicht schlecht dann kenne ich schon mal jemanden und das Vegane Angebot in Berlin soll auch sehr gut sein und es gibt so ein Veganes Stra enfest und wenn Stars nach Deutschland kommen , dann gehen die meistens auch immer nach Berlin dann muss ich nicht mehr hin fahren hat schon echt Vorteile	1	
Ja f nde ich auch nicht schlecht dann kenne ich schon mal jemanden und das Vegane Angebot in Berlin soll auch sehr gut sein und wenn Stars nach Deutschland kommen , dann gehen die meistens auch immer nach Berlin	1	
Oh ich vermisse Deutschland Und auch mein Berlin	1	
Ok schade Berlin ist meine zweit liebste Stadt in Deutschland	1	
Tickets kann heute ab 10 Uhr kaufen , und ich kann mir vorstellen dass die ziemlich schnell weg sein k nnten weil die Halle wohl nicht so gro ist und das in Berlin das einzige in Deutschland ist	1	
#Kabul,	Afghanistan
#Athen,	Griechenland
Und dieses Jahr im April , geh i 6 tage Griechenland , 3 tage Athen , 3 Tage Santorini	1	
#Moskau,	Russland
Moskow Moskau werft die Gl ser an die wand Russland ist ein sch nes Land hahahaha HEY	2	
Er is in Russland geboren worden um genau zu sein in Moskau	1	
#Stockholm,	Schweden
Aber Schweden ist trotzdem geil und Stockholm voll die sch ne Stadf	1	
In Schweden hat Melfest in der Friends Arena in Stockholm stattgefunden da wurde der ESC 2016 ausgetragen und die Halle war proppenvoll , das hei t 11  .	1	
#Ottawa,	Kanada
#Rom,	Italien
Also da gibt es meinen Opa in Spanien wo ich schon ganz oftvalleine hingeflogen bin und die Tante in Rom wo ich achin war dann Frankreich Schweiz D nemark 4mal Amerika Italien Norwegen	1	
ohne meine L nder oder Deutschland ich liebe am meisten kasachstan und danach kommen Norwegen , gypten , kanada , Türkei und Italien St dte Damaskus , Paris , Astana , Rom , Athen , Aleppo , K ln und Ottawa	1	
#Hanoi,	Vietnam
#Peking,	China
#Bangkok,	Thailand
#Oslo,	Norwegen
Bis jetzt super Skifahren in Norwegen und heute und morgen noch Oslo	1	
#Bagdad,	Irak
#Funafuti,	Tuvalu
#Madrid,	Spanien
Madrid ist die Hauptstadt von Spanien	2	
Es ist auch nh Unterschied zwischen Madrid und Barcelona , ist trotzdem Spanien	1	
Haja man aber auf was ich mich freue wenn mir in Final spiel gegen Real Madrid spielen und das in Spanien mega geil man	1	
Ich flieg mal mit dir nach Spanien und dann k nnen wir ja ein real Madrid spiel schauen	1	
Madrid ist die hauptstadt von Spanien aber wieso ist dann doch auch Barcelona einezeichnet	1	
#Paris,	Frankreich
Also wir fahren übernacht durch und in Paris sind wir in ner jugendherberge und in Frankreich dann ja auch	1	
Das is halt wieder die andere Geschichte Ja definitiv schon filmcharakter Aber ansonsten sehr lahm bei cod 2 war die Normandie so heftig umk mpft hier war das einfach ein run Die Panzerschlacht in Frankreich war stark In Paris das Battle war geil Die sneaky mission mit der roussue war cool Aber das Ende g hnend langweilig	1	
Die ist alleine oder mit einer Freundin in Frankreich die hat heute Storys gemacht von Haxton und Paris	1	
Frankreich lohnt sich nicht wirklich nur mal ein tag Paris oder so und England war ich glaube auch noch nicht	1	
Tamara Oh nein wir holen sachen aus Paris nimmt nagisas arm und teleportiert sie nach Frankreich	1	
Zum Thema Frankreich hast du mal Paris gesehen , das ist schlimm	1	
#Nassau,	Bahamas
#Maputo,	Mosambik
#Teheran,	Iran
#Vientiane,	Laos
#Bamako,	Mali
#Ankara,	Türkei
#Vaduz,	Liechtenstein
#Asmara,	Eritrea
#Roseau,	Dominica
#Duschanbe,	Tadschikistan
#Sofia,	Bulgarien
#Bukarest,	Rumänien
#Tunis,	Tunesien
#Lusaka,	Zambia
#Quito,	Ecuador
#Khartum,	Sudan
#Montevideo,	Uruguay
#Antananarivo,	Madagaskar
#Kiew,	Ukraine
#Rom,	Italien
Also da gibt es meinen Opa in Spanien wo ich schon ganz oftvalleine hingeflogen bin und die Tante in Rom wo ich achin war dann Frankreich Schweiz D nemark 4mal Amerika Italien Norwegen	1	
ohne meine L nder oder Deutschland ich liebe am meisten kasachstan und danach kommen Norwegen , gypten , kanada , Türkei und Italien St dte Damaskus , Paris , Astana , Rom , Athen , Aleppo , K ln und Ottawa	1	
#Hanio,	Vietnam
#Damaskus,	Syrien
#Oslo,	Norwegen
Bis jetzt super Skifahren in Norwegen und heute und morgen noch Oslo	1	
#Vilnius,	Litauen
#Algier,	Algerien
#Taschkent,	Usbekistan
#Tokio,	Japan
#Helsinki,	Finnland
#Dublin,	Irland
#Chișinău,	Moldau
#Managua,	Nicaragua
#Paramaribo,	Suriname
#Bischkek,	Kirgisistan
#Kario,	Ägypten
#Amman,	Jordanien
#Budapest,	Ungarn
#Doha,	Katar
#Astana,	Kasachstan
#Kabul,	Afghanistan
#Monrovia,	Liberia
#Dhaka,	Bangladesch
#Mogadischu,	Somalia
#Bujumbura,	Burundi
#Valletta,	Malta
#Nouakchott,	Mauretanien
#Kingston,	Jamaika
#Beirut,	Libanon
#Peking,	China
#Bangkok,	Thailand
#Harare,	Simbabwe
#Maskat,	Oman
#Bagdad,	Irak
#Conakry,	Guinea
#Tallinn,	Estland
#Georgetown,	Guyana
#Taipeh,	Taiwan
#Rabat,	Marokko
#Jerewan,	Armenien
#Havanna,	Kuba
#Thimphu,	Bhutan
#Nuuk,	Grönland
#Baku,	Aserbaidschan
#Kigali,	Ruanda
#Dakar,	Senegal
#Suva,	Fidschi
#Belmopan,	Belize
#Banjul,	Gambia
#Athen,	Griechenland
Und dieses Jahr im April , geh i 6 tage Griechenland , 3 tage Athen , 3 Tage Santorini	1	
#Riga,	Lettland
#Zagreb,	Kroatien
Kroatien w re auch gut wir haben in Zagreb haben wir ein haus	1	
#Skopje,	Mazedonien
#Aşgabat,	Turkmenistan
