#ehrlich,	unehrlich
Trotzdem hast du mir gesagt das du niewieder so viel trinken willst ja und ich hab dir vertraut und dz spielst damit als w re ich nichts aber ich glaube das bin ich bei dir sowie so schon aber ganz ehrlich wenn menschen zu mir unehrlich sind hab ich auch kein Bock was mit den zu machen	1	
Uch bin absolut ehrlich , aber das kappierst Du nicht , weil ich in Deinen Augen unehrlich bin  .	1	
Wenn ich ganz ehrlich bin nein aba seien wir unehrlich weils lustig is	1	
#überzeugt,	unüberzeugt
#wettbewerbsfähig,	wettbewerbsunfähig
#bekannt,	unbekannt
Kein Plan aber ist ja alles unbekannt oder nur lokal bekannt	1	
#eindrucksvoll,	unscheinbar
#möglich,	unmöglich
#entschlossen,	unentschlossen
#einheitlich,	uneinheitlich
#ethisch,	unethisch
#informiert,	uninformiert
#gemütlich,	ungemütlich
Ja hasse es danm voll , ans Ladekabel zu gehen wan so gemütlich ist und dann wieder ungemütlich	1	
Wie machsch du des das des wie Titten aussieht und sag nie wieder ich bin ungemütlich weil meim brustkorb isch gemütlich weil der voll verbiegba idch und weils Lutz gsa hat umd des blaue isch meine Brust  .	1	
#möglich,	unmöglich
#logisch,	unlogisch
Danke Mascha unsere unlogisch Logik die eigentlich logisch is weil sie unlogisch is  .	2	
Au erdem ist weniges von dem was ich fühle logisch oder n tig , das meiste ist unn tig , unlogisch und somehow	1	
Der klingt für mich logisch aber ist eigentlich voll unlogisch	1	
Geht nicht , Das kann man nicht logisch erkl ren , weil es unlogisch ist  .	1	
Irgendwie ist des unlogisch was ich gemacht hab aber irgendwie logisch	1	
Ja das logische in diesem satz ist inder tat ziemlich logisch aber wenn man dann unlogisch denkt kommt er einen wieder logisch vor	1	
Ja es ist logisch aber es ist unlogisch das wenn du online bist meine Nachrichten nicht liest	1	
Weis nicht was daran unlogisch war ich fand logisch	1	
nenene in crimmitschau is es auch stock duster schau auf die zeit is unlogisch also verarsch mich ne w re logisch würde crimmitschau am andern ende der welt liegeb	1	
#effektiv,	ineffektiv
#ergiebig,	unergiebig
#angenehm,	unangenehm
Jenny ihre Augen weiten sich bei seiner Erz hlung und ihr Herz schl gt schneller , aber nicht so angenehm wie wenn man verliebt ist sondern schmerzhaft und unangenehm , ihr Blick weicht von seinem zu den Flie en auf dem Boden , zieht die Muster mit den Augen nach Ist schon gut  .	1	
#verantwortlich,	unverantwortlich
#angenehm,	unangenehm
Jenny ihre Augen weiten sich bei seiner Erz hlung und ihr Herz schl gt schneller , aber nicht so angenehm wie wenn man verliebt ist sondern schmerzhaft und unangenehm , ihr Blick weicht von seinem zu den Flie en auf dem Boden , zieht die Muster mit den Augen nach Ist schon gut  .	1	
#geschmackvoll,	geschmacklos
#glücklich,	unglücklich
Ich m chte dich nicht unglücklich machen , ich m chte dich glücklich machen	4	
Och schatz h r doch auf dir sowas einzureden du bist perfekt so wie du bist und ich will glücklich mit dir sein und niemanden haben der immer unglücklich ist den dafür hast du keinen Grund schatz	3	
Aber was soll ich den denken wenn du immer glücklich aussiehst ohne mich und unglücklich mit mir	2	
Als ich versuche , alle andere glücklich zu machen , mache ich mich in diesen prozess unglücklich	2	
Besser Single und glücklich als vergeben und unglücklich	2	
Ich Versuche jeden meiner freunde glücklich zu machen auch wenn es mich unglücklich machen k nnte Besonders stark ist es bei Leuten die ich liebe , wie zb Lucy  .	2	
Ich sehe dich in meinen tr umen mit anderen wie du glücklich bist und die mit dir , manchmal sehe ich dich und mich aber unglücklich  .	2	
Ich war so glücklich mit einem jungen zusammen war aber jetzt bin ich unglücklich aber dieser junge wei	2	
küsst dich wenn du schmollst hei t es du bist Unglücklich und wenn du unglücklich bist geh ich davon aus das ich dich nivht glücklich machen kann	2	
wenn ich glücklich bin nich wenn icb unglücklich bin warscheinlich nich aber vllt 2  .	2	
Aber er hat sie unglücklich gemacht und mit dem sie vereihrate war war sie glücklich  .	1	
Aber ich werde alles in meiner Macht stehende tun damit du glücklich bist , vielleicht nicht alles auf einmal aber manches blaues unglücklich muss will ich beseitigen	1	
Aber leider ist das bis jetzt immer so gewesen ich habe mit all meinem wissen und Taten geholfen , meine Freundinnen waren glücklich und haben mich dann weggeschmissen und am Ende sind sie wieder unglücklich geworden	1	
Aber leider ist das bis jetzt immer so gewesen ich habe mit all meinem wissen und Taten geholfen , meine Freundinnen waren glücklich und haben mich dann weggeschmissen und am Ende sind sie wieder unglücklich geworden Die Hoffnung habe ich bei Rya auch , so wie du bei leo	1	
Aber wenn er da glücklich is sokk er lieber da bleiben will ihn ja net unglücklich machen	1	
Aber willst du lieber glücklich ohne mich oder unglücklich mit mir  ?	1	
Aber würde ich nicht danach streben und einfach unglücklich sein k nnte ich genauso wenig glücklich werden	1	
Also liebe ist hart tut weh kann glücklich machen aber so macht es unglücklich  .	1	
Ausserdem bin ich doch am Wochenende immer bei dir au er jz dieses eine mal merkst du eig was du mir da vorwirfst genauso wie des aller schlimmste für dich das du ned merkst das du mir des aller wichtigste bist für dich verzichte ich auf schlaf für dich bring ich immer Schokolade und essen mit ich will dich immer glücklich machen aber Wahnsinn zu sehen wie unglücklich du in Wirklichkeit mit mir	1	
Bist du nicht mehr glücklich mit mir fühlst du dich nicht mehr wohl bei mir mach ich dich unglücklich  ?	1	
Bro wenn du unglücklich bist geh zu der zurück wo du glücklich mit warst	1	
Das einzigste womit du mich verletzten würdest ist wenn du etwas tust oder auf etwas eingehst was dich unglücklich macht bzw wo du unglücklich bist , denn ich m chte das es dir gut geht und du glücklich bist und nicht leidest  .	1	
Das was ich gerade am meisten m chte is dich glücklich zu sehen , wenn es dich unglücklich macht mir deine liebe zu offenbaren , dann sei es so  .	1	
Du hast es definitiv verdient glücklich zu sein nur du machst dich selbst unglücklich wenn du so lebst	1	
Du w rst nicht glücklich weil ich gerade wieder unglücklich bin	1	
Es gibt immer eine Kleinigkeit glücklich zu sein und eine unglücklich	1	
Es klingt hart aber verschwende keine Zeit wo du unglücklich bist und nutze die zeit um glücklich zu werden  .	1	
Eyyy wenn du sie unglücklich machst nh dann wirst du keinen glücklich Tag mehr in deinem ganzen leben haben kapiert	1	
F llt mir das mega schwer jetzt wenn ich sie sehen werde das ich glücklich bin da ich nicht will das einer vin euch unglücklich ist	1	
Faken also wie zb wenn ich unglücklich bin und so tue als w re ich glücklich	1	
Glaube an das was dich glücklich Macht und nicht an das was dich unglücklich macht	1	
Hat sie immoment mit irgendwas zuk mpfen was sie mir nicht gesagt hat oder so halt ich wei es um erlich zu sein auch nicht was das Problem ist ob sie glücklich ist oder mich liebt und unglücklich ist ich wei es halt echt nicht	1	
Hey Bebi du brauchst nur denken dass du mich brauchst und ich bin für dich da egal wie egal wo ich werde immer alles versuchen dass es dir besser geht und du glücklich bist ja und selber dich nicht mehr unglücklich machen du bist doch mein M dchen	1	
Ich Versuche jeden meiner freunde glücklich zu machen auch wenn es mich unglücklich machen k nnte	1	
Ich bin grade so unglücklich Und dabei sollte ich doch eigentlich glücklich sein	1	
Ich bin grade so unglücklich Und dabei sollte ich doch eigentlich glücklich sein Aber das mit marco zieht mich voll runter	1	
Ich bin im Moment richtig unglücklich aber es macht mich glücklich andere Leute zum lachen zu bringen  .	1	
Ich bin so oft glücklich , aber wieder dann so unglücklich , weil ich über zu viel nachdenke und mir das nicht aus dem kopf geht	1	
Ich bin zu 50 glücklich und zu 50 unglücklich  .	1	
Ich habe das dann falsch verstanden , dachte du w rst unglücklich , war nicht meine Absicht sorry , wenn ihr 2 so glücklich seid ist das ja auch gut so , habe das echt irgendwo was falsch verstanden	1	
Ich ja , aber wie gesagt Um glücklich zu sein , musst du nur das aufgeben was dir unglücklich macht	1	
Ich krall mich ja immer an vergangene sachen die mir freunde bereitet haben und mich glücklich gemacht haben aber es hat mir nur Sorgen und unglücklich gemacht weil die vergangenheit nichts mit der gegenwart und der Zukunft zu tun hat	1	
Ich m chte ja auch das du glücklich bist und ich will nicht das meine Alicia st ndig weint und unglücklich ist	1	
Ich m chte und will nicht das du immer unglücklich bist deswegen m chte ich das du jetzt immer nur noch glücklich bist und das mit mir mein schatz Genau wir wechseln jetzt das Thema das reicht wenn es heute wieder alles hochgekommen ist Bei mir l uft es soweit ganz gut musste vorhin schon 13 paletten abladen ansonsten sind wir flei ig beim verteilen Aber meine gedanken sind immer nur bei dir mein schatzv	1	
Ich mach dich nur unglücklich dome macht dich glücklich	1	
Ich war so glücklich mit einem jungen zusammen war aber jetzt bin ich unglücklich aber dieser	1	
Ich wei doch selber das dome dich glücklich macht und ich dich nur unglücklich weil ich so bin wie ich bin	1	
Ich werde nicht glücklich ich bin einfach nur noch unglücklich	1	
Ich werde nicht mehr warten ich hab auch ein recht glücklich zu werden und ich wei du bist genauso unglücklich wie ich	1	
Ich will das es dir gut geht und will divh glücklich machen aber hab eher des gefühl ich mach dich damit unglücklich und mich selbst auch	1	
#informativ,	informativ
#vernünftig,	unvernünftig
#akzeptabel,	unakzeptabel
#bewusst,	unbewusst
Dann stehst du vielleicht nicht bewusst hinter ihm , unbewusst aber definitiv , denn sonst l sst man als beste Freundin eigentlich nicht zu , das man so über einen redet  .	1	
Das kann ich bewusst so nicht sagen aber unbewusst ja bestimmt	1	
Ka ob du es bewusst gemacht hast oder unbewusst	1	
Manchmal sagen sie dir dinge , die von mir selbst net mals bewusst gewollt waren , sondern unbewusst  .	1	
Ok ich 3 mal einmal unbewusst und 2 mal bewusst	1	
#angemessen,	unangemessen
#sicher,	unsicher
Ich bin gerade echt unsicher Weil ich echt nicht sicher bin , ob du das zu 100 ernst meinst	2	
Okay wollte nur sicher gehen weil du ja beim interview noch etwas unsicher wirkest  .	2	
Aber wenn ich zu hause sicher spielen kann und es nur nich kann oder mir unsicher bin wenn andere dabei sind , is das doch komisch , ich wei nich ob es daran liegt das ich immer so nerv s bin oder so aber is halt komisch	1	
Bald kommt das Baby , dann ich hab die 3 Prüfungen und bin noch nicht 100 sicher welcher wird mein n chster Arbeitsgeber , also alles zu unsicher für mich	1	
Bin mir noch unsicher m chte mir erst sicher sein	1	
Da bin ich selbst unsicher und das geht nur wenn beide wollen und beide sicher sind	1	
Die würde ich sicher bekommen , aber bin mir unsicher  .	1	
Er ist zwar dann leicht unsicher was er tun soll aber er wird ganz sicher Tae nicht aufhalten denn er mag es das er anscheinend ihm so gef llt	1	
Er nahm seine hand weil er unsicher war ob er sicher ist	1	
Genau in einer woche sieht es sicher anderes aus und wenn nicht und ihr euch unsicher seid hol ich sie wieder ab  .	1	
Ich bin mir nicht sicher , Ich bin total unsicher	1	
Ich bin sehr vorsichtig wodurch von Grund auf ich immer unsicher bin bei ihm bin ich mir sicher er ist der falsche genau wie bei robert	1	
Ich hab mich glaub in dich verliebt bin aber nicht sicher das ist voll komisch weill aber eigentlich nicht drüber reden und bin unsicher und ich hab voll die Selbstzweifel und n 8cht nur desswegen aber man was soll ich machen und wenn du nach der nachricht nix schreibst dann würde das nur noch mehr komisch errden und ich fühl nich grad komisch und MANNNNN DAS IST VOOOOOIIIIILLLLLLLL SCCCCCCHHHWEREEERRRRR SAG EINFACH WAS	1	
Naja es ist schwierig Also der Kleine und der mittlere sind sicher dran zeige und Ring ist noch unsicher	1	
Ne bestimmt nicht'Ich war mir immer unsicher und als dann Bad boy erw hnt wurde war ich mir sicher xD	1	
Okay wollte nur sicher gehen weil du ja beim interview noch etwas unsicher warst	1	
Schon allein dass ich mir danach nicht sicher war ob ich so bin hat bewiesen wie unsicher ich bin lelelellelel	1	
Sehr sicher ja aber er ist immer so unsicher er sagt immer ich h tte jmd besseren verdient undso man ich kann nichts dagegen tun ich hoffe der ist nicht zuuuuuuuuu shy	1	
Sehr sicher ja aber er ist immer so unsicher er sagt immer ich h tte jmd besseren verdient undso man ich kann nichts dagegen tun ich hoffe der ist nicht zuuuuuuuuu shy u know  ?	1	
Und gerade bin ich an dem punkt wo ich eigentlich mega weit schon bin vom denken her über alles nur das umsetzen Haut nicht hin Und deshalb falle ich alte Muster zurück und kann mich nicht entscheiden denn in den alten mustern bin ich sicher und hab Schutz Das neue ist unsicher riskanter  .	1	
Weil ich mal sicher war dann mal wieder unsicher	1	
guckt ihn leicht unsicher an und atmet nochmal tief durch ich frage ihn erstmal um sicher zu gehen  .	1	
hab ein da komischrs Gefühl Boah w rst du jetzt hier dann h ttest du mich sicher gehauen k nnte sein das ich schwanger bin ichcelver bin mir sau unsicher mal schauen ab heute müssten meine Tage kommen aber bis jetzt kommt rein gar nix	1	
ja , ich bin mir halt unsicher manchmal nein w r ja fies und bei ja war ich mir nicht sicher 3	1	
wenn du dich so unsicher fühlst dann warte auf den Zeitpunkt wo du dir sicher bist ob oder ob nicht  .	1	
#überzeugt,	unüberzeugt
#möglich,	unmöglich
#niedrig,	niedriger
#alt,	älter
#schnell,	schneller
Guten morgen meine geliebte kleine prinzessin Auch ich wünschte ich k nnte die zeit schneller vergehen lassen um so schnell wie m glich mit dir zusammen zu ziehen  .	11	
Ah okay , wenn man schnell schreiben kann gehts schneller das stimmt , bei mir sind die in der Firma auch immer Fasziniert wie schnell ich schreiben kann	2	
Au erdem wenn du immer so schnell off gehst f llt mir umso schneller was neues ein	2	
Der spielt den Lauf net komplett schnell sondern f ngt langsam an und wird immer schneller und das klingt 1  .	2	
Erst langsam und dann immer schneller und dann so schnell du kannst und am anfang eher sanft und dann immer h rter	2	
Sch tze mal das wird schneller Versand sein , aber ist ja auch jetzt egal wie schnell es geht  .	2	
Yj bewegt sich schnell und hart st t immer tief in ihn und bewegt seine Hand schneller Ohhh Baby du machst mich Kaputt  !	2	
ich war früher nicht gerade der artigste und da musste ich halt vor jmd wegrennen den ich b se gemacht habe und ich war damals schneller als du wie schnell rennst du 60 meter  ?	2	
1 wenn ich mo lange nicht sehe werden ich anh nglicher und mach mir schnell mehr sorgen um ihn und werde schneller eifersüchtig 2  .	1	
Aber iwie geht mir das zu schnell also der w chst ja in jeder schwangerschaft schneller	1	
Aber man reift ja mit dem Alter nhh und manche reifen schneller und manche nicht so schnell	1	
Aber umso schneller es geht , umso schnell ist es vorbei	1	
Aber wen man sich sieht geht die zeit immer schneller rum also der Mittwoch geht jede woche schnell rum  .	1	
Aber wenn er dir noch schnell hilft , dann seid ihr doch viel schneller fertig	1	
Ach komm ich mach schnell mit dann sind wir schneller fertig	1	
Ach so da kann man schneller mal ja sagen wenn du weisst das ich nicht so schnell komme	1	
Ah okay , wenn man schnell schreiben kann gehts schneller das stimmt , bei mir sind die in der Firma auch immer Fasziniert wie schnell ich schreiben kann Ja heute war auch wieder anstrengend auf Arbeit deshalb hab ich mich direkt aufs bett geschmissen	1	
Ah okay , wenn man schnell schreiben kann gehts schneller das stimmt , bei mir sind die in der Firma auch immer Fasziniert wie schnell ich schreiben kann Ja heute war auch wieder anstrengend auf Arbeit deshalb hab ich mich direkt aufs bett geschmissen Ach quack ich kann auch anstrengend sein	1	
Akito stehe schnell auf und renne noch schneller weiter	1	
Alan bewegte sich auch schneller aber konnte es nicht mehr verhindern , er kam und atmete schnell	1	
Alan sein Herz schlug schneller aber pl tzlich wurde es sehr langsam und dann wieder schnell , alan schnappte etwas nach luft	1	
Alles beides , Positiv und Negativ , es gibt Tage da kommt man schneller nach oben und es gibt Tage da senkt man wieder so schnell nach unten	1	
Also durch den tunnel kann ich dir sagen gehts schnell aber davor steht alles still selbst Omas mit Rollator sind schneller	1	
Also gut ich kenne leonie nicht so gut wie ihr aber ich sch tze mal sie wird nicht anders als ihr sein ich denke mal sie wird sich schnell Hoffnungen machen und wenn das dann raus kommt ist marten schneller weg als du ein bier aufmachen kannst	1	
Also in 2 stunden schaue jz nen film mit consti und geh dann schnell ins bett und so schneller haben wir morgen	1	
Also meine sex Art ist Ich lecke und Finger die Person zu gleixh danach stecke ich ihn ihr und ficke sie erst sehr langsam und sachte ich werde so jede Minute etwas schneller und H rter bis ich sm Ende sehr schnell und hart ficke  .	1	
Am liebestden soll die zeit jetzt schnell rum gehen sas ich schneller due winterpause bekomme und dann nur noch zu dir und danb solle die zeit wieder langsamm gehen	1	
Andre kommt schon , jetzt heim , ging schneller als erwartet und er f hrt noch schnell in Stall und mister ab	1	
Awwww das ist sü aber ich denke dann nicht das du schlechter bis den du bist mein freund und mir w r es egal ob ich oder du schneller ist von mir aus k nnen wir auch gleich schnell sein	1	
Bin auch so schnell wenn nicht sogar noch schneller	1	
Bin schneller da als du denkst so schnell kanst du das nicht leer trinken	1	
Bringe dir sp ter dein mett war schnell mit claudia bei edeka bin schneller mit auto	1	
Controller sind alle gleiche ch schnell da kann man nix schneller machen	1	
Da muast schnell dringa dann wirst schneller und brauchst weniger	1	
Da war an dieser Ampel in der burgbreite so ein Alter man zu erst hat der zu mir gepfiffen dann bin ich weiter gefahren dann ist dieser alte mir auch noch hinter her dann bin ich schneller gefahren und dann schnell die für auf gemacht und dann schnell rein ich hatte so schiss	1	
Dan sag mal ihr sol mal auf handy schauen weil würde dan jason Nacher hoch schicken weil dan kan ich beruhigt mit maya schnell los latschen geht dan schneller wen er nicht dabei ist	1	
Dann arbeiten wir jetzt mal ganz schnell , damit die Zeit auch schneller vergeht	1	
Dann geh jetzt schnell arbeiten damit du schneller nach Hause kommst	1	
Dann lass jetzt schnell trocknen um so schneller siehst du auch dein schatz	1	
Dann mach jetzt je schnell du fertig bisz desto schneller k nne wir schreiben	1	
Dann mach schnell , kannst du schneller ins Bett	1	
Das ist schei e ihr müsst ja nicht Ultra schnell sein nur halt etwas schneller das wir nicht so lange auf euch warten müssen	1	
Das werden wir alles schaffen schatz Wirst schon sehen , diebzeit vergeht dann schneller als man denkt , ich mein 3017 war Fucking schnell rum irgendwie  .	1	
Das wiederhole ich bis du st hnst schneller steff , gibs mir jetzt hart und schnell	1	
Denk dran wie ich unter dir lieg und wimmer weil du tief und schnell in mich st t und du immer h rter und schneller in mich st t	1	
Der Bra ist schnell doch die Kripos waren schneller	1	
Der Bra ist schnell doch die Krippos waren schneller	1	
Der bra ist schnell doch die krippo waren schneller	1	
Der ist schnell genug eig k nnte der schneller sein 70 sind mir noch zu langsam	1	
Der tag wird schnell um sein wen du erst mal hier bist noch schneller	1	
#stark,	stärker
#eng,	enger
Eddie erwidert und legt ihr seinen Mantel nebenbei um Inka st hnt sehr laut und ausgelassen , ihr Anus ist sehr eng , gefühlt noch enger als sie beim ersten mal	1	
Ja hinten ist es noch enger als vorne und ich weis ja du liebst es eng und willst auch gerne hinten	1	
Kakyuu schwimmen hab ich noch nie gemacht und ja k nnen wir gerne machen Kakyuu drückt sich enger an ihm lass mich nicht alleine Bunny ehrlich war ich so eng aber es war total geil mit dir mein Schatz	1	
Man beim rennen ist die bindung aufgegangen ich h tte sie noch enger machen sollen aber papa hat ja so ga gesagt sie war zu eng mich regt das übelst auf	1	
Quatsch du bist nicht zu eng und glaub mir jeh enger du bist desto geiler fühlt es sich dann an	1	
Tat es dir eigentlich weh , weil ich ja noch recht eng bin und gerade am anfang ich enger war  ?	1	
Wie soll man Sie ficken , so eng wie Ihre Fotze ist , ist ihr Arschloch noch enger	1	
die ganze zeit vom rumlaufen & dann schei kleiner enger bus & dann noch flugzeug eng	1	
die ganze zeit vom rumlaufen & dann schei kleiner enger bus & dann noch flugzeug eng und keine beinfreiheit	1	
ziehe dich ganz eng an mich ziehe meine jacke enger um dich und w re dich gleich sind wir unten dann bringe ich dich da hin wo es warm ist  .	1	
#einfach,	einfacher
Ich will einfach soo viel sagen , ich wünschte es w re einfacher Wei t du warum ich dich damals als besten Freund gesehen habe  ?	10	
Es ist für mich einfacher , sch ner und gibt mir auch sicherheit , wenn du einfach direkt sagst was du fühlst  .	3	
Glaub mir das ist einfacher wenn du ihm nicht mehr schreibst und es einfach l sst ich wei wovon ich rede	2	
Ja Silvana ist wirklich nie einfach letztes mal war es bisschen einfacher weil ich wusste Elli bleibt aber diesmal	2	
Sag halt einfach wenn du kein bock mehr auf mich hast das ist für mich einfacher als zu warten und zu hoffen das man in denn arm genommen wird  .	2	
Schick mir einfach mal einen link von YouTube ist einfacher	2	
Aber egal , wie du es machen wolltest , w re es einfacher , wenn ich einfach damit lebe und es dir dann nicht ganz so schlecht damit geht  .	1	
Aber einfacher w re es gewesen , einfach etwas weniger zu lernen  .	1	
Aber genau das begreifen die wenigstens , immerhin ist es viel einfacher die Fehler bei anderen zu sehen als einfach mal über sich selbst nachzudenken	1	
Aber ohne gro e Vorrede , es einfach tun , ist einfacher , als wenn sie jetzt noch einen gro en Diskurs dazu führen	1	
Aber sei einfach in dem Punkt mal wie er , lach einfach selbst drüber und es wird einfacher	1	
Ach wir steigen einfach aufn hbf um das ist einfacher xF	1	
Aha ok falls es aber der Fall sein sollte sag mir einfach bescheid das ist n mlich einfacher	1	
Alter nein tipp doch einfach auf ja dann ist es einfacher	1	
Am besten w re ich w r einfach weg dann w r alles einfacher	1	
Amelie steht under anderem an dem Punkt an dem sie jetzt steht , weil schon andere ebenfalls einfach versucht haben ihr alles einfacher zu machen	1	
Antworte einfach wenn du irgendwann kannst is einfacher als ne Zeit aus zu machen	1	
Auch wenn das jetzt einfacher klingt als es is mach einfach , denk nich zu viel drüber nach	1	
Bei diesen Tabellen hab ich einfach x , y , z drüber geschrieben ist einfacher und das hinter dem Strich ist das was nach steht	1	
Bei uns Jungs ist alles viieeel einfacher , wir schenken uns einfach garnichts	1	
Bitte mach dich jz nicht so fertig und schlaf mal ich wei es ist einfacher gesagt als getan aber lege einfach mal dein Handy weg und versuche zu schlafen	1	
Bleib doch einfach da wenn das einfacher ist  .	1	
Da kann man aber auch einfach mal zur Seite gehen ist noch einfacher	1	
Da kann man aber auch einfach mal zur Seite gehen ist noch einfacher ich verstehe schon , dass sich leute über sowas Aufregen	1	
Dann zeichne einfach so eins ist doch einfacher	1	
Das h rt sich so an nach dem motto warte auf mich ich bin fast so weit schatz wenb dz so weit bist sag es nir einfach das ist doch einfacher	1	
Das stimmt einfach ein Screenshot von machen ist definitiv einfacher	1	
Denn schreib ich dir du kannst mich ja beschützen oder ich nehme einfach wie sonst auch immer meinen Schlagstock mit ist einfacher	1	
Dieser Monat ist einfach stressig und du machst es nicht gerade einfacher  .	1	
Du k nntest es mir einfacher machen , indem du einfach alles erz hlst , was es darüber zu erz hlen gibt	1	
Du kannst mir dann einfach den Code schicken dann w re das einfacher	1	
Du solltest sie einfach gehen lassen für dich ist es weit aus einfacher als wie für mich Du k nntest auf sie schei en und probleme gelost	1	
Du wei t doch besser was stimmt und was nicht , dann musst du sofort kontern , das meine ich mit fertig machen , du k mpfst nicht dagegen an , du l sst zu das du dich fertig machen l sst , du musst stark dahinter bleiben und dich nicht klein kriegen lassen , wie meinst du bin ich heute zu dem geworden was ich bin , machs noch einfacher , sag für jeder Beleidigung einfach Danke , das rgert sie am meisten glaub mir	1	
Du weist dass es teilweise viel einfacher w re für dich einfach den gefallen anzunehmen	1	
Eben Denke schon dass sie schaut Am liebsten würde ich die 5 wo au en rennen einfach aussetzten dann w re alles sehr viel einfacher	1	
Egal werd wohl auch einfach nicht arschloch ist einfacher	1	
Ein einfacher Dreisatz ist eine Tabelle mit drei Zeilen und zwei spalten , die du einfach nach einem bestimmten Schema befüllen musst , das gute am Dreisatz ist , dass das Schema immer das gleiche ist  .	1	
Er meint so sag doch einfach das du schluss machen willst das ist einfacher	1	
Er steht auf mary er solls mir einfach sagen dann ist es jedenfalls einfacher es zu verstehen	1	
Er würde es einfacher machen wenn er es einfach ui gibt	1	
Es ist einfach aber midori zu killn ist einfacher	1	
Es ist nicht einfach aber dadurch wird es einfacher	1	
Es tut einfach weh und ein einfacher Sani hilft da nicht	1	
Es würde sich einfach super anfühlen wenn das wieder funktioniert dann f llt mir das um einiges einfacher	1	
Fahr einfach zu mir durch ist einfacher	1	
Fakt ist er will nicht reden und das es einfacher ist es mit allen zsm zu besprechen einfach mal ne Gruppe	1	
Frag doch einfach Lara ist doch einfacher	1	
H r etwas fter einfach auf mich und dein leben w re viel einfacher	1	
Hab mama jetzt einfach gefragt was die hat ist einfacher	1	
Haben einfach gesagt ist so wie bei Eukaryoten nur einfacher	1	
#groß,	größer
#heiß,	heißer
#groß,	größer
#hart,	härter
#groß,	größer
#stark,	stärker
#hell,	heller
Am anfang hatte sie pechschwarze augen mittlerweile sind sie so hell wie meine es hat ca mit 2 monaten begonnen dass sie heller wurden	1	
Du brennst so hell und du brennst immer heller  .	1	
Es ist hell braun die eine ist heller	1	
Ich weis zwar nicht wie hell es war am Wochenende aber Freitag definitiv heller	1	
Im Sommer sind die richtig hell und alle sagen dann so übersetzt heller	1	
Ist zwar bissel zu hell für florino aber im sommer isser sicher heller	1	
Ja neh hell braun nicht wenn so wie auf den bild heller nicht	1	
Jaa jetzt wird ja sommer und eigentlich wollte ich das heller machen weil ich dann lila str hnen hier hab und das würde ja dann gut aussehen also denk ich und so schokobraun und rot und das hatte ich schon immer und im sommer werden meine haare immer heller und , daruch das hell  .	1	
Nein , aber es soll immer heller werden , und ich mache es grundsetzlich nur hell	1	
Wenn f rben dann heller aber nich zu hell oder blond	1	
#billig,	billiger
Da gibt es alles ganu billig nis zu 70 Prozent billiger alles was es gibt voll cool	1	
Danke , das ist wirklich viel billiger , nur overwatch nicht , aber das ist schon billig XD	1	
Ich denke ich auch will nachher aber erstmal mbappe testen ich kann ihn in mir nachher holen der kostet nur noch 120k wegen dem Black friday Markt Crash es ist alles so billig und es wird noch billiger	1	
Total billig um a 50 gal billiger Do is aba glab I heid nix los weil I wissad koan der do heid hi geht	1	
Würde ja nicht alleine fahren und einen kaufen so nen billig auto ist ja genau so alt nur da sind die teile halt billiger	1	
#warm,	wärmer
#jung,	jünger
Also jung ja aber nur 2 Jahre jünger und das andere wird oft behauptet nur ob man will das es so ist oder nicht ist die frage	1	
Bin doch noch keine 30 Warum jung hab viele freunde die jünger sind xd	1	
Da waren haare noch grau und lang und ich noch jung naja zumindest zwei Monate jünger	1	
Das mit dem zu jung war so gemeint weil du so jung noch ausgesehen hast und ich nicht wusste das du nur 2jahre jünger bist als ich	1	
Egal wie jung eure freunde sind Jesus freunde waren jünger	1	
Es ist schon bl d und wenn die zsm k men und die Eltern das erlauben würden dann w re ich megaa wütend , weil Mira jünger ist als ich und die es mit mir nur weil ich zu jung war nicht erlaubt haben	1	
Ey das wird schon und wenn nicht ist es auch kein Weltuntergang bist ja noch jung , aber bedenke das sie bisschen jünger ist als du und deswegen mit der reife vllt ein bisschen zurück liegt	1	
Ja ich fühle mich immer voll klein und jung neben allen anderen Mein Freund rgert mich immer weil ich kleiner und jünger bin als er	1	
Na und ich bin lter ich finde sogar 1 jahr lter Jungs zu jung und dann auch noch jemandem der jünger als ich bin das ist doch shitter	1	
Ne ihr seit alle so jung will auch mal jünger sein	1	
Ohne dieses detailierte Wissen über meine Gedanken und Gefühle h tte er mich nie so auffangen k nnen , wie er es tut und das , obwohl er sehr jung ist 23 und damit 9 Jahre jünger als ich  .	1	
This moment wenn du denkst sie sieht jetzt voll jung aus noch , sie aber früher noch jünger aussah  .	1	
Wollte gerade sagen sie ist ja noch jung aber die ist ein jahr jünger xD	1	
also mal abgesehen davon das ich ja viel zu jung für ihn bin & er das niiiie machen würde aber das ich jünger bin w r mir dann auch egal	1	
sind aber auch echt jung die beiden , also jünger als ich auf jeden fall , vielleicht grade mal 18	1	
#schnell,	schneller
Guten morgen meine geliebte kleine prinzessin Auch ich wünschte ich k nnte die zeit schneller vergehen lassen um so schnell wie m glich mit dir zusammen zu ziehen  .	11	
Ah okay , wenn man schnell schreiben kann gehts schneller das stimmt , bei mir sind die in der Firma auch immer Fasziniert wie schnell ich schreiben kann	2	
Au erdem wenn du immer so schnell off gehst f llt mir umso schneller was neues ein	2	
Der spielt den Lauf net komplett schnell sondern f ngt langsam an und wird immer schneller und das klingt 1  .	2	
Erst langsam und dann immer schneller und dann so schnell du kannst und am anfang eher sanft und dann immer h rter	2	
Sch tze mal das wird schneller Versand sein , aber ist ja auch jetzt egal wie schnell es geht  .	2	
Yj bewegt sich schnell und hart st t immer tief in ihn und bewegt seine Hand schneller Ohhh Baby du machst mich Kaputt  !	2	
ich war früher nicht gerade der artigste und da musste ich halt vor jmd wegrennen den ich b se gemacht habe und ich war damals schneller als du wie schnell rennst du 60 meter  ?	2	
1 wenn ich mo lange nicht sehe werden ich anh nglicher und mach mir schnell mehr sorgen um ihn und werde schneller eifersüchtig 2  .	1	
Aber iwie geht mir das zu schnell also der w chst ja in jeder schwangerschaft schneller	1	
Aber man reift ja mit dem Alter nhh und manche reifen schneller und manche nicht so schnell	1	
Aber umso schneller es geht , umso schnell ist es vorbei	1	
Aber wen man sich sieht geht die zeit immer schneller rum also der Mittwoch geht jede woche schnell rum  .	1	
Aber wenn er dir noch schnell hilft , dann seid ihr doch viel schneller fertig	1	
Ach komm ich mach schnell mit dann sind wir schneller fertig	1	
Ach so da kann man schneller mal ja sagen wenn du weisst das ich nicht so schnell komme	1	
Ah okay , wenn man schnell schreiben kann gehts schneller das stimmt , bei mir sind die in der Firma auch immer Fasziniert wie schnell ich schreiben kann Ja heute war auch wieder anstrengend auf Arbeit deshalb hab ich mich direkt aufs bett geschmissen	1	
Ah okay , wenn man schnell schreiben kann gehts schneller das stimmt , bei mir sind die in der Firma auch immer Fasziniert wie schnell ich schreiben kann Ja heute war auch wieder anstrengend auf Arbeit deshalb hab ich mich direkt aufs bett geschmissen Ach quack ich kann auch anstrengend sein	1	
Akito stehe schnell auf und renne noch schneller weiter	1	
Alan bewegte sich auch schneller aber konnte es nicht mehr verhindern , er kam und atmete schnell	1	
Alan sein Herz schlug schneller aber pl tzlich wurde es sehr langsam und dann wieder schnell , alan schnappte etwas nach luft	1	
Alles beides , Positiv und Negativ , es gibt Tage da kommt man schneller nach oben und es gibt Tage da senkt man wieder so schnell nach unten	1	
Also durch den tunnel kann ich dir sagen gehts schnell aber davor steht alles still selbst Omas mit Rollator sind schneller	1	
Also gut ich kenne leonie nicht so gut wie ihr aber ich sch tze mal sie wird nicht anders als ihr sein ich denke mal sie wird sich schnell Hoffnungen machen und wenn das dann raus kommt ist marten schneller weg als du ein bier aufmachen kannst	1	
Also in 2 stunden schaue jz nen film mit consti und geh dann schnell ins bett und so schneller haben wir morgen	1	
Also meine sex Art ist Ich lecke und Finger die Person zu gleixh danach stecke ich ihn ihr und ficke sie erst sehr langsam und sachte ich werde so jede Minute etwas schneller und H rter bis ich sm Ende sehr schnell und hart ficke  .	1	
Am liebestden soll die zeit jetzt schnell rum gehen sas ich schneller due winterpause bekomme und dann nur noch zu dir und danb solle die zeit wieder langsamm gehen	1	
Andre kommt schon , jetzt heim , ging schneller als erwartet und er f hrt noch schnell in Stall und mister ab	1	
Awwww das ist sü aber ich denke dann nicht das du schlechter bis den du bist mein freund und mir w r es egal ob ich oder du schneller ist von mir aus k nnen wir auch gleich schnell sein	1	
Bin auch so schnell wenn nicht sogar noch schneller	1	
Bin schneller da als du denkst so schnell kanst du das nicht leer trinken	1	
Bringe dir sp ter dein mett war schnell mit claudia bei edeka bin schneller mit auto	1	
Controller sind alle gleiche ch schnell da kann man nix schneller machen	1	
Da muast schnell dringa dann wirst schneller und brauchst weniger	1	
Da war an dieser Ampel in der burgbreite so ein Alter man zu erst hat der zu mir gepfiffen dann bin ich weiter gefahren dann ist dieser alte mir auch noch hinter her dann bin ich schneller gefahren und dann schnell die für auf gemacht und dann schnell rein ich hatte so schiss	1	
Dan sag mal ihr sol mal auf handy schauen weil würde dan jason Nacher hoch schicken weil dan kan ich beruhigt mit maya schnell los latschen geht dan schneller wen er nicht dabei ist	1	
Dann arbeiten wir jetzt mal ganz schnell , damit die Zeit auch schneller vergeht	1	
Dann geh jetzt schnell arbeiten damit du schneller nach Hause kommst	1	
Dann lass jetzt schnell trocknen um so schneller siehst du auch dein schatz	1	
Dann mach jetzt je schnell du fertig bisz desto schneller k nne wir schreiben	1	
Dann mach schnell , kannst du schneller ins Bett	1	
Das ist schei e ihr müsst ja nicht Ultra schnell sein nur halt etwas schneller das wir nicht so lange auf euch warten müssen	1	
Das werden wir alles schaffen schatz Wirst schon sehen , diebzeit vergeht dann schneller als man denkt , ich mein 3017 war Fucking schnell rum irgendwie  .	1	
Das wiederhole ich bis du st hnst schneller steff , gibs mir jetzt hart und schnell	1	
Denk dran wie ich unter dir lieg und wimmer weil du tief und schnell in mich st t und du immer h rter und schneller in mich st t	1	
Der Bra ist schnell doch die Kripos waren schneller	1	
Der Bra ist schnell doch die Krippos waren schneller	1	
Der bra ist schnell doch die krippo waren schneller	1	
Der ist schnell genug eig k nnte der schneller sein 70 sind mir noch zu langsam	1	
Der tag wird schnell um sein wen du erst mal hier bist noch schneller	1	
#tief,	tiefer
Vor jedem Husten sollte ein tiefer Atemzug genommen werden , und der Husten muss tief und verl ngert sein , wie bei der Produktion von Sputum aus der Tiefe der Brust  .	2	
Du bist so unbeschreiblich hübsch das du mit deinem aussehen echt killtst und denk dran egal wie tief du singst das Niveau deiner Feinde ist immer tiefer	1	
Eigentlich sollte ich dich ein wenig bestrafen grinst leicht und raunt es tief in ihr nackenfell , st t dann fester zu tiefer in sie rein	1	
Ich fande seine Stimme vorher genau so sch n wie jetzt ich finde es nicht schlimm das Seinen Stimme tiefer ist als der ozean ich liebe es wenn er tief sing auch wenn er recht hoch mit der stimme kommt	1	
Ich geh mit mein kopf vor und zurück und nehme ihn tiefer in den mund so tief das ich ganz kurz würgn musste und nehme ihn dann wieder kurz in die hand und gebe dur paar sekunden nen handjob	1	
Ich hab angst das ich iwann mal die narben habe nur halt gr er , tiefer , oder das ich iwann gen ht werden muss weil es zu tief war	1	
Jeder hat narben bei dem ein tiefer und bei dem anderen nicht so tief  .	1	
Man baby du bist so tief in meinem Herzen tiefer geht es net	1	
Man f ngt mit einem Geodreieck an dann geht's weiter mit einer Schere es wird tiefer dann mit einer Klinge es wird noch tiefer und am Ende ist es so tief dass man sogar ein Messer benutzt man sich vor Schmerzen schreit	1	
Man f ngt mit einem Geodreieck an dann geht's weiter mit einer Schere es wird tiefer dann mit einer Klinge es wird noch tiefer und am Ende ist es so tief dass man sogar ein Messer benutzt man sich vor Schmerzen schreit aber es ist egal für diese Person die sich ritzen denn so bauen sie sich ihr Stress ab indem Sie sich einfach weiter	1	
Na , ich fang ganz tief an , h r dann aweng tiefer auf , geh dann wieder nach Haus	1	
Sie ist aber schon lange tief und sieht so aus als ob sie immer tiefer geht , au er sie zieht endlich mit ihrer mom um	1	
Sind die 4 so tief wie der eine am deinem arm oder tiefer  ?	1	
So tief hat sie es gemacht aber bei dem anderen ist es tiefer	1	
aber tief im inneren bin ich ein guter mensch Und noch tiefer drin bin ich noch ein gr eres arschloch lololololololol	1	
deine brüste packen und massieren und So tief rein gehen wie ich kann unf immer mehr versuchen tiefer rein  .	1	
ich war schon genau so tief , wenn nicht tiefer  .	1	
schnurrt tief vibrierend auf //mhmm ich liebe es wenn sie das sagt // dringt immer tiefer ein und f ngt dabei mehr zu sto en an , knabbert lüstern an ihrem nacken	1	
st hnt tiefer als er ihren H hepunkt spürt und keucht tief erregt Ohhhjaaa das ist es schnurrt er tief genie end und st t nun mit schnellen kurzen St en um ihre Verengung auszunutzen ihn zum H hepunkt zu treiben , sein glied pulsiert immer deutlicher und er bei t ihr nochmal in den Nacken	1	
tief genug oder willst du noch tiefer	1	
#laut,	lauter
Ok ich bin lauter weil so kampfjet ist 125 db laut und ich bin dezent drüber weil bei mir zeigt das nichts mehr an	2	
Aber auch nicht laut oder so sondern eher so leise und dann erst lauter wenn es wirklich weh tut	1	
Baby sie ist nicht verstummt sie ist sogar sehr laut sie schreit mit jedem Schnitt lauter mit jedem Gedanken den du an den Tot hast , mit allen Zweifeln an dir selber wird sie lauter nur weil man ihr keine Beachtung schenkt hei t das nicht das sie nicht da ist	1	
Bin schon etwas lauter aber auch nicht zu laut 3	1	
Bin schon mal laut beim Sex , wurde gern noch lauter sein , aber die Nachbarn , bist du laut	1	
Binnie bei t sich schnell auf die unterlippe in der Hoffnung sie würde nicht lauter st hnen was aber scheitert und st hnte laut auf Seine H nde sind so gro  .	1	
Blo du wirst lauter schreien und es knallt auch laut	1	
Da war dann so ein Typ der ka Vllt 15 war und ne jbl Box dabei hatte und dieses lied richtig laut anhatte und er stand im tunnel also hat man es natürlich noch lauter geh rt	1	
Da war dann so ein Typ der ka Vllt 15 war und ne jbl Box dabei hatte und dieses lied richtig laut anhatte und er stand im tunnel also hat man es natürlich noch lauter geh rt das war so behindert vor allem war da dann noch ne Gruppe M dels die dazu getanzt haben	1	
Dann kannst du schreien so laut du willst niemand h rts weil ich lauter bin	1	
Der Ton von dir also benachrichtigungs Ton wird von selber lauter erst leise dann mega laut	1	
Der alte schnarcht voll laut und wenn ich noch n her bei ihm liege ist es noch lauter Wei nicht worüber m chtest du reden	1	
Du fickst mich erst langsam und dann immer H rter und H rter , ich st hne immer lauter und schneller , mal laut mal leise , ich flüster dir ins Ohr das du ihn rausziehen und mich Lecken sollst , was du dann auch tust , ich werde so verdammt geil auf dich das ich dich auf den rücken lege und ich mich auf dich damit ich dir einen blasen kann und du mich lecken  .	1	
Du wirst mich auch noch so laut oder auch vielleicht lauter h ren	1	
Fiat punto bisch illegal umgerüstet lauter und so bzw zu laut mit knapp 180db	1	
Finde ich besser und ist auch sch ner finde ich hoffe bist nicht so entt uscht das ich nicht soviel aufger umt hab lass das bitte ich mach das Ruhe dich bitte aus dann und mach dir kein Kopf die waren schon viel lauter und ich fand wir waren nicht laut unf wen wollte sie uns das immer sagen also Pech für sie vermiss dich ganz schrecklich mein engel love you	1	
H leonie hat gesagt ich soll lauter reden weil Fynn den Fernseher so laut gedreht hat	1	
Ich hab wenn garnichts geht fernseher in der stube etwas lauter gemacht und mit dem handy laut musik im bad	1	
Ich habe meine Musik ein wenig lauter gemacht und dafür macht er mich an aber wenn er seine musik aud laut macht	1	
Ich kenn die ganzen kak lieder alle die musste ich immer extra laut singen weil meine sis meinte ich soll lauter singen	1	
Ich meine damit ne müll bombe ich und meien Freundinnen haben wodka gesoffen und voll viel scheie gebaut wir waren lauter als die Erwachsenen und die waren laut	1	
Ja aber nicht so laut klar das kinder mal lauter sind aber das ist ja schon nicht mehr normales spielen	1	
Ja und du drehst die musik so laut das es gar nicht noch lauter geht und trotzdem h rst du noch deren musik ich habe da ja nichts gegen wenn sie mal gute musik anmachen würden	1	
Kannst ruhig laut sein Bin leise und wenn ich Orgasmus bekomme werde ich bissen lauter	1	
Kleiner Tipp du musst lauter reden weil dieses Fernsehen pipen ist zu laut	1	
Lena st hnt lauter Silver st hnt laut weil IHR KLEINER MUND ziemlich gut an SEINEM M CHTIGES UND STEIFEN GLIED saugt  .	1	
Lias tut mir weh ich schimpf lauter und die heult glei rum weils zu laut war	1	
Mach dein Handy laut und ich mach das es lauter ist	1	
Mach mal dein Handy so laut du kannst oder nehme Kopfh rer die Explosion war viel lauter als es im Video rüber kommt	1	
Mal lauter , mal weniger laut	1	
Musste grad mal lauter werden in der Klasse alle mega laut weil wir gruppen Arbeit hatten und wir haben eine schwarze in der klasse mega sü und die versteht eh schon schlecht und ich musste immer lauter lesen damit die was versteht ich dann aufgeh rt und quer durch die klasse gebrüllt das die ihre fresse halten sollen und der Lehrer so ja da geb ich der Frau schuhmacher recht wa	1	
Ne Diggah kann net lauter wegen Eltern macht einfach Handy laut	1	
No er sagt es laut aber meinen mum ruft immer was ist red lauter	1	
OMG hatte mich gerade so erschrocken ich drücke so auf laut und auf einmal geht es so immer lauter und lauter obwohl ich die Fernbedienung net in der Hand hatte	1	
Papa wurde laut weil meine Hose Kaputt gegangen ist hab ich leicht lauter gesagt was kann ich bitte dafür und hab mein handy auswersehen angemacht und wollte es aus machen	1	
Raina st hnt etwas lauter aber nicht zu laut W  .	1	
Rede mal lauter , ich muss mein Handy immer ganz laut machen	1	
Schlimm find ich halr sas man das playbeck so laut hoert un dann singt sie halt manchm leiser un manchma lauter druebr	1	
Sie ist laut sie schreit mit jedem Schnitt lauter , mit jedem Zweifeln an dir und deinem K nnen , mit allen Selbstmord gedanken , doch wenn du soweit bist sich umzubringen h st du sie deutlich sie ist einfach zu laut und du willst sie umbringen doch sie stirbt nicht nur du wenn du es soweit kommen  .	1	
Sie wurde lauter und er hat dann laut mit ihr Schluss gemacht  .	1	
So laut ist das aber auch nicht da sind die anderen lauter 1 0	1	
Sto e dich h rter es wird zwar lauter aber zum Glück sind die leute drau en so laut das h rt man das schlagen von meiner hüfte auf dein Arsch nicjt	1	
Tu ich ned aber ich hab kopfh rer drinnen und meine sind kapputt deswehen kann ich so laut schrein wie ich will ihr würdet es trz nd lauter b rem	1	
Wann kommst du ich habe mich ebend hingelegt und wollte schlafen weil ich kaputt bin und dann kommt andre und h rt wieder so laut und wenn ich sag er soll leiser machen macht er lauter	1	
Warte ich stell lauter is gerad so laut im Bus	1	
Weil bin lea am argern sie sagt du schlafst aba immer hier also ich auf der couch da hab ich ihr gesagt weil sie immer zu laut schnarcht und sie dann soo daniel ist viel lauter und versucht es dann nach zu machen	1	
Zu laut Musik oder zu lauter Sex  ?	1	
hm also wenn ich über Kopfh rer music h re egal ob so laut wie geht oder nicht ist das Martinshorn eigendlich trotzen lauter	1	
immer wenn derr laut macht bin iches ja immer mit der bezeichnung meine anlage were lauter	1	
wir sa en auf dem boden und haben okey gespielt und neben an war oruc voll laut am telefonieren der ist noch lauter als ich immer	1	
#neu,	neuer
Mein neuer Job ist stressig war ja aber klar , wenn alles neu aufgebaut wird  .	4	
Ach so ins unserer Crew sind neu Der spanier und ein neuer er schnuppert erstmal nur ein	1	
Ach so ins unserer Crew sind neu Der spanier und ein neuer er schnuppert erstmal nur rein	1	
Alles neu tepezieren neue tapete holen neuer tisch	1	
Das ein neuer junge mit Seiner Familie neu in das Land kommt und ein Auge auf emilia wirft und die ganze zeit versucht für sich zu gewinnen und das bekommt ihr Freund mit und fordert ihn vor ein Duell heraus und am Ende kommt raus das er nur so ist weil er keinen mehr verlieren will	1	
Ein neugeborenes kind ist neu aber manuel ist neuer	1	
Für neuer au puff schetzungsWeise 50-60 bei den bremsen wenn man beide neu macht also neue Bel ge ungef hr 15 bis 30 liegt daran ob der scheiben oder Trommel bremsen hat und ne batterie 10 bis 15 aber wenn man einen wirklich gute mit mehr ah amper stunde nimmt kostet die bis 30 muss man aber nicht haben also sch tzungsweise kostet alles um die 100 warscheinlich sogar etwas weni	1	
Hallo neuer hallo an alle die neu sind	1	
Hier habe ich foto gemacht als ich es neu bekommen habe nur ist mitlerweile hinten der reifen Schrott da muss neuer schlauch und alles erneuert werden	1	
Hinten ein Zimmer gestrichen , neuer Teppichboden und alles mal neu hingestellt also m bel und so	1	
Ich lade die Seite nochmal so auf fun neu und was ist neuer skin alles klar riot	1	
Ist das ein neuer Account von dir alle bilder neu oder ist des dein erster	1	
Ist das ein neuer oder der Alte neu gemacht  ?	1	
Ja ich muss mein leben nochmal komplett neu aufbauen , also neuer job neue wohnung usw  .	1	
Leute das ist unser neuer YouTube Kanal hab einfach alles neu erstellt	1	
Mein neuer Hausarzt meinte ich muss meine barmerkarte auch neu machen	1	
Muss es entweder neu geschliefen werden oder neuer Abdruck her	1	
Ne Masse von leuten die neu kommen also muss neuer name her	1	
Probleme mit neuer Nummer hab dich deshalb neu anschreiben müssen	1	
So W sche h ngt , Bettw sche neu bezogen frisch geduscht in neuer Bettw sche So mein engel ich wünsche dir eine wundersch ne gute nacht schlaf gut und tr ume was sch nes pass auf dich auf und melde dich morgen früh wenn du wach bist war ein sch ner abend auch	1	
Und was ist mit neuer Version gemeint du meinst das fif wird neu gemacht	1	
Wenn das spiel neu installiert wird ist da auch ein neuer account	1	
Wieso neuer Akku is gebraucht war haste nicht komplett neu gekauft	1	
es braucht halt seine Zeit aber eine gute Nachricht ist das se ne neu operieren müssen , das Implantat sitzt aber ein kleiner neuer Bruch ist an der Operationsstelle und der verursacht halt m chtige Schmerzen  .	1	
man bedenke auch wir mussten hier alles neu machen tapezieren , verputzen neuer boden  .	1	
mein name feli hat die Bedeutung neu anfang der welt oder auch neuer anfang nach dem	1	
weil du musst ein neuer benutzer machen dich dort neu einschreiben  .	1	
weil ich sc neu installl musst u jz neuer acc , weil kp wie pw war	1	
#weit,	weiter
Wenn er zu weit geht , gehe ich weiter  .	4	
Ich habe die zwei die die ganze zeit am n rgeln sind schon so weit bekommen und jetzt wo es weiter gehen kann wenn du zumindest eintrittst sagst du n  .	3	
Und das h lt Fernbeziehung ist nichts f 7r mich deswegen bin ich da etwas erschrocken anka hat damals nur ein Block weiter gewohnt das war mir schon zu weit	3	
der hat mir so ein komisches video geschickt wo er als son hasenfilter hat und so musik an hat und da hatte er sein T-shirt mega weit unten hab ich geschrieben joaa zieh dein T-shirt am besten noch weiter runter war als Ironie gemeint  .	3	
Ganz gut so weit hab jetzt angefangen meinen cheff einfach zu lochen wenn ich nicht weiter komme	2	
Hi Steffi , k nnte Steffi bitte wieder weiter hinten parken , da J rg einkaufen ist und sonst wieder so weit schleppen muss  .	2	
Ja ich mein die züchten eh kaum und sind weit unten in der rl und die wollen weiter hoch	2	
Sorry gabi aber das du weiter erz hlst das ich nicht arbeite geht echt zu weit  .	2	
Wart ihr dann auch ungef hr so weit oder wart ihr noch etwas weiter  .	2	
danke für alles Mike bin so stolz auf dich du hast es so weit Geschafft ich liebe mach weiter so , teamsinger	2	
danke für alles Mike bin so stolz auf dich du hast es so weit Geschafft ich liebe mach weiter so , teamsinger und alles alles gute zum Geburtstag @philthebeat du bist der beste	2	
du bringst es echt so weit das meine Gefühle für dich immer weniger werden weiter so wenn dir dein leben nocht passt zieh echt am besten aus und mach was du willst ich habe dicj damals sogar nocj gefragt ob du das mit mir durchziehst  !	2	
000cm weiter weg von dir und doch so weit weg	1	
; ; generell meinen weiter machen wenigstens so weit das der kopfricjtig fertig ist und vielleicht auch H nde und feedpaws	1	
Aber bisch ja richtig weit mit stranger things ich glaub nach der marvel reihe kuck ich des au weiter	1	
Aber dann schreiben du kannst bei mir so weit gehen wie du willst , bis zum Unendlichen zur unendlichkeit und noch viel weiter	1	
Aber ganz ehrlich elias würde so auf die fresse kriegen wenn der so weiter macht mit seinen schei griffen kommt der eh nicht weit	1	
Aber nicht zu weit du musst aber weiter nach rechts gehn als Rayan	1	
Aber wir schauen nach der ersten stunde film und ich denk Geschichte wird easy vor allem weil wir zwei mit den bl tterb weit sind also wen wir die weiter machen	1	
Ahhh-ist ans bett gepinnt und die augen weit offen- S-schaut sie weiter an- //sie hat einen Strich im auge //	1	
Akeno fliegt weiter Rossweisse darf nicht weit sein Sirzechs D mon gut bald hab ich deine Energie Rossweisse verliert weiter Energie	1	
Also ich bin in dem Thema ja auch iwie weiter als du , glaub ich und deshalb versuch ich eig garnet zu weit zu denken  .	1	
Also liegt es wirklich nicht nur an mir das das alles seltsam ist aber das sie danach brechen oder schlafen ist normal , meiner hat damals gehechelt , Menschen reagieren ja auch manchmal auf Impfungen , trotzdem wei ich nicht ob ich wirklich noch weiter zu dem Tierarzt gehen will , schade das meine alte Tier rztin so weit weg ist , dir war wirklich super	1	
Also was ist wieder so weit ich verpisse mich wier machen morgen weiter	1	
Also wenn ihnen das doch zu weit ist , ist das natürlich kein Problem , dann frag ich eben nochmal weiter	1	
Alsoo es geht weiter du machst immer schneller und schneller bis du kommst ich stehe auf und schlucke alles runter es geht weiter du schmei t mich aufs Bett machst meine beine gaaaanz weit auseinander du steckst deinen schw nz rein und fingerst mich noch dabei	1	
Anatomie siind wir noch ni so weit , wir machen da erst weiter wenn Physiologie fertig is also diese Woche glaube	1	
Aso ja dann schau wie weit du kommst und wir schauen da weiter wei net wo lisa grad ist aber egal	1	
Aso ok Ja genau , 14uhr ist denn trauung , danach Sektempfang am Strand denn gehts zur Location zu Fu , ist echt nicht weit , da denn kaffee und weiter muss ich mit dennis noch planen , aufjedenfall 18uhr kommt catering	1	
Auf jedenfall gut zu wissen , wollte mich n mlich als n chstes in bad bramstedt anmelden und der weg w re wirklich zu weit , also noch weiter als bayern	1	
B in Berlin Und lea noch weiter weg Blendi muss ich schauen wie weit	1	
Bald ist es so weit dann geht twd weiter und bald auch noch die convention	1	
Bei mir ist der eine weiter drin und der andere voll weit drau en das fühlt sich so unnormal ab	1	
Bei mir ist der eine weiter drin und der andere voll weit drau en das fühlt sich so unnormal an	1	
Bin soooo weit unten , Freitag beim Neurologen wird weiter geschaut und auch Tests gemacht	1	
Bisher bin ich noch nie so weit gekommen wie führt man so eine Unterhaltung weiter	1	
Bisher bin ich noch nie so weit gekommen wie führt man so eine Unterhaltung weiter  ?	1	
Bist ja sonst noch weiter wech von mir so weit reicht meine Gedanken Kraft nicht	1	
Damals bei der Wahl des Studiums war ja theologie auch sehr weit oben aber dafür h tte ich halt weiter fahren müssen mit der Bahn jeden Tag als ich bereit war Aha  ?	1	
Dann kann ich dir sagen wo ich bin , falls ich schon weiter bin oder noch nicht so weit  .	1	
Das geht echt zu weit das man meine Nummer weiter gibt	1	
Das ist weit weg Wir essen auf und reden noch weiter über Gott und die Welt Dann gehen wir raus	1	
Das ist weit weg Wir essen auf und reden noch weiter über Gott und die Welt er bezahlt und wir gehen raus	1	
Das ist weit weg Wir essen auf und reden noch weiter über Gott und die Welt er bezahlt und wir gehen raus Danke  .	1	
Den kann man weiter verkaufen oder so und mit 5 Euro kommt man nicht weit	1	
Dies ging noch ein paar mal soweiter , bis sie weit ge ffnet undeicht St hnend auf dem Rücken lag aber weiter schlief @moox	1	
Diggah du bist doch jetzt viel weiter als ich und so weit habe ich auch keine Erfahrung glaub mir ich h tte sie gern  .	1	
Doch tu ich aber Ich wei einfach nicht mehr weiter Du bist auch so weit weg Was kriege ich denn überhaupt mal hin	1	
Du bist tausend mal sch ner wie bei Schmeewittchen der Spiegel sagt weil er nett ist zur K nigin das sie sch n ist weil er aber trzd ein ehrlich Spiegel sein m chte sagt er das Schneewittchen noch vieeeel sch ner ist Nur weiter weg Du bist zum Glück nicht so weit weg und deshalb k nnen wir uns ja mal treffen	1	
Du das kann ich echt nicht sagen weil wenn ihr zimmer so weit leer ist muss ich mit meinem weiter machen	1	
#schlecht,	schlechter
Denn müsste es dir aber immer schlecht gehen Aufgrund der Tatsache das du kein schlechter Mensch bist	4	
Ich wollte nur sagen , das es mir sehr leid tut , das ich es nicht gemerkt habe das es dir schlecht geht und ich ein sehr schlechter Freund bin  .	2	
Mir geht / gings schlecht und er meint ich muss meine laube nicht an ihm auslassen hab nur schlecht gelaunt geschrieben weil als ob ich mit schlechter laune glücklich schreibe	2	
1 schlechter war sagte jemand du bist ja mega schlecht aber nur aus Spa	1	
Alles wird gut NinaGlaub mir , morgen nehm ich dich dann in den arm und wir gehen mit lukas zum Weihnachtsmarkt wo gute Laune herrscht und dann gehts dir hoffentlich ein bisschen besserIch kann dir aber auch noch oft genug sagen das du überhaupt kein schlechter Mensch bist , sie mal du warst immer für mich da egal wie schlecht es dir gerade ging und so , h r nich auf die anderen die das sagen die sind doch dann alle nich besser wenn sie sowas tolles wie dich verletzten	1	
Alles wird gut NinaGlaub mir , morgen nehm ich dich dann in den arm und wir gehen mit lukas zum Weihnachtsmarkt wo gute Laune herrscht und dann gehts dir hoffentlich ein bisschen besserIch kann dir aber auch noch oft genug sagen das du überhaupt kein schlechter Mensch bist , sie mal du warst immer für mich da egal wie schlecht es dir gerade ging und so , h r nich auf die anderen die das sagen die sind doch dann alle nich besser wenn sie sowas tolles wie dich verletzten Du bist toll nina und ich hab dich lieb fsl	1	
Also entweder du wirst mich wegen meinem Schnitt auslachen weil der so schlecht ist oder weil du viel schlechter bist und du findest ich würde übertreiben was ich nicht glaube	1	
Angeblich so schlecht , dass es schlechter garned mehr geht	1	
Baby es geht mir nicht alt so schlecht mir ist nur bissl schwindelig mehr nicht und dir geht es viel schlechter	1	
Besser als gestern wo es mir vorgestern noch schlechter ging sber tzd noch schlecht	1	
Bin ich noch schlechter darauf als ich mal schlecht drauf war weil meine mutter schlecht drauf war und auch schon mal schlecht drauf warst	1	
Bor Bist du schlecht Aber ich bin schlechter	1	
Dann bist du schlecht drauf und dann geht es mir noch schlechter	1	
Das du verstehst das es uns beiden schlecht geht und es ist egal wem es schlechter geht oder wem besser	1	
Das ist super das du nicht alleine bist aber sehr schlecht das es dir immer schlechter geht	1	
Deine verbindung ist schlechter als meine und meine ist schon mega schlecht	1	
Die leute die eig gut sind si d jetzt schlechter als die die schlecht sind wtf  ?	1	
Die sache ist die Ich bin zwar nicht glücklich mit dem wie mein leben momentan verl uftAber ansich ist es auch nicht schlecht es k nnte mir deutlich schlechter gehen als jetzt Soll ich mit meinem leben zufrieden sein wie es ist  ?	1	
Dir geht es Schei e und ich sage zu dir mir geht es auch schei e garkein bock mehr auf Leben und so würdest du dich nicht noch schlechter Fühlen und ich will nicht das es dir schlecht geht ich will nur das es dir gut geht nichts anderes	1	
Du , ich wei gar nicht ob das überhaupt noch schlechter geht , hahaIch fühle mich so schlecht wie noch nie zuvor und wei auch nicht ob es nur heute war oder ob ich	1	
Du bist kein schlechter ytber man kann natürlich was verbessern aber du bist net schlecht	1	
Du kannst mit mir echt über alles redeb weil wenn es dir schlecht geht geht es mir noch schlechter	1	
Du wirst immer schlechter , und das ist schlecht  .	1	
Egal wie schlecht dir ist , der Witz war schlechter	1	
Er ist so auf mich zugegangen und hat gefragt ob ich noch schlecht fühle und dann hab ich gesagt dass ich mich noch schlechter fühle weil ich mit dir zsm bin	1	
Gut gehts mir nie und schlecht sag ich nie weils mir sonst schlechter geht	1	
Habe ich dich so schlecht behandelt bin ich so schlechter fester partner	1	
Hans GlückNur weil die S-Bahn schlecht ist , musst man sie ja nicht noch schlechter machen und deren Nutzer hart auf die Nüsse gehen  .	1	
Hier ist so nh neue die glaube 30 ist und voll gut mit Laura ist Opfer hat immer so alte beste Freunde und die denkt auch die ist funny das einzige das lustig ist ist das sie nur ganz schlecht polnisch kann noch schlechter als ich	1	
Ich bin eh schon voll schlecht und so würdest du mich derma en ablenken das ich nicht schlechter bin	1	
Ich bin so schlecht im suchen und noch schlechter im finden	1	
Ich bin voll schlecht im tr sten weil ich Angst habe alles schlechter zu machen	1	
Ich frag mich auch alle paar Tage was du machen würdest wenn ich mal bei dir w r , ob du weitermachen würdest oder es lassen würdest , naja man erkennt im real halt auch wie schlecht nen Mensch eig is , ich w r sicherlich noch schlechter als ich es jz schon bin , so gesehen und gleich wieder abgeschoben da ich eh nix kann	1	
Ich fühle mich schlecht wenn ich es sage dir geht es viel schlechter als mir	1	
Ich glaub auch an karma ohne Witz aber bin halt nie schlecht zu irgendwem gewesen und bin kein schlechter Mensch	1	
Ich habe seitdem Schnupfen und kriege Nachts schlecht Luft auf meinem linken Ohr h re ich seitdem noch schlechter ich h re kaum noch was auf meinem linken Ohr	1	
Ich kann doch nicht mitfahren ich fühle mich schlecht und mim Fahrrad wirds noch schlechter	1	
Ich kannn schlecht Reimen aber ihr noch schlechter ironie verst ndis ist hier angesagt	1	
Ich leide ja auch darunter und es zieht mich auch voll runter , dass ich dich kaum noch seh , dir es immer schlechter geht und wenns dir schlecht geht , gehts mir auch schlecht  .	1	
Ich liebe sie echt sehr je mehr desto schlechter geht es mir wenn es ihr schlecht geht	1	
Ich schaff das einfach nicht mir geht es dirch den stress zu hause schon schlecht genug und das zus tzlich noch , dadurch geht es mir einfach noch schlechter und das schaffe ich einfach nicht	1	
Ich wollte dich nur mal was fragen und zwar wurde mir von mehreren Leuten aus meiner Freundesliste berichtet dass du dich auf ein Niveau herunter l sst was ich von dir nicht erwartet h tte und zwar sollst du einige aus meiner Kontaktliste auf Facebook und Freundesliste halt auf Facebook anschreiben bzw als Freunde annehmen um ihn dann zu schreiben wie schlecht ich doch bin was für ein schlechter Mensch ich doch bin ja also kannst du gerne weiterhin machen  .	1	
Ich wollte dich nur mal was fragen und zwar wurde mir von mehreren Leuten aus meiner Freundesliste berichtet dass du dich auf ein Niveau herunter l sst was ich von dir nicht erwartet h tte und zwar sollst du einige aus meiner Kontaktliste auf Facebook und Freundesliste halt auf Facebook anschreiben bzw als Freunde annehmen um ihn dann zu schreiben wie schlecht ich doch bin was für ein schlechter Mensch ich doch bin ja also kannst es	1	
In dem wo ich schlecht bin oder das wo ich noch schlechter bin	1	
Ja bist ja kein schlechter typ , ich mein nicer Charakter so wie ich dich bissel kenn und schlecht siehst auch ned aus	1	
Ja ich finde es traurig denn so ein schlechter Mensch ist dein Bruder nicht ihr wisst alle nicht wie schlecht es ihm eigentlich geht  .	1	
Ja ich fühle mich dann schlecht und das ich dir ned helfen kann und alles und das schlimmste ist das ich mich dann als freund schlecht fühle und denke das ich ein schlechter freund bin	1	
Ja klar aba wenn i ihr des sag gehts ihr schlecht und mir no schlechter	1	
Jaa und ich muss hoffen das es mit den urin und Blutproben gereicht hat weil ich hab um 10 gesagt ich kann nicht mehr mit ging es immer schlechter und selbst jetzt geht es mir noch ziemlich schlecht  .	1	
L Ja alles ok mir ist nur schlecht mir geht es noch schlechter als gestern	1	
#lang,	länger
#langsam,	langsamer
Mhmmm nahh genie t das Gefühl was er zu spüren bekommt und sein glied Pulsiert langsam etwas , wollte eigentlich erst wieder langsamer werden , aber da es ihr so gef llt beh lt er es so feste und schnell bei , lehnt seine stirn nun mehr an ihren hals und st hnt keuchend mit ihr	2	
Bei mir wolltest du da auch langsam machen warum willst du bei ihm nicht langsamer machen	1	
Ein langsamer Prozessor hei t , dass er langsam l dt  ?	1	
Haha ich hab von mcs chicken Nuggets gegessen und ich liebe die überalles und hab die richtig rein gestopft ich bin eigentlich ein sehr langsamer esser aber da bin ich nicht mehr so langsam	1	
Kannst du mir das Video langsam machen also noch langsamer  .	1	
Luhan Seufzte leise und lief langsamer Kris Nahm sie langsam raus	1	
Momo Ich wurde langsam ruhiger und auf mein schnell pochendes Herz wurde langsamer	1	
Nee ich will nich das du langsam machst ka ich mach immer etwas langsamer wenn ich	1	
Nee ich will nich das du langsam machst ka ich mach immer etwas langsamer wenn ich leise mache da mach ich auch nich so fest	1	
Ok und ja ich hab ja ned gesagt schnell ok mit Arschfick des machen wir ja auch langsam weist dan mavhma des auch langsam aber mit schlucken halt noch langsamer ok den des schmeckt dir ja ned so und musst ja manchmal kotzen und Arschfick tut halt weh was ich eig  .	1	
Robi freut sich so sehr auf dich aber bitte fahr morgen vorsichtig und wenn das wieder passiert Warnblinker an und langsamer werden und dann stehenbleiben die zeit hast du nur nicht panisch werden und langsam fahren weil Robi macht sich sehr gro e Sorgen um dich  !	1	
ich laufe langsam hinterher //ganz ruhig ich gehe einfach langsamer als sie und verwandel mich dann//	1	
rein babx und fange erst ganz langsam an baby und werde immer schneller dann werde ich wieder langsamer und sto e ganz dolle mein  .	1	
spürt das ihr hertz langsamer schl gt und bekommt langsam panick sucht nach einen Krankenhaus und findet eins huyen wen ich dir wichtig bin dan halte noch einwenig aus vertrau mir du wirst nicht sterben ich bitte dich halte noch ein bissien durch geht dan im Krankenhaus Hilfe wir brauchen hilfe schnell	1	
#leicht,	leichter
Am Ende m gliche Anzeichen zur Ver nderung , welche ich wahrnahm Abnehmen Kribbeln am Bauch leichten Druck am BauchK rperwachstum/lange Beine Kribbeln am Fu gelenk Kribbeln in den Fü en leichtes Ziehen im Unter- und Oberschenkel leicht taubes Gefühl an den Oberschenkeln leichter Schmerz an der Wirbels ule fteres streckenIch bin mir bewusst , dass die Erfolge mit Subliminals bei jeden individuell sind  .	6	
leichter seltsamer schmerz im Bauch , leicht freuchtes gefüllt  .	4	
Am Ende m gliche Anzeichen zur Ver nderung Abnehmen Kribbeln am Bauch leichten Druck am BauchK rperwachstum/lange Beine Kribbeln am Fu gelenk Kribbeln in den Fü en leichtes Ziehen im Unter- und Oberschenkel leicht taubes Gefühl an den Oberschenkeln leichter Schmerz an der Wirbels ule streckenIch bin mir bewusst , dass die Erfolge mit Subliminals bei jeden individuell sind  .	2	
Am Ende m gliche Anzeichen zur Ver nderung , welche ich wahrnahm Abnehmen Kribbeln am Bauch leichten Druck am BauchK rperwachstum/lange Beine Kribbeln am Fu gelenk Kribbeln in den Fü en leichtes Ziehen im Unter- und Oberschenkel leicht taubes Gefühl an den Oberschenkeln leichter Schmerz an der Wirbels ule fteres	1	
Am Ende m gliche Anzeichen zur Ver nderung Abnehmen Kribbeln am Bauch leichten Druck am BauchK rperwachstum/lange Beine Kribbeln am Fu gelenk Kribbeln in den Fü en leichtes Ziehen im Unter- und Oberschenkel leicht taubes Gefühl an den Oberschenkeln leichter Schmerz an der Wirbels ule strecken	1	
Da ist noch so leicht Pulli dabei , also so ein leichter	1	
Die kleben ja auch leicht und das macht es leichter den Ball zu fangen	1	
Du brauchst doch nicht denken das der junge sich um irgendwas selbst kümmert , ich meine beim bund die Ausbildung w r schwer gewesen und ihm f llt das lernen nicht leicht , so h tte er was vernünftiges leichter lernen k nnen und danach für das selbe geld zum bund gehen k nnen	1	
Du wei t auch , dass ich dich liebe mehr ala allea andere auf dieser welt ich glaube das hatten wir gekl rt aber trotzdem musst du verstehen dass es nicht leicht iat dich nicht zu sehen und es mir ohne grund auch nicht leichter gemacht wird  .	1	
Ja es ist nicht leicht aber wenn man viel durch hat f llt es einem leichter  .	1	
Ja klar ist es am Anfang nicht leicht aber es ist besser das sie es wei so kann sie dir besser helfen auch wenn sie jetut natürlich etwas traurig ist aber wie sollen Eltern halt reagieren wenn ihr Kind Depression hat das ist natürlich nicht leicht aber zusammen ist es leichter  !	1	
Ja natürlich f llt es mir dadurch noch leichter , mir f llt es auch so ziemlich leicht muss ich sagen , weil ich es ja von mir selber ver ndern will  .	1	
Sue es ist nicht leicht wird aber sp ter leichter nach und nach beruhigst du dich und fertig so l uft pupert t ab sollzest du eigebtkuch wissen	1	
T du bist si leicht wie emma vllt noch leichter	1	
Viel leichter vs viel leichter in Deutschland gewinnt viel leicht	1	
Wenn er jemanden schl gt und es auf einer Normalen erwachsen St rke ist dann sagt er es war leicht und so meint es dann auch so das es ein leichter schlag war	1	
Zieh ganz leicht damit sie es leichter hat es zur welt zu bringen und es im schlimmstenfall nicht stirbt	1	
ich sehe ihn an leichter gesagt als getan ich lehne mich leicht an ihn //ich will nicht hier sein//	1	
ja weil du es auch noch nicht ohne die versucht hast und es ist leicht zu behaupten das es mit ihnen leichter w r	1	
m gliche Anzeichen zur Ver nderung Abnehmen Kribbeln am Bauch leichten Druck am BauchK rperwachstum/lange Beine Kribbeln am Fu gelenk Kribbeln in den Fü en leichtes Ziehen im Unter- und Oberschenkel leicht taubes Gefühl an den Oberschenkeln leichter Schmerz an der Wirbels ule	1	
zu zweit ist es leichter aber nicht soooo leicht	1	
#kurz,	kürzer
Alle meinen immer das steht mirUnd ich hab halt überlegt ob ich mir meine haare kürzer schneide Aber natürlich nicht so kurz	1	
Alle meinen immer das steht mirUnd ich hab halt überlegt ob ich mir meine haare kürzer schneide Aber natürlich nicht so kurz Dann wei t du es jetzt	1	
Dann immer so auf schulterl nge bzw noch etwas kürzer und seit drei jahren so kurz	1	
Die sind irgendwie kurz und die eine noch kürzer	1	
Doch schon relativ kurz also denke nicht das es kürzer geht	1	
Hab heute meine Haare schneiden lassen , wollte sie eigentlich nur ein bisschen kürzer haben und was macht die , die schneidet die mir so schei e kurz alter  .	1	
Hallo karin , wir kommen morgen mittag mal kurz vorbei , ich hab n mlich noch ein shirt was kürzer gemacht werden muss für karneval , hat aber ja keine Eile	1	
Ich kann auch nix dafür , hab meine mam gefragt wie kurz das wird dann hat die das gezeigt aber das wurde halt kürzer	1	
Ich mach immer bis Schulter net kürzer bis Kinn , iat , mir zu , kurz	1	
Keine Ahnung das war jetzt kurz vor Drama und das obwohl die viel kürzer drin war	1	
Lang und dünn oder dick und kurz kurz ist das eig nicht aber kürzer als das andere	1	
Lass es einfach , dass wird nicht gut aussehen , lass se nh Stück kürzer schneiden aber never so kurz  .	1	
Ne ich schneide oben so kurz wie früher am Anfang und seiten noch kürzer so wie ich die seiten halt normal immer schneiden lasse	1	
Schnurrbart weg , eyebrows on fleek , haare kürzer weil alles kaputt is weg und n gel wieder obwohl die kurz sind alles für 10	1	
Soll ich meine Haare dann richtig kurz schneiden lassen oder nur bissl kürzer	1	
Und machst du jetzt kürzer oder doch nicht so kurz	1	
Unser Leben ist kurz genug , mach es nicht noch kürzer  .	1	
Wenn es zu mir kürzer ist , kannst du bestimmt auch kurz zu mir kommen  .	1	
Wie musst du die woche arbeiten & wie teuer ist bei euch ein normaler Herren haarschnitt trocken nur schneiden kurz an de seiten & oben kürzer & an der Seite oben ein Strich rein rasiert	1	
ach komm die seiten sind nur bissel kurz geraden der rest ist vllt 3 cm kürzer	1	
also diesmal habe ich auch etwas kürzer gemacht als sonst , aber das ist zu kurz	1	
eher in den sommer ferien mach ich die seiten ganz kurz und oben lass ich die entweder wachsen oder auch was kürzer	1	
#klein,	kleiner
Ok Also Alex is so mein kleiner bruda weil der halt so klein ist und aus 6  .	2	
So oder kürzer und sorry wegen face konnts net ndern weil des bild leider schon lter is und ganz ehrlich warum ich nur manvhmal lach weil meime augen dann voll klein simd und meim rechtes auge kleiner ist und dann siehtbdes schei e aus	2	
Aber am besten klein da du auch kleiner als ich bist	1	
Aber was ist mir wichtiger sch ner wohnen und mehr mit meinen Geld umgehen oder kleiner wohnen und alles eng und klein	1	
Ach Honey , ich bin klein , aber noch kleiner lass ich mich nicht machen  .	1	
Ach mein kleiner Brokkoli T , so klein bin ich nicht meine Zuckerwatte Er lief auf mich zu , beugte sich leicht zu mir runter und küsste mich  .	1	
Alle die kleiner sind als ich sind klein  .	1	
Alles was kleiner als 1 , 86 is is klein	1	
Alles was kleiner is als ich ist klein  .	1	
Als ob er so klein ist ich will nicht das er kleiner ist als ihr dan kan er nicht mein boyfriend sein	1	
Also erstens ich bin nicht klein und zweitens du bist kleiner	1	
Also ganz klein nichz mehr aber kleiner	1	
Auch wenn ich hohe svhuhe anhab bin ich trzd noch klein glaub mir sogar kleiner als gizem	1	
Bin ja auch klein aber du noch kleiner	1	
Bin lter als du ich kann dich klein kind nennen obwohl ich kleiner bin	1	
Bin lter als du ich kann dich klein kind nennen obwohl ich kleiner bin als du	1	
Bist aber klein Nagut im alter wird man auch wieder kleiner	1	
DOCH SARA DOCH du denkst wahrscheinlich deine sind klein aber meine nich kleiner xD	1	
Das die Gefühle ob gro ob klein waren immer da nur die werden halt kleiner und dann liebe ich halt meinen freund aber trz hatte ich immer kleine gefühle für dich egal ob gro ob klein	1	
Das in klein und mein K rper bisschen kleiner  ?	1	
Das ist ja egal wenn es klein ist rockt ea über den teppich also mein kleiner teppichporsche	1	
Deine Augen sind doch nicht klein meine Lippen sind viel kleiner	1	
Deine Hand ist nicht zu klein du bist nur inkompetent meine Hand ist kleiner und ich bekomms hin	1	
Der Ashbringer ist vollendet und ich bin ziemlich zufrieden und zugegeben auch ein klein wenig stolz Allerdings ist das nur ein kleiner Teil des gesamten Cosplays  .	1	
Der sieht so komisch aus wie er ist , der ist anderthalb K pfe kleiner als ich und sein vater ist einfach auch so klein , also sogar noch kleiner	1	
Deswegen bist du mein kleiner verrückter Bruder obwohl man klein nicht sagen kann	1	
Die ist g ttlich sü ich hatte die mal in der Hand und die war sooooooo klein war ein bisschen kleiner als meine Hand	1	
Doch war kleiner als ich also klein	1	
Du bist kleiner als ich als bist du schon klein	1	
Ey du kleiner maricon keine mund ziehen hier du klein sipi wenn du ich nochmal so was h re wirst du es bereuen kennst mich nicht also pssstt	1	
Gerne der ganz kleine hat jetzt auch die augen ge ffnet er ist so klein weil es ein kleiner albino ist	1	
Guck ma damit du wei t wie ich es meine Dann müssen wir es sehr klein machen , oder kleiner schreiben	1	
Hab ich dir aber auch schon ein paar mal gesagt aber ich merke das du eh nicht auf mich h rst was ich ich nicht verlange da es dein Leben ist bei dem ich ein kleiner Teil davon bin klein deswegen weil das Leben so gro ist	1	
Happy birthday kleiner Und jap du bist und bleibst immer klein für mich	1	
Hast du freunde die kleiner sind als du markiere paar weil ich auch klein bin es ist geil klein zu sein	1	
Hey , ich wei nicht was los , aber eins muss ich dir sagen , irgandwann kommt so ein kleiner spasst namens lukas , der sau klein is , aber 14 is kommt irgendwann montags  .	1	
Ich bin klein aber du bist kleiner	1	
Ich glaube nicht das ich kleiner bin als du bestimmt nicht so klein sind glaube fast gleich gro	1	
Ich hab zwei ltere nur die sind fasst kleiner als ich XD und ein klein Bruder	1	
Ich und mein kleiner voll knuffig und klein	1	
Irgend ein kleiner schaten oder so aber nur ganz ganz klein er hat jetzt alle Füllungen raus gemacht und eine neue gemacht	1	
Ja das mach ich auch nicht aber wenn er mit der zsm kommen würde ich würd den so auslachen alter die is richtig klein ich glaub 1 1 / 2 k pfe kleiner wie ich und is erst 1 jahr bei uns auf der schule also deutschlqnd	1	
Ja ich fühle mich immer voll klein und jung neben allen anderen Mein Freund rgert mich immer weil ich kleiner und jünger bin als er	1	
Ja sie ist so klein wie die Hexe , und sie kann sich noch kleiner machen , sodass man sie nicht sieht und macht dann ein Angriff , dass ist richtig creepy , kannst ja mal von Kathie die letzte DbD Folge gucken da sieht man das	1	
Jimin ist zwar mega klein , aber auch nur 6 cm kleiner als Jungkook  .	1	
Jo kp love is love aber zB ich bin sehr klein würde es komisch finden w re mein freund so kleiner haha	1	
Lars sein kleiner bro sieht 1zu1 aus wie er in klein	1	
Lol das sieht wirklich sehr gro aus o im Buch wurden sie kleiner beschrieben und im Film waren sie ach klein o  .	1	
Lol meine Mom kauft und ne neue Hose und für sich ne Nummer kleiner aber das ist ihr zu klein	1	
Lol meine Mom kauft und ne neue Hose und für sich ne Nummer kleiner aber das ist ihr zu klein jetz mussten wir tauschen	1	
#scharf,	schärfer
#sicher,	sicherer
Ich bin mir langsam sicher das wir eine gemeinsame zukunft haben wir werden sicherer in unserem handeln dem anderen gegenüber uns zu verstehen und festigen so unsere bezihung du wolltest gestern zwar nicht das ich vorbeikomme und dir helfe aber ich fand es hat dir gut getan das ich da war du hast gemerkt das ich auch in schwerwn zeiten ruhe bewahren kann und das beste für dich und kinder bzw kind tun kann auvh wenn es mir selbst nicht gerade gut geht	1	
Ich hab nicht gesagt das es komplett sicher ist , aber sicherer als mitm zug und dann irgendwo im nirgendwo alleine rum h ngen	1	
Ja ich bin mir da wirklich sehr sehr sehr sehr sehr sehr sicher und noch 1000 mal sicherer	1	
Ja so sicher das es nicht mehr sicherer geht	1	
Man kann es am 1sten Tag der periode nehmen da ist es sicherer oder man kann es danach nehmen da dauert es l nger bis es sicher ist  .	1	
So sicher das ich mir sicherer nicht sein kann	1	
So sicher wie nie zuvor Das einzige mal wo ich noch sicherer war , war der Moment wo ich mit dir zsm gekommen bin	1	
Und ich bin mir sicher dass du nach den prüfungen dich schon bald wieder sicherer fühlst , das ist gerade in der situation normal unsicher zu sein	1	
W re es nicht klüger du kaufst eine dir vertraue ich das viel mehr zu und kennst dich aus und so , und da du sowieso mit deiner CD kommst , geht das sicher besser , schneller und vor allem sicherer  .	1	
#kalt,	kälter
#gut,	besser
Seid dem fühle ich mich wirklich gut und kann morgens viel besser in den Tag starten  .	18	
lys und fotos und schicken und vlt auch noch Briefe du bist alles für mich bitte ver ndere dich nicht für ein anderen Love you so much bby Ich danke dir für alles Wenn es dir morgen in der schule nicht gut geht gehe ichit dir sofort ins krankenzimmer bist es dir besser geht ich würde um dich k mpfen wenn wir streit h tten wir werden für immer und ewig die besten Freunde bleiben  !	17	
Wusstest du-Küssen ist gesund-Bananen sind gut für Kr mpfe Hühnersuppe l sst dich tats chlich besser fühlen-Es ist wahr  .	15	
Manchmal ist nicht die Frage , mit wem es dir gut geht , sondern ohne wen es dir besser geht  .	14	
Einen wundersch nen guten morgen mein schatz ich hoffe das du sehr gut geschlafen hast und es dir jetzt ein bisschen besser geht  .	13	
Einen wundersch nen guten Morgen mein Schatz konntest du gut einschlafen und ist dein Kopfweh jetzt besser  ?	12	
Wusstest du-Küssen ist gesund-Bananen sind gut für Kr mpfe-Hühnersuppe l sst dich tats chlich besser fühlen-Es ist wahr  .	12	
2 min sp ter , jetzt bin ich traurig , weil das Nutella so gut schmeckt , aber ich besser nix mehr l ffeln sollte  .	11	
Mir geht es zwar nicht gut , aber das wird wieder besser Versprochen  !	11	
Aber ich will halt immernoch den Grund von dir erfahren , warum es nicht gut ist , warum es deiner Meinung nach besser so ist und warum in dir was sagt tus nicht  !	9	
Dann Ruhe dich mal gut aus das es dir schnell wieder besser geht und ja  .	9	
Naja heute ist ja auch Montag vielleicht liegt es daran Schlafen ist immer gut danach fühlt man sich meistens besser	9	
Mal ehrlich du hast mehr erreicht als so gut wie alle in dieser bekackten Generation und mehr als alle die ich kenn du hast das tanzen du bist gut in der schule du bist in so vielem besser als ich auch wenn du das kontern wirst Du bist viel besser als jeder der ich kenne und sagst mir du hast nix erreicht  ?	8	
Ach Mensch was ein Mist , dann ruhe und Kuriere dich mal gut aus , dass es dir ganz schnell wieder besser geht  .	7	
Ich hoffe dir geht es besser und du konntest auch gut schlafen  ?	7	
Vertrauen ist gut , Kontrolle ist besser	7	
trotzdem haben wir die freien Stunden so gut es geht ausgenutzt die naechsten Wochen werden auch nicht viel besser aber ich hoffe dass wenigstens das Wetter immer besser wird  .	7	
was ich h tte anders und besser machen k nnen und dabei fallen mir so viele sachen ein aber gut ich kanns nicht ndern  .	7	
Guten Morgen mein Engel ja ich hab gut geschlafen und ja mir gehts ein bisschen besser	6	
Hallo Mama hoffe dir geht es so weit gut Mir geht es etwas besser Bin halt blo noch etwas schlapp  .	6	
Hi Anita wollte mal kurz nach fragen wie es dir denn heute geht Mir ging es die Nacht über haupt nicht gut Ich glaube ich hatte Fieber Wenn es bis Montag morgen nicht besser ist gehe ich lieber mal zum Arzt  .	6	
Hi Anita wollte mich nur mal kurz melden Weil ich wach bin Hoffe dir geht es gut Mir geht es etwas besser  .	6	
Hi meine sü e hoffe dir geht es gut Also gestern habe ich mich besser gefühlt  .	6	
Ich finde es besser , wenn man es mit der Beziehung langsam angeht und dann in eine gut aufgebaute Beziehung geht  .	6	
Nichts hilft besser wenn man sich nicht so gut fühlt die Bedingungslose Liebe eined Hundes mein kleines flauschiges , kuscheliges , weises Prinzesschen mit keinem Geld der Welt zu bezahlen , Hundemamaundstolz , zwangspause , Couching , kuscheln , fu schonen , Fersensporn , liebe , bedingungslos , sternchen , Kuschelzeit , kuscheldecke , pirced , tattooedgirl	6	
sie m gen dich wenn du gut bist und hassen dich wenn du besser bist als sie	6	
Ganz gut , w r besser mit dir	5	
Guten Morgen mein Liebling Ich hoffe du konntest gut schlafen und es geht deinem Bauch besser  ?	5	
Hallo ihr lieben hoffe euch geht es gut Ich bin seit 3 Tagen wieder mal krank Gestern ging ges mir besser  .	5	
Hi Alice das tut mir leid das es dir nicht so gut geht Dann wünsche ich dir eine gute Besserung Das es dir ganz schnell wieder besser geht Mir geht es auch nicht ganz so gut Hatte ja gestern denn Termin wegen der Untersuchung meiner Blase  .	5	
Hi Anita hoffe dir geht es heute etwas besser Mir geht es nicht gut Seit 2 Tagen wird mir st ndig Schwindlig und schwarz vor denn Augen  .	5	
Ich Wünsche euch allen ein Sch nes neues Jahr , das ihr im Jahr 2018 alle glücklich seid und fals das jahr 2017 nicht so gut gelaufen ist dass , das Jahr 2018 besser wird  .	5	
Ja das weis ich aber alles gut liebes hab da so meine strecken die ich laufe da ist meist nichts los Sitze aber nun auch schon in der bahn Ja wie ich schon schrieb ich kann mir das alles sehr gut vorstellen wie es dir gerade geht aber es wird besser und ob jemand nur das eine m chte das merkste eigendlich schon ziemlich fix Gib dir selber jetzt erstmal zeit alles zu realisieren sowie zu verarbeiten  .	5	
Morgen spatz Ich bin krank geschrieben rs vieren aber mir geht es schon langsam besser und ansteckend bin ich zum Glück auch net mehr und ansonsten ist alles gut bei uns Ganz ehrlich  .	5	
Wenn ihr alle der meinung seit das Katzen Qu len , wenn sie doch eigentlich tot krank sind , nur damit es dem Menschen besser geht , in Ordnung findet dann ist das ja auch sch n und gut  .	5	
gute nacht schatz sorry aber muss morgen früh raus ja schlaf gut , tr um was sch nes und hoffentlich gehts dir morgen besser ich liebe dich über alles und du bist alles  !	5	
Aber ich muss sagen , heut gehts schon besser haben gestern extra Futter gekauft , von dem ich gedacht hab des kommt gut an , weil des viele Katzenbesitzer auch loben und denen ihre des m gen  .	4	
Auch gut aber mit dir noch besser	4	
Dann sag doch dir ist net gut und wolltest warten bis es besser ist	4	
Es klappt eh nicht mit uns und es ist eh besser wenn wir nur Freunde sind weil wir uns so gut wie nie sehen	4	
Es regt mich halt einfach auf , wenn irgendjemand total schei e behandelt wir , nur weil er ein falsches Wort gesagt hat , irgendwas nicht so gut kann , wie jemand anders , was besser wusste , oder was weis denn ich Und ganz besonders schei e finde ich das bei Ausl nder  .	4	
Guten Morgen baby Hoffe du hast einigerma en gut gepennt Hoffe es geht dir besser und du kannst in die Schule Pass auf dich auf mein Engel Sei vorsichtig  !	4	
Guten Morgen mein Schatz es ist alles gut , mir geht es besser  .	4	
Guten morgen mein Schatz ich wünsche dir einen guten morgen , ich hoffe du hast gut geschlafen und das es dir heute besser geht wegen übelkeit  .	4	
Hallo Conny , danke , mir gehts besser , viel Arbeit , viel ablenken , ist auch gut  .	4	
Hey Ich wei es ist jetzt nicht so gut ausgeschnitten und so aber habe es nicht besser hinbekommen Bye , concrafter , besteryoutuber , lucrew , Bearbeitetet , selfmade , loveyou	4	
Hey ich gehe früh pennen tut mir leid aber k nnen wir erste pause reden pers nlich is des eh nochmal besser hal nur zu zweit und vergesse es nich hab dich lieb schlaf gut und tr um sü bis der beste bruder den ich wünschen k nnte	4	
Hi Mausi Oh du arme hoffe echt das es dir bald besser geht mit dem Reha Sport Das ist gut das du einen Termin beim Orthop den hast  .	4	
Huhu , besser ja , aber irgendwie nicht wirklich gut  .	4	
Ich find auch es l uft gut , und wird immer besser p was auszusetzen hab ich nicht um ehrlich zu sein und das muss was hei rn klar gibts n paar sachen die ich mir wünschen würde aber das sind dann eher extras haha z  .	4	
#hoch,	höcher
#schwach,	schwächer
#klug,	klüger
Du bist klug aber bist vom denken her nicht klüger als ich	1	
#kalt,	kälter
#großartig,	großartiger
#hart,	härter
#leicht,	leichtst
#merkwürdig,	merkwürdigst
#kalt,	kältest
#scharf,	schärfst
#warm,	wärmst
#stark,	stärkst
#seltsam,	seltsamst
#niedrig,	niedrigst
#weit,	weitest
#klein,	kleinst
#kalt,	kältest
#schön,	schönst
#heiß,	heißest
#lang,	längst
#schwach,	schwächst
#leicht,	leichtest
#klug,	klügst
#hoch,	höchst
#groß,	größt
#schmackhaft,	schmackhaftest
#jung,	jüngst
#schlecht,	schlechtest
Quatsch ich denke dann halt das du was schlechtest von mir denkst aber ich habe niemals gesagt oder gedacht das es schlecht oder zu klein ist	1	
#schnell,	schnellst
Ok , w re halt gut , wenn es so schnell wie m glich w re , will alles schnellst m glich weg haben	1	
Um 11 und um den Krankenschein kümmere ich mich schnellst m glich ich bring nur schnell die Kinder zur kita und geh dann direkt zum arzt	1	
ja sollte durchfall zukommen melde dich dann treffen wir uns schnell geb ich dir reis und kohletablette dann sollte schnellst alles gut sein  .	1	
#alt,	ältst
#schnell,	schnellst
Ok , w re halt gut , wenn es so schnell wie m glich w re , will alles schnellst m glich weg haben	1	
Um 11 und um den Krankenschein kümmere ich mich schnellst m glich ich bring nur schnell die Kinder zur kita und geh dann direkt zum arzt	1	
ja sollte durchfall zukommen melde dich dann treffen wir uns schnell geb ich dir reis und kohletablette dann sollte schnellst alles gut sein  .	1	
#hell,	hellst
#stark,	stärkst
#groß,	größt
#langsam,	langsamst
#kurz,	kürzst
#gut,	best
Aber iwann kommt die Person die dich umhaut und das ich mal wider ne best digung bekommen habe das ich einem menschen gut tue freut mich ich habe es noch nie so geh rt  !	6	
Das ist alles von mir sry ich lag mit Magen Darm flach und heute ist unser Haus fast abgebrannt also falls ihr heute noch nicht auf Facebook ward oder Lokalplus gesehen habt hier die best tigung bei uns hats gebrannt uns allen gehts gut und es haus steht zum glück noch	3	
Hoy mein best Friend , ich hoffe das euch alle gut geht  ?	3	
Ihr seit best buddies Ich bin in letzter zeit blo nicht gut drauf zu sprechen  .	3	
Also ich kann die anderen irgendwie verstehen immer wenn es bei uns einen Überraschungstest gab hatte ich immer schon ein ungutes Gefühl , hat sich meistens auch best tigt hast du gut gemacht	2	
Das tut mir leid , gut dass sich der Verdacht nicht best tigt hat  !	2	
Ja ich freue mich auch so mega und ende des Jahres kommt bo 4 das wird mega ohne rumgefliege das haben sie best tigt Sch n das es dir besser geht Mir geht es heute soweit gut au er das ich mich immer noch nicht daran gew hnen kann das nimmer da bist	2	
Aber da du in der regek perfekt bist und regeln bekanntlich Ausnahmen best tigen is das gut wenn du in etwas nicht perfekt bist	1	
Ach du schei e , gut das es sich nicht best tigt hat und das mit deinem Vater tut mir für dich richtig Leid  !	1	
Alles gut , ich dachte es mir schon und brauchte nur ne best tiung	1	
Alles gut danke das ist schon einfach gut zu h ren aber best rkt mich ich in meiner meinung	1	
Alter so wib Türke den ich kenne der ist ziemlich gut mit ubs befreundet hat uns allen D ner spendiert aus seinem laden best	1	
Bin in meinem Bett meiner best n Bestell ihr gut	1	
Bitte du kannst selbst sophia fragen und sie kann es best tigen das ich gut reden kann	1	
Dann sollten kein anderen Gefühle da sein , aber gut das sich das auch best tigt hat	1	
Das best tigt meine Theorie Der Stress kommt den Schüler nicht gut	1	
Das sollte Kookie nur nochmal best tigen , dass er alles gut  .	1	
Der Moment wenn man ausrastet das leute best tigen dass man gut aussieht ;	1	
Die überweisen dir eine gut Schrift ich brauch den Best tigungs Code dann ist dein konto best tigt	1	
Diese kündigung würde ich entweder pers nlich abgeben und best tigen lassen , wenn du dich mit dem Chef gut verstehst , oder durch eine Bevollm chtigte person hinbringen lassen und quittieren lassen  .	1	
Ei gut wenn dirs so wichtig is dann mache ma es best gleich Schluss  .	1	
Frag Pascal , der wird dir best tigen , dass das gut ist	1	
Ganz erlich wenn die mit lisa ein auf best frens macht dann kan sie genau so gut mit ihr arbeite	1	
Gute nacht schlaf auch gut lass da nicht argern bis morgen früh lieb da ich best friends	1	
H ttest du es ned best tigt w re alles gut	1	
Hab doch schon best tigt das du gut ausschaust	1	
Hab geliked bin ich gut hab sogar comment gemacht ich bin der best ik	1	
Haha nein alles gut aber dachte ihr seid best friends  ?	1	
Hat farbe my best to the Future gut und zu zwei Jahren the Future gut und dir sagen das ich dich auch nicht mehr so	1	
Hey ich bins celine ich wollte dir nur mal sagen das deine Freundin sich mit typen sehr lange umarmt , an deren angeleckten eis leckt , mit den sch kert , sich ihre hand streicheln l sst du hast ein recht das zu erfahren glaub mir oder nicht das ist deine Entscheidung aber viele aus meiner Klasse k nnen das best tigen lg celine ich meine es nur gut mir dir	1	
Hi was machst so that you can be the best in was ist mit dem ich dich nicht so gut aus und	1	
Ich finde es trotzdem gut , mir sowas anzusehen , das best rkt mich in meiner Entscheidung mir meine Kirche nach Pfarrer und nicht nach Wohnort auszusuchen und ansonsten gar nicht hin zu gehen  .	1	
Ich hab heute schei e gebaut was best tigt das ich dir nicht gut tue	1	
Ich hab heute schei e gebaut was best tigt das ich dir nicht gut tur	1	
Ich kann best tigen der kuchen schmeckt gut	1	
Ich kann nicht gut mit girls sein au er bei best gf	1	
Ich kenne sie nicht so gut und das habe ich auch nur aufgeschnappt und sie hat es mir best tigt aber wir haben keinen richtigen Kontakt	1	
Ich liebe Pusteblume und mehr sie ist die beste die man habeb kann sie ist schmell sch n und sie ist so gut in Galob sie ist die aller best	1	
Ina sehr gut kann ich nur best tigen war ne gute idee hier zu übernachten Paul na auch schon wach	1	
Ist alles gut wurde nur ein gerücht verbreitet , was gestern als falsch best tigt wurde  !	1	
Ja aber die mehrheit best tigt ja das es wichtiger ist gut auszusehen umd des tut sie ja offensichtlich imgegensatz zu mir und anderen personen des p bels	1	
Ja das tut gut , das kann ich best tigen	1	
Ja denn p tty kenne ich sehr gut das ist mein best bro und best aller bester freund Der jan aus dem Lager ja hat sich in mich verguggt Und der jan aus der zespannung denn kenn ich noch nicht so gut deswegen weis ich nicht ob er dazu geh rt	1	
Ja dir best tigung hat der chef noch Das Praktikum lief sehr gut	1	
Ja hat sich aber nicht best tigt manche Blutwerte waren nich so gut	1	
Ja ne das ist ne Fruktose Intoleranz das ist best tigt dar nur bestimmte Lebensmittel nicht essen sonst gehts mir gut ja konnte ja vorher nicht viel machen deshalb muss mal arbeiten so	1	
Ja und du hast das gut gemacht das sagen und best tigen alle wir waren ein team jetzt ist es nicht mehr	1	
Ja war nur nochma zur best tiung , voll gut	1	
Jo ich weis bescheid wir haben schon gequatscht untrr einander alles gut sind ja seit 10 jahren best friends	1	
Maja dein Kette ist das ist das gut weil du wolltest ja best haben  ?	1	
#dunkel,	dunklst
#glücklich,	glücklichst
