#Stockholm,	Schweden
Aber Schweden ist trotzdem geil und Stockholm voll die sch ne Stadf	1	
In Schweden hat Melfest in der Friends Arena in Stockholm stattgefunden da wurde der ESC 2016 ausgetragen und die Halle war proppenvoll , das hei t 11  .	1	
#Manila,	Philippinen
Also Manila is auf den Philippinen	1	
#Brüssel,	Belgien
#Luanda,	Angola
#Nikosia,	Zypern
Nikosia ist die Hauptstadt von Zypern du ei	1	
#Caracas,	Venezuela
#Minsk,	Belarus
#Tiflis,	Georgien
#Libreville,	Gabun
#Tegucigalpa,	Honduras
#Wien,	Österreich
#Warschau,	Polen
#Berlin,	Deutschland
Berlin ist meine zweit liebste Stadt in Deutschland  .	1	
Das gr te Einkauf Center Deutschland bis Mall of Berlin kam was dann zum gr ten Europas wurde	1	
Gut dann bis morgen und einen guten Start ins Wochenende in Berlin und hat sich auf dem Weg nach Deutschland zu kommen weil wir freunde sein aber ich	1	
In gewisser Hinsicht ist das Onlineshopping auch sicher , denn was für Gefahren in den Innenst dten lauern sieht man ja am Anschlag in Berlin und anderen St dten in Deutschland und der Welt  .	1	
Ja Berlin ist die Hauptstadt aber auch die gr te in Deutschland Ankara ist die hauptstadt doch Istanbul ist die gr te stadt oder wieso sind bei russland die zwei Punkte einfach nur weil schilabins ziemlich gro ist und wieso ist wol bei Irland keine hauptstadt drinne  ?	1	
Ja f nde ich auch nicht schlecht dann kenne ich schon mal jemanden und das Vegane Angebot in Berlin soll auch sehr gut sein und es gibt so ein Veganes Stra enfest und wenn Stars nach Deutschland kommen , dann gehen die meistens auch immer nach Berlin	1	
Ja f nde ich auch nicht schlecht dann kenne ich schon mal jemanden und das Vegane Angebot in Berlin soll auch sehr gut sein und es gibt so ein Veganes Stra enfest und wenn Stars nach Deutschland kommen , dann gehen die meistens auch immer nach Berlin dann muss ich nicht mehr hin fahren	1	
Ja f nde ich auch nicht schlecht dann kenne ich schon mal jemanden und das Vegane Angebot in Berlin soll auch sehr gut sein und es gibt so ein Veganes Stra enfest und wenn Stars nach Deutschland kommen , dann gehen die meistens auch immer nach Berlin dann muss ich nicht mehr hin fahren hat schon echt Vorteile	1	
Ja f nde ich auch nicht schlecht dann kenne ich schon mal jemanden und das Vegane Angebot in Berlin soll auch sehr gut sein und wenn Stars nach Deutschland kommen , dann gehen die meistens auch immer nach Berlin	1	
Oh ich vermisse Deutschland Und auch mein Berlin	1	
Ok schade Berlin ist meine zweit liebste Stadt in Deutschland	1	
Tickets kann heute ab 10 Uhr kaufen , und ich kann mir vorstellen dass die ziemlich schnell weg sein k nnten weil die Halle wohl nicht so gro ist und das in Berlin das einzige in Deutschland ist	1	
#Islamabad,	Pakistan
#Bern,	Schweiz
Ein stiefvater arbeitet in die Schweiz , in der N he von Bern	2	
Hauptsache der Pisser muss dann seine eigene schei Praxis in der Schweiz machen und das auch noch in Bern  .	1	
#Lima,	Peru
#Accra,	Ghana
#Tripolis,	Libyen
#Gaborone,	Botswana
#Manama,	Bahrain
#Bratislava,	Slovakia
#Canberra,	Australien
#Kampala,	Uganda
#Kathmandu,	Nepal
#Lissabon,	Portugal
#Apia,	Samoa
#Belgrad,	Serbien
#Jakarta,	Indonesien
#Lilongwe,	Malawi
#Ljubljana,	Slowenien
#Moskau,	Russland
Moskow Moskau werft die Gl ser an die wand Russland ist ein sch nes Land hahahaha HEY	2	
Er is in Russland geboren worden um genau zu sein in Moskau	1	
#Tirana,	Tirana
#Ottawa,	Kanada
#Nairobi,	Kenia
#Kopenhagen,	Dänemark
#Niamey,	Niger
#Abuja,	Nigeria
#Windhoek,	Namibia
#Podgorica,	Montenegro
#Polen,	Zloty
Mutti kann man in Polen beim geld wechseln auch Zloty Münzen in Geldscheine wechseln  ?	1	
#Vietnam,	Dong
#Angola,	Kwanza
#Japan,	Yen
Hat in Japan knapp 10 Milliarden Yen eingespielt und das verdient  .	1	
#Lettland,	Lats
#Litauen,	Litas
#Ungarn,	Forint
#Armenien,	Darm
#Thailand,	Bäht
#Nigeria,	Naira
#Ukraine,	Hrywna
#Kroatien,	Kuna
#Kambodscha,	Riel
#Europa,	Euro
12 , Euro und 15 , Europa das ist doch billig	1	
Ja jung ich gebe dir die 20 Europa für die Festplatte dann braust du nur noch 10 Euro für PUBG	1	
Wie viel soll ich mit nehmen also ich brauche ja 18 Euro oder so für mich und 5 Europa oder so für die karte von jessi nh	1	
#Malaysia,	Ringglt
#Bulgarien,	Lew
#Wichita,	Kansas
#Akron,	Ohio
#Irvine,	Kalifornien
#Toledo,	Ohio
#Indianapolis,	Indiana
#Denver,	Colorado
#Milwaukee,	Wisconsin
#Reno,	Nevada
#Boston,	Massachusetts
#Minneapolis,	Minnesota
#Bakersfield,	Kalifornien
#Henderson,	Nevada
#Seattle,	Washington
#Atlanta,	Georgia
#Chandler,	Arizona
#Dallas,	Texas
#Madison,	Wisconsin
#Tampa,	Florida
#Tallahassee,	Florida
#Irving,	Texas
#Fontana,	Kalifornien
#Anaheim,	Kalifornien
#Fresni,	Kalifornien
#Amarillo,	Texas
#Hialeah,	Florida
#Pittsburgh,	Pennsylvania
#Austin,	Texas
