#süß,	süßest
#Thailand,	thailändisch
#Indien,	indisch
#Portugal,	portugiesisch
#Belarus,	belarussisch
#Schweden,	schwedisch
Fals du fragst er kommt aus Schweden und singt da ja halt schwedisch	1	
#Spanien,	spanisch
Ich jab bock auf Spanien ich will aicj spanisch sprechen das ist sexy	1	
Ja sowas mache ich nicht Kann nur paar Beleidigungen weil ich in Spanien war und mein lieblings rapper auch spanisch spricht Warte ich google kurz	1	
#Mexiko,	mexikanisch
#Brasilien,	brasilianisch
#China,	chinesisch
#Peru,	peruanisch
#Argentinien,	argentinisch
#Korea,	koreanisch
Das habe ich immer gesagt und erst als ich mit Korea angefangen habe , habsch gemerkt das ich da immer koreanisch gesprochen hab	1	
#Ägypten,	ägyptisch
#Ukraine,	ukrainisch
#Australien,	australisch
#Russland,	russisch
Bin in Deutschland geboren eltern in Kasachstan ist in so wie Russland spreche auch selbst russisch	1	
Ich komme aus Russland und ich spreche russisch aber es hei t nicht das ich eine russe bin	1	
#Japan,	japanisch
#Kambodscha,	kambodschanisch
#Griechenland,	griechisch
Hab mir in Griechenland ein buch auf griechisch gekauft weil ich nicht so schnell lesen kann wegen anderem Alphabet und so	1	
#Niederlande,	niederländisch
#Polen,	polnisch
Das ist polnisch , meine Oma stammt aus Polen und das hei t , ein Leben voller Leid , Trauer und Unverst ndnis  !	1	
Der Veranstalter also der Mann mit dem meine Schwester singt kommt eigentlich aus München , aber der singt halt gerne in Polen und versucht auch polnisch zu reden und deswegen kommen halt auch andere deutsche S nger  .	1	
Mein opa konnte polnisch weil er und meine oma in dem jzigen Polen gelebt haben ostpreu en das war damals Deutschland	1	
#Irland,	irisch
#Slowakei,	slowakisch
Ich wohne nicht in der Slowakei weil ich nicht der beste in slowakisch bin	1	
#Albanien,	albanisch
Ich glaub der kommt aus Albanien zumindest ist sein Status auf albanisch	1	
#Chile,	chilenisch
#Deutschland,	deutsch
Also dafür das er Brasilianer is und 10 monate lang in Deutschland schon lebt , kann er echt mega gut deutsch	2	
Bin ich etwa so deutsch das selbst meine abgeheilte brandblase aussieht wie Deutschland  ?	2	
Kein problem weil in Deutschland wir brauchen nur deutsch Sprechen	2	
@lbd1474 Alter wir sind hier in Deutschland also du Hurensohn lern deutsch	1	
@marius44 ich spreche deutsch weil ich in Deutschland seit 4 jahren bin	1	
Aber ich finde es auch auf englisch sch n , denn ich denke auch hier in Deutschland werden sternchen geboren deren eltern nicht so gut deutsch verstehen  .	1	
Als ich neu in Deutschland gekommen Neee ich k nnte auch garkein deutsch dann war ich in woche zwei tag bei mein nochbar die hat mich zu viel geholfen	1	
Also ich hab mir gedacht dass irgendwie in den Nachrichten kommt dass ein berühmter Schauspieler namens James Connor nach Deutschland zurück kommt ich wei der Name ist nicht sonderlich deutsch	1	
Also in Syrien dürfre ich nicht zur Schule weil garkein Schule nah an uns war und das war zu gef hrlich zur Schule zu gehen es gibt ja Krieg und ich war in die scgule seid 2 jahre erst also ich bin 2 jahre in Deutschland und als ich neu in deutsch Land war war ich erst in eine schule Klasse ABC	1	
Alta kannst du deutsch wir sind in Deutschland	1	
Anton 0 jahre alt kann kein deutsch ist aber in Deutschland geboren  .	1	
Bitte auf deutsch wir sind in Deutschland nicht in irak	1	
Das deutsch muss auch Stimmen also ist fantastisch scheinbar nicht aus Deutschland	1	
Der spricht auch deutsch und lebt auch in Deutschland du Schlaumeier	1	
Deutschland aber mein vater ist Italiener also bin ich hab deutsch halb italienisch	1	
Deutschland ist Deutschland und hier muss man deutsch reden als deutscher HAHAHAHAHA ich kack ab nur ma so hier darf man reden was man will	1	
Die Deutschland flage ist in mein deutsch Unterricht	1	
Entschuldigung aber ich kann nicht so gut deutsch reden ich bin hier neue in Deutschland	1	
Er hat aber auch Deutschland vergr ert und lern deutsch	1	
Er meint so das russland arm ist und Putin die Wahl kontrolliert der ist ja 17 Jahre president und das geht eigentlich und langsam merken das alle leute und 2018 wir neu gew hlt und wird putin Gewinnen wird er in 2 jahren nach Deutschland kommen weil er in seiner schule 11 jahre deutsch gelernt hat	1	
Er meint so das russland arm ist und Putin die Wahl kontrolliert der ist ja 17 Jahre president und das geht eigentlich und langsam merken das alle leute und 2018 wir neu gew hlt und wird putin Gewinnen wird er in 2 jahren nach Deutschland kommen weil er in seiner schule 11 jahre deutsch gelernt hat der benutzt irgendso eine App um Drogen zu bekommen	1	
Hab ich doch dir gesagt es geht um ein Russe der ist neu in Deutschland er kann nicht deutsch sprechen er will mit die andere Fu ball spielen aber er kann nicht sagen danach kommt ein bald er schi allrme qucken dis das ananas und so	1	
Halb deutsch , ein viertel Polen aber das hat damals zu Deutschland geh rt also dreiviertel Deutsch , und ein viertel aus Syrien wegen meinem schei opa	1	
Hallooooo , wir sind hier in Deutschland , wo ist dein deutsch hin	1	
Ich bin mit 10 nach Deutschland und hab auf n Zeugnis 1 , 4 in deutsch	1	
Ich ferstehe dich nicht eir sind ihn Deutschland da spricht man deutsch	1	
Ich finde das witzig ich bin in Deutschland geboren aber kann mehr Russisch als deutsch haah Normal	1	
Ich kam ja vor 3 jahren nach Deutschland und ich konnte kein wort und war im so ne klasse fürs deutsch lernen und wurde 1 Jahrgang runtergeschoben	1	
Ich spreche deutsch als w hre ich 3 Tage in Deutschland	1	
Ich war letztes Jahr in Holland Da Kannst du deutsch reden die verstehen Dich die reden auch Deutschland	1	
Ich wohne in Deutschland da muss man deutsch beherschen kein mathe	1	
Ich würde in Deutschland geboren aber meine Eltern aber die k nnen sehr gut deutsch	1	
Ka mansche wohnen wo anders und k nnen deutsch er hat glaub ich früher in Deutschland gewohnt	1	
Lasst doch mal Paula in Ruhe auch wenn er schwarz ist kann er deutsch sein wenn er in Deutschland geboren ist , ist er deutsch egal was für eltern er hat oder schonmal was geh rt das man sich sonnen kann	1	
Mein deutsch wird sich aber noch verbessern wir gehen ja eben zu Deutschland wohnen aber ka wohin habe ja noch Zeit bis zum Summer	1	
Meine Mutter ist 22 jahre in Deutschland und kann kein deutsch also lass den yapsen zeit	1	
Naja , ich bin in Deutschland geboren aber kann halb Wegs deutsch so , bei mir ist es ich hab ein Problem bei der sprache	1	
Ne aber wo ich nach Deutschland gekommen bin da kannte ich kein deutsch und musste dann in die zweite klasse	1	
Obwohl ich in Deutschland geboren bin , bin ich auch schlecht in deutsch	1	
Pole oder Ost deutsche meine familie kommt zum teil aus schlesien und zum andern aus preu en war früher beides deutsch is heute polnisch seit dem es polnisch is lebt meine familie in Deutschland	1	
Realschule Hardtberg ich komme aus Türkei ich bin hier 1 Monat in Deutschland ich kann so gut deutsch	1	
Sehr geehrte Damen und Herren , ich habe ihre Anzeige im Internet gefunden , die Stelle hat ist sehr interessant für mich , denn ich habe in Syrien Informatik studiert , ich lebe seit zwei Jahren in Deutschland und spreche sehr gut deutsch , ich habe auch gute Englischkenntnisse , in Moment arbeite ich als Elektriker , im Studium habe ich ein Praktikum in einem Hotel gemacht , ich arbeite sehr gerne im Team , in der Anlage finden sie meinen Lebenslauf und meine Zeugnisse , mit Freundlichen grü en ,	1	
Sie spricht deutsch wie ein türke der vor kurzem nach Deutschland gekommen ist	1	
So nebenbei irgendwie ist es zur Tradition geworden dass wenn die wwe in Deutschland ist irgendwer versucht deutsch zu reden oder	1	
Und deutsche kommen aus Deutschland , sterreich und Schweiz und sprechen deutsch	1	
Und eins muss ich sagen in den 6 monaten die sie in Deutschland ist kann sie besser deutsch als jemand der 5 Jahre in Deutschland is	1	
Und sprech deutsch wir leben in Deutschland Gru sarah	1	
Wenn ich früher nach Deutschland gekommen w re , k nnte ich besser deutsch sprechen	1	
Wie du willst machen wirs so bis du nach Deutschland kommst sprecheb wir deutsch und wenn ich zu dir komme dann spanisch	1	
Wie sind in Deutschland also red auch deutsch	1	
#Österreich,	österreichisch
#Italien,	italienisch
und wenn ich nicht Single bin und ein Freund aus Italien ist und nur italienisch spricht aber ich kann kein italienisch aber selbst wenn man	3	
und wenn ich nicht Single bin und ein Freund aus Italien ist und nur italienisch spricht aber ich kann kein italienisch aber selbst wenn man nicht die gleiche Sprache spricht die Liebe findet immer einen Weg Spa	3	
Alles gut muss heute noch das erste mal okay nicht zu meiner Tante aber dort sehe ich das erst mal mein ganze Familie die aus Italien kommt freue mich zwar habe auch gleichzeitig angst davor da ich ja kein italienisch sprechen kann	1	
Misch es aber gern mit dem bischen italienisch was ich für Italien gelernt habe vor 2 Jahren	1	
Nur italienisch weil man dann in Italien Pizza in deren Sprache bestellen kann ohne probleme	1	
R ruft den Kellner und bestellt halt alles und redet noch kurz mit dem auf italienisch bc proud ob being Italien und dann gehr der kellner	1	
und wenn ich nicht Single bin und ein Freund aus Italien habe und er nur italienisch spricht aber ich kann kein italienisch  .	1	
und wenn ich nicht Single bin und ein Freund aus Italien ist und nur italienisch spricht aber ich kann	1	
und wenn ich nicht Single bin und ein Freund aus Italien ist und nur italienisch spricht aber ich kann kein italienisch aber selbst wenn man nicht die gleiche Sprache spricht die Liebe findet immer einen Weg Spa das musste jetzt sein	1	
#Norwegen,	norwegisch
#Schweiz,	schweizerisch
#Malta,	maltesisch
#Israel,	israelisch
#Moldawien,	moldawisch
#Kolumbien,	kolumbianisch
#Bulgarien,	bulgarisch
#Mazedonien,	mazedonisch
#Kroatien,	kroatisch
Ich war schon mal für ne Woche in Kroatien wo mich niemand versteht da ich kein kroatisch spreche und der einzige den ich hatte war mein Vater das war schon ziemlich anstrengend da jmd  .	1	
Okay ich freu mich voll auf Kroatien , kannst du kroatisch gut  ?	1	
#Dänemark,	dänisch
#Island,	isländisch
#Frankreich,	französisch
#der Pferd ,	die Pferde 
