1. capital-common-countries		1. столица-общий-страны	
Tokyo	Japan	Токио	Япония
Helsinki	Finland	Хельсинки	Финляндия
Madrid	Spain	Мадрид	Испания
Paris	France	Париж	Франция
Havana	Cuba	Гавана	Куба
Tehran	Iran	Тегеран	Иран
Cairo	Egypt	Каир	Египет
Islamabad	Pakistan	Исламабад	Пакистан
Bern	Switzerland	Берн	Швейцария
Canberra	Australia	Канберра	Австралия
London	England	Лондон	Англия
Berlin	Germany	Берлин	Германия
Kabul	Afghanistan	Кабул	Афганистан
Athens	Greece	Афины	Греция
Moscow	Russia	Москва	Россия
Stockholm	Sweden	Стокгольм	Швеция
Ottawa	Canada	Оттава	Канада
Rome	Italy	Рим	Италия
Hanoi	Vietnam	Ханой	Вьетнам
Beijing	China	Пекин	Китай
Bangkok	Thailand	Бангкок	Таиланд
Oslo	Norway	Осло	Норвегия
Baghdad	Iraq	Багдад	Ирак
2. capital-world		2. столица-мир	
Funafuti	Tuvalu	Фунафути	Тувалу
Madrid	Spain	Мадрид	Испания
Paris	France	Париж	Франция
Nassau	Bahamas	Нассау	Багамские острова
Maputo	Mozambique	Мапуту	Мозамбик
Tehran	Iran	Тегеран	Иран
Vientiane	Laos	Вьентьян	Лаос
Bamako	Mali	Бамако	Мали
Ankara	Turkey	Анкара	Турция
Vaduz	Liechtenstein	Вадуц	Лихтенштейн
Asmara	Eritrea	Асмэра	Эритрея
Roseau	Dominica	Розо	Доминика
Dushanbe	Tajikistan	Душанбе	Таджикистан
Sofia	Bulgaria	София	Болгария
Bucharest	Romania	Бухарест	Румыния
Tunis	Tunisia	Тунис	Тунис
Lusaka	Zambia	Лусака	Замбия
Quito	Ecuador	Кито	Эквадор
Khartoum	Sudan	Хартум	Судан
Montevideo	Uruguay	Монтевидео	Уругвай
Antananarivo	Madagascar	Антананариву	Мадагаскар
Kiev	Ukraine	Киев	Украина
Rome	Italy	Рим	Италия
Hanoi	Vietnam	Ханой	Вьетнам
Damascus	Syria	Дамаск	Сирия
Oslo	Norway	Осло	Норвегия
Vilnius	Lithuania	Вильнюс	Литва
Algiers	Algeria	Алжир	Алжир
Tashkent	Uzbekistan	Ташкент	Узбекистан
Tokyo	Japan	Токио	Япония
Helsinki	Finland	Хельсинки	Финляндия
Dublin	Ireland	Дублин	Ирландия
Chisinau	Moldova	Кишинэу	Молдова
Managua	Nicaragua	Манагуа	Никарагуа
Paramaribo	Suriname	Парамарибо	Суринам
Bishkek	Kyrgyzstan	Бишкек	Кыргызстан
Cairo	Egypt	Каир	Египет
Amman	Jordan	Амман	Иордания
Budapest	Hungary	Будапешт	Венгрия
Doha	Qatar	Доха	Катар
Astana	Kazakhstan	Астана	Казахстан
Kabul	Afghanistan	Кабул	Афганистан
Monrovia	Liberia	Монровия	Либерия
Dhaka	Bangladesh	Дакка	Бангладеш
Mogadishu	Somalia	Могадишо	Сомали
Bujumbura	Burundi	Бужумбура	Бурунди
Valletta	Malta	Валлетта	Мальта
Nouakchott	Mauritania	Нуакшот	Мавритания
Kingston	Jamaica	Кингстон	Ямайка
Beirut	Lebanon	Бейрут	Ливан
Beijing	China	Пекин	Китай
Bangkok	Thailand	Бангкок	Таиланд
Harare	Zimbabwe	Хараре	Зимбабве
Muscat	Oman	Мускат	Оман
Baghdad	Iraq	Багдад	Ирак
Conakry	Guinea	Конакри	Гвинея
Tallinn	Estonia	Таллинн	Эстония
Georgetown	Guyana	Джорджтаун	Гайана
Taipei	Taiwan	Тайбэй	Тайвань
Rabat	Morocco	Рабат	Марокко
Yerevan	Armenia	Ереван	Армения
Havana	Cuba	Гавана	Куба
Thimphu	Bhutan	Тхимпху	Бутан
Nuuk	Greenland	Nuuk	Гренландия
Baku	Azerbaijan	Баку	Азербайджан
Kigali	Rwanda	Кигали	Руанда
Dakar	Senegal	Дакар	Сенегал
Suva	Fiji	Сува	Фиджи
Belmopan	Belize	Бельмопан	Белиз
Banjul	Gambia	Банджул	Гамбия
Athens	Greece	Афины	Греция
Riga	Latvia	Рига	Латвия
Zagreb	Croatia	Загреб	Хорватия
Skopje	Macedonia	Скопье	Македония
Ashgabat	Turkmenistan	Ашхабад	Туркменистан
Stockholm	Sweden	Стокгольм	Швеция
Manila	Philippines	Манила	Филиппины
Brussels	Belgium	Брюссель	Бельгия
Luanda	Angola	Луанда	Ангола
Nicosia	Cyprus	Никосия	Кипр
Santiago	Chile	Сантьяго	Чили
Caracas	Venezuela	Каракас	Венесуэла
Minsk	Belarus	Минск	Беларусь
Tbilisi	Georgia	Тбилиси	Грузия
Libreville	Gabon	Либревиль	Габон
Tegucigalpa	Honduras	Тегусигальпа	Гондурас
London	England	Лондон	Англия
Vienna	Austria	Вена	Австрия
Warsaw	Poland	Варшава	Польша
Berlin	Germany	Берлин	Германия
Islamabad	Pakistan	Исламабад	Пакистан
Bern	Switzerland	Берн	Швейцария
Lima	Peru	Лима	Перу
Accra	Ghana	Аккра	Гана
Tripoli	Libya	Триполи	Ливия
Gaborone	Botswana	Габороне	Ботсвана
Manama	Bahrain	Манама	Бахрейн
Bratislava	Slovakia	Братислава	Словакия
Canberra	Australia	Канберра	Австралия
Kampala	Uganda	Кампала	Уганда
Kathmandu	Nepal	Катманду	Непал
Lisbon	Portugal	Лиссабон	Португалия
Apia	Samoa	Апиа	Самоа
Belgrade	Serbia	Белград	Сербия
Jakarta	Indonesia	Джакарта	Индонезия
Lilongwe	Malawi	Лилонгве	Малави
Ljubljana	Slovenia	Любляна	Словения
Moscow	Russia	Москва	Россия
Tirana	Tirana	Тирана	Тирана
Ottawa	Canada	Оттава	Канада
Nairobi	Kenya	Найроби	Кения
Copenhagen	Denmark	Копенгаген	Дания
Niamey	Niger	Ниамей	Нигер
Abuja	Nigeria	Абуджа	Нигерия
Windhoek	Namibia	Виндхук	Намибия
Podgorica	Montenegro	Подгорица	Черногория
3. currency		3. валюта	
Poland	zloty	Польша	злотый
Brazil	real	Бразилия	реальный
Vietnam	dong	Вьетнам	дон
Sweden	krona	Швеция	крона
Angola	kwanza	Ангола	кванза
Japan	yen	Япония	иена
Mexico	peso	Мексика	песо
Latvia	lats	Латвия	латы
Lithuania	litas	Литва	лит
Hungary	forint	Венгрия	форинт
USA	dollar	США	доллар
Denmark	krone	Дания	крона
Armenia	dram	Армения	драхма
Thailand	baht	Таиланд	бат
Nigeria	naira	Нигерия	naira
Romania	leu	Румыния	лей
Argentina	peso	Аргентина	песо
Russia	ruble	Россия	рубль
Algeria	dinar	Алжир	динар
Ukraine	hryvnia	Украина	гривна
Croatia	kuna	Хорватия	куна
Cambodia	riel	Камбоджа	риель
Canada	dollar	Канада	доллар
Korea	won	Корея	выигранный
Europe	euro	Европа	евро
Malaysia	ringgit	Малайзия	ринггит
Iran	rial	Иран	риал
India	rupee	Индия	рупия
Macedonia	denar	Македония	денар
Bulgaria	lev	Болгария	лев
4. city-in-state		4. город-в-государство	
Wichita	Kansas	Уичито	Канзас
Akron	Ohio	Акрон	Огайо
Irvine	California	Ирвин	Калифорнии
Toledo	Ohio	Толедо	Огайо
Indianapolis	Indiana	Индианаполис	Индиана
Denver	Colorado	Денвер	Колорадо
Milwaukee	Wisconsin	Милуоки	Висконсин
Reno	Nevada	Рено	Невада
Boston	Massachusetts	Бостон	Массачусетс
Minneapolis	Minnesota	Миннеаполис	Миннесота
Bakersfield	California	Бейкерсфилд	Калифорнии
Henderson	Nevada	Хендерсон	Невада
Seattle	Washington	Сиэтл	Вашингтон
Atlanta	Georgia	Атланта	Грузия
Chandler	Arizona	Чандлер	Аризона
Dallas	Texas	Даллас	Техас
Madison	Wisconsin	Мэдисон	Висконсин
Tampa	Florida	Тампа	Флорида
Tallahassee	Florida	Таллахасси	Флорида
Irving	Texas	Ирвинг	Техас
Fontana	California	Фонтана	Калифорнии
Anaheim	California	Анахайм	Калифорнии
Fresno	California	Фресно	Калифорнии
Amarillo	Texas	Amarillo	Техас
Hialeah	Florida	Хайалиа	Флорида
Pittsburgh	Pennsylvania	Питсбург	Пенсильвания
Austin	Texas	Остин	Техас
Sacramento	California	Сакраменто	Калифорнии
Portland	Oregon	Портленд	Орегон
Glendale	California	Глендейл	Калифорнии
Jacksonville	Florida	Джексонвилль	Флорида
Shreveport	Louisiana	Шривпорт	Луизиана
Lexington	Kentucky	Лексингтон	Кентукки
Tulsa	Oklahoma	Талса	Оклахома
Glendale	Arizona	Глендейл	Аризона
Tucson	Arizona	Тусон	Аризона
Mesa	Arizona	Меса	Аризона
Spokane	Washington	Спокан	Вашингтон
Memphis	Tennessee	Мемфис	Теннесси
Oxnard	California	Окснард	Калифорнии
Tacoma	Washington	Такома	Вашингтон
Lubbock	Texas	Лаббок	Техас
Worcester	Massachusetts	Вустер	Массачусетс
Miami	Florida	Майами	Флорида
Cleveland	Ohio	Кливленд	Огайо
Scottsdale	Arizona	Scottsdale	Аризона
Louisville	Kentucky	Луисвилл	Кентукки
Stockton	California	Стоктон	Калифорнии
Detroit	Michigan	Детройт	Мичиган
Phoenix	Arizona	Феникс	Аризона
Philadelphia	Pennsylvania	Филадельфия	Пенсильвания
Huntsville	Alabama	Хантсвилл	Алабама
Cincinnati	Ohio	Цинциннати	Огайо
Honolulu	Hawaii	Гонолулу	Гавайи
Nashville	Tennessee	Нашвилл	Теннесси
Oakland	California	Окленд	Калифорнии
Houston	Texas	Хьюстон	Техас
Fremont	California	Фримонт	Калифорнии
Orlando	Florida	Орландо	Флорида
Arlington	Texas	Арлингтон	Техас
Omaha	Nebraska	Омаха	Небраска
Laredo	Texas	Ларедо	Техас
Chicago	Illinois	Чикаго	Иллинойс
Baltimore	Maryland	Балтимор	Мэриленд
Anchorage	Alaska	Якорная стоянка	Аляска
Plano	Texas	Plano	Техас
Modesto	California	Модесто	Калифорнии
Garland	Texas	Гирлянда	Техас
5. family		5. семья	
brothers	sisters	братья	сестры
stepfather	stepmother	отчим	мачеха
his	her	его	её
grandson	granddaughter	внук	внучка
man	woman	муж	женщина
stepson	stepdaughter	пасынок	падчерица
husband	wife	мужчина	жена
grandfather	grandmother	дед	бабушка
groom	bride	жених	невеста
grandpa	grandma	дедушка	бабушка
brother	sister	брат	сестра
king	queen	царь	королева
son	daughter	сын	дочь
father	mother	отец	мать
prince	princess	князь	княгиня
boy	girl	мальчик	девушка
nephew	niece	племянник	племянница
stepbrother	stepsister	сводный брат	сводная сестра
he	she	он	она
dad	mom	папа	мама
uncle	aunt	дядя	тетя
sons	daughters	сыновья	дочери
policeman	policewoman	полицейский	полицейский
6. gram1-adjective-to-adverb		6. грамм1-прилагательное-к-наречие	
complete	completely	полный	полностью
lucky	luckily	счастливый	к счастью
quick	quickly	быстрый	быстро
rare	rarely	редкий	редко
amazing	amazingly	удивительный	удивительно
possible	possibly	вероятный	возможно
unfortunate	unfortunately	несчастный	к сожалению
cheerful	cheerfully	веселый	весело
most	mostly	наибольший	по большей части
fortunate	fortunately	удачливый	к счастью
free	freely	бесплатный	свободно
safe	safely	безопасный	безопасно
swift	swiftly	стремительный	быстро
apparent	apparently	очевидный	видимо
efficient	efficiently	эффективный	эффективно
rapid	rapidly	быстрый	быстро
precise	precisely	точный	точно
reluctant	reluctantly	неохотный	неохотно
serious	seriously	серьезный	серьезно
calm	calmly	спокойствие	спокойно
happy	happily	счастливый	счастливо
usual	usually	обычный	обычно
furious	furiously	разъяренный	яростно
occasional	occasionally	случайный	иногда
immediate	immediately	немедленный	сразу
professional	professionally	профессиональный	профессионально
obvious	obviously	очевидный	очевидно
sudden	suddenly	внезапный	вдруг
typical	typically	типичный	типично
quiet	quietly	тихий	спокойно
infrequent	infrequently	редкий	нечасто
slow	slowly	медленный	медленно
7. gram2-opposite		7. gram2-противоположный	
clear	unclear	понятно	непонятный
honest	dishonest	честный	нечестный
convincing	unconvincing	убедительный	неубедительный
competitive	uncompetitive	конкурентный	неконкурентоспособный
known	unknown	называемый	неизвестный
impressive	unimpressive	впечатляющий	невыразительный
possibly	impossibly	возможно	невероятно
decided	undecided	решенный	нерешительный
consistent	inconsistent	последовательный	непоследовательный
ethical	unethical	этический	неэтичный
informed	uninformed	информированный	неинформированный
comfortable	uncomfortable	удобный	неудобный
possible	impossible	вероятный	невозможный
logical	illogical	логический	нелогичный
efficient	inefficient	эффективный	неэффективный
productive	unproductive	продуктивный	непродуктивный
convenient	inconvenient	удобный	неудобный
responsible	irresponsible	ответственный	безответственный
pleasant	unpleasant	приятный	неприятный
tasteful	distasteful	вкусный	неприятный
fortunate	unfortunate	удачливый	несчастный
informative	uninformative	информативный	неинформативный
rational	irrational	рациональный	неразумный
acceptable	unacceptable	приемлемый	неприемлемый
aware	unaware	осведомленный	незнающий
reasonable	unreasonable	разумный	неразумный
sure	unsure	конечно	неуверенный
certain	uncertain	определенный	неопределенный
likely	unlikely	вероятно	вряд ли
8. gram3-comparative		8. грамм3-сравнительный	
low	lower	низкий	ниже
old	older	старый	более старый
fast	faster	быстрый	более быстрый
heavy	heavier	тяжелый	более тяжелый
tight	tighter	плотно	более жесткий
simple	simpler	простой	упроститься
large	larger	большой	больше
hot	hotter	горячий	накаляться
big	bigger	большой	больший
tough	tougher	жесткий	более жесткий
high	higher	высокий	высший
strong	stronger	сильный	более сильный
bright	brighter	яркий	яркий
cheap	cheaper	дешевый	выгоднее
warm	warmer	теплый	грелка
young	younger	молодой	младший
quick	quicker	быстрый	быстрее
deep	deeper	глубокий	более глубокий
loud	louder	громкий	громкий
new	newer	новый	более новый
wide	wider	широкий	более широкий
bad	worse	плохой	худший
long	longer	длинный	более длительный
slow	slower	медленный	замедлившийся
easy	easier	легкий	облегчающий
short	shorter	короткий	щортер
small	smaller	малый	меньший
sharp	sharper	резкий	шулер
safe	safer	безопасный	более безопасный
cold	colder	холодный	холоднее
good	better	хороший	лучше
tall	taller	высокий	выше
weak	weaker	слабый	более слабый
smart	smarter	умный	более умный
cool	cooler	прохладный	прохладнее
great	greater	великий	больший
hard	harder	трудный	посильнее
9. gram4-superlative		9. грамм4-превосходная степень	
easy	easiest	легкий	простейший
weird	weirdest	сверхъестественный	сверхъестественный
cold	coldest	простуда	равнодушный
sharp	sharpest	резкий	резкий
warm	warmest	теплый	самый теплый
strong	strongest	сильный	сильнейший
strange	strangest	странный	престранный
low	lowest	низкий	минимально
wide	widest	широкий	максимально широкий
small	smallest	малый	наименьший
cool	coolest	прохладный	прохладный
great	greatest	большой	величайший
hot	hottest	горячий	самый горячий
long	longest	длинный	самый длинный
weak	weakest	слабый	наиболее слабый
simple	simplest	простой	простейший
smart	smartest	умный	умнейший
high	highest	высокий	самый высокий
tall	tallest	высокий	высокий
tasty	tastiest	вкусный	вкусный
young	youngest	юный	младший по возрасту
bad	worst	плохой	наихудший
quick	quickest	быстрый	быстрейший
old	oldest	старый	старейший
fast	fastest	быстрый	самый быстрый
bright	brightest	яркий	ярчайший
big	biggest	большой	наибольший
large	largest	большой	наибольший
slow	slowest	медленный	самый медленный
short	shortest	короткий	кратчайший
good	best	хороший	лучший
dark	darkest	темный	темнейший
lucky	luckiest	счастливый	счастливейший
sweet	sweetest	сладкий	сладчайший
10. gram6-nationality-adjective		10. грамм6-национальность-прилагательное	
Thailand	Thai	Таиланд	Тайский
India	Indian	Индия	Индийский
Portugal	Portuguese	Португалия	Португальский
Belarus	Belorussian	Беларусь	Белорусский
Sweden	Swedish	Швеция	Шведский
Spain	Spanish	Испания	Испанский
Mexico	Mexican	Мексика	Мексиканец
Brazil	Brazilian	Бразилия	Бразилец
China	Chinese	Китай	Китайский
Peru	Peruvian	Перу	Перуанский
Argentina	Argentinean	Аргентина	Аргентинский
Korea	Korean	Корея	Корейский
Egypt	Egyptian	Египет	Египетский
Ukraine	Ukrainian	Украина	Украинский
Australia	Australian	Австралия	Австралийский
Russia	Russian	Россия	Русский
Japan	Japanese	Япония	Японский
Cambodia	Cambodian	Камбоджа	Камбоджийский
Greece	Greek	Греция	Греческий
Netherlands	Dutch	Нидерланды	Голландский
England	English	Англия	Английский
Poland	Polish	Польша	Польский
Ireland	Irish	Ирландия	Ирландский
Slovakia	Slovakian	Словакия	Словацкий
Albania	Albanian	Албания	Албанский
Chile	Chilean	Чили	Чилийский
Germany	German	Германия	Герман
Austria	Austrian	Австрия	Австрийский
Italy	Italian	Италия	Итальянский
Norway	Norwegian	Норвегия	Норвежский
Switzerland	Swiss	Швейцария	Швейцарский
Malta	Maltese	Мальта	Мальтийский
Israel	Israeli	Израиль	Израильский
Moldova	Moldovan	Молдова	Молдавский
Colombia	Colombian	Колумбия	Колумбийский
Bulgaria	Bulgarian	Болгария	Болгарский
Macedonia	Macedonian	Македония	Македонский
Croatia	Croatian	Хорватия	Хорватский
Denmark	Danish	Дания	Датский
Iceland	Icelandic	Исландия	Исландский
France	French	Франция	Французский
11. gram8-plural		11. грамм8-множественный	
color	colors	цвет	цветы
dream	dreams	сновидение	сновиденое
mango	mangoes	манго	манго
elephant	elephants	слон	слоны
monkey	monkeys	обезьяна	обезьяны
eagle	eagles	орел	орлы
hand	hands	рука	руки
bottle	bottles	бутылка	разливаться
woman	women	женщина	женский
melon	melons	дыня	бахчевые культуры
cloud	clouds	облако	облака
lion	lions	лев	лайонз
mouse	mice	мышь	мыши
pig	pigs	свинья	свиньи
donkey	donkeys	осел	ослы
machine	machines	машина	машины
road	roads	дорога	дорожные магистрали
rat	rats	крыса	крысы
onion	onions	лук	лука репчатого
snake	snakes	змея	змеи
car	cars	автомобиль	автомобили
building	buildings	здание	строительные объекты
man	men	человек	люди
pineapple	pineapples	ананас	ананасы
cat	cats	кошка	кошки
bird	birds	птица	птичий
cow	cows	корова	стадо
goat	goats	коза	козлов
horse	horses	лошадь	лошади
child	children	ребенок	дети
computer	computers	компьютер	компьютеры
dollar	dollars	доллар	долларовый
banana	bananas	банан	бананы
finger	fingers	палец	пальца кисти
dog	dogs	собака	собаки
pear	pears	груша	груши
