#Стокгольм,	Швеция
#Манила,	Филиппины
#Брюссель,	Бельгия
#Луанда,	Ангола
#Никосия,	Кипр
#Сантьяго,	Чили
#Каракас,	Венесуэла
#Минск,	Беларусь
#Тбилиси,	Грузия
#Либревиль,	Габон
#Тегусигальпа,	Гондурас
#Лондон,	Англия
Англия , мне хочется побывать в Англии , Лондон	1	
Да , очень рад , Англия нереально крутая , Лондон восхитителен , уже побывал в Ливерпуле , Бирмингеме , недавно летал в штаты в техас на конференцию	1	
#Вена,	Австрия
#Варшава,	Польша
#Берлин,	Германия
Германия , я ведь говорил , город Берлин  .	1	
#Исламабад,	Пакистан
#Берн,	Швейцария
#Лима,	Перу
#Аккра,	Гана
#Триполи,	Ливия
#Габороне,	Ботсвана
#Манама,	Бахрейн
#Братислава,	Словакия
#Канберра,	Австралия
#Кампала,	Уганда
#Катманду,	Непал
#Лиссабон,	Португалия
#Апиа,	Самоа
#Белград,	Сербия
#Джакарта,	Индонезия
#Лилонгве,	Малави
#Любляна,	Словения
#Москва,	Россия
CASADEI , лучшаяобувь , сапоги , касадеи , толькоунас , Москва , санктпетербург , россия , Казахстан , красивыеплатья , женскаяодежда , одежданазаказ , Россия , Казахстан , москва , челябинск , новосибирск , вседлядевушек , красота , моднаяодежда , новыйгод , тепло , красивыеплатьяунас	3	
Шикарные туфли MANOLO BLAHNIK , шикарнаяобувь , женскиетуфли , каблуки , лучшиеунас , красота , Россия , Казахстан , Москва , санктпетербург	3	
Россия , 125368 , Москва , Митино ,	2	
SL , лучшаяобувь , сапоги , касадеи , толькоунас , Москва , санктпетербург , россия , Казахстан , красивыеплатья , женскаяодежда , одежданазаказ , Россия , Казахстан , москва , челябинск , новосибирск , вседлядевушек , красота , моднаяодежда , новыйгод , тепло , красивыеплатьяунас	1	
Ас Москва деш г 1 о аьлч Россия забрала у нас крым бохш	1	
В России в принципе очень мало достойных город , я сейчас не про Москву и Питер , потому что Москва и Питер- это не Россия , это исключительная ее территория	1	
Если бы там была Россия , то это точно Москва и Питер	1	
И знаю Россия для русских , Москва для москвичей	1	
МЕХ-ЧЕРНОБУРКА , МЯГКАЯ КОЖА , ООООЧЕНЬ ТЕПЛАЯ , теплаякуртка , зимняяодежда , самыекрасивыевещи , толькоунас , Москва , санктпетербург , челябинск , Россия , Казахстан , одеваемсятепло	1	
МЕХ-ЧЕРНОБУРКА , МЯГКАЯ КОЖА , ООООЧЕНЬ ТЕПЛАЯ , теплаякуртка , зимняяодежда , самыекрасивыевещи , толькоунас , Москва , санктпетербург , челябинск , Россия , ка	1	
Москва , Кучин переулок , 14 , Россия  .	1	
По мере того , как развивались события , Совет безопасности ООН выработал по Сирии резолюцию о прекращении огня в Гуте , которую Россия блокировала , заявив Москва согласится на резолюцию только при условии , что прекращение огня не будет применяться к поддерживаемым США террористическим силам  .	1	
Потому что Москва и Питер-это не Россия	1	
Россия , 125368 , Москва , Митино	1	
Россия это не только Москва и область , есь ещё и другие города , которые нуждаются в этих деньгах	1	
Шикарные туфли MANOLO BLAHNIK , шикарнаяобувь , женскиетуфли , каблуки , лучшиеунас , красота , Россия , Казахстан , Москва , Сан	1	
Это Россия ту наверное только Москва все знвет	1	
#Тирана,	Тирана
#Оттава,	Канада
#Найроби,	Кения
#Копенгаген,	Дания
#Ниамей,	Нигер
#Абуджа,	Нигерия
#Виндхук,	Намибия
#Подгорица,	Черногория
#Польша,	злотый
#Бразилия,	реальный
#Вьетнам,	дон
#Швеция,	крона
#Ангола,	кванза
#Япония,	иена
#Мексика,	песо
#Латвия,	латы
#Литва,	лит
#Венгрия,	форинт
#США,	доллар
#Дания,	крона
#Армения,	драхма
#Таиланд,	бат
#Нигерия,	naira
#Румыния,	лей
#Аргентина,	песо
#Россия,	рубль
#Алжир,	динар
#Украина,	гривна
#Хорватия,	куна
#Камбоджа,	риель
#Канада,	доллар
#Корея,	выигранный
#Европа,	евро
А весь евро союз в стране Европа	1	
Европа что нибудь с евро	1	
#Малайзия,	ринггит
#Иран,	риал
#Индия,	рупия
#Македония,	денар
#Болгария,	лев
#Уичито,	Канзас
#Акрон,	Огайо
#Ирвин,	Калифорнии
#Толедо,	Огайо
#Индианаполис,	Индиана
#Денвер,	Колорадо
#Милуоки,	Висконсин
#Рено,	Невада
#Бостон,	Массачусетс
#Миннеаполис,	Миннесота
#Бейкерсфилд,	Калифорнии
#Хендерсон,	Невада
#Сиэтл,	Вашингтон
#Атланта,	Грузия
#Чандлер,	Аризона
#Даллас,	Техас
#Мэдисон,	Висконсин
#Тампа,	Флорида
#Таллахасси,	Флорида
#Ирвинг,	Техас
#Фонтана,	Калифорнии
#Анахайм,	Калифорнии
#Фресно,	Калифорнии
#Amarillo,	Техас
#Хайалиа,	Флорида
#Питсбург,	Пенсильвания
#Остин,	Техас
