#Токио,	Япония
#Хельсинки,	Финляндия
Финляндия тоже понравилась , я там был в 3 городах Хельсинки , хамильяти и тампаре , все понравились	1	
#Мадрид,	Испания
#Париж,	Франция
Например она говорит Франция , а ты говоришь столицу Париж	1	
#Гавана,	Куба
#Тегеран,	Иран
#Каир,	Египет
#Исламабад,	Пакистан
#Берн,	Швейцария
#Канберра,	Австралия
#Лондон,	Англия
Англия , мне хочется побывать в Англии , Лондон	1	
Да , очень рад , Англия нереально крутая , Лондон восхитителен , уже побывал в Ливерпуле , Бирмингеме , недавно летал в штаты в техас на конференцию	1	
#Берлин,	Германия
Германия , я ведь говорил , город Берлин  .	1	
#Кабул,	Афганистан
#Афины,	Греция
#Москва,	Россия
CASADEI , лучшаяобувь , сапоги , касадеи , толькоунас , Москва , санктпетербург , россия , Казахстан , красивыеплатья , женскаяодежда , одежданазаказ , Россия , Казахстан , москва , челябинск , новосибирск , вседлядевушек , красота , моднаяодежда , новыйгод , тепло , красивыеплатьяунас	3	
Шикарные туфли MANOLO BLAHNIK , шикарнаяобувь , женскиетуфли , каблуки , лучшиеунас , красота , Россия , Казахстан , Москва , санктпетербург	3	
Россия , 125368 , Москва , Митино ,	2	
SL , лучшаяобувь , сапоги , касадеи , толькоунас , Москва , санктпетербург , россия , Казахстан , красивыеплатья , женскаяодежда , одежданазаказ , Россия , Казахстан , москва , челябинск , новосибирск , вседлядевушек , красота , моднаяодежда , новыйгод , тепло , красивыеплатьяунас	1	
Ас Москва деш г 1 о аьлч Россия забрала у нас крым бохш	1	
В России в принципе очень мало достойных город , я сейчас не про Москву и Питер , потому что Москва и Питер- это не Россия , это исключительная ее территория	1	
Если бы там была Россия , то это точно Москва и Питер	1	
И знаю Россия для русских , Москва для москвичей	1	
МЕХ-ЧЕРНОБУРКА , МЯГКАЯ КОЖА , ООООЧЕНЬ ТЕПЛАЯ , теплаякуртка , зимняяодежда , самыекрасивыевещи , толькоунас , Москва , санктпетербург , челябинск , Россия , Казахстан , одеваемсятепло	1	
МЕХ-ЧЕРНОБУРКА , МЯГКАЯ КОЖА , ООООЧЕНЬ ТЕПЛАЯ , теплаякуртка , зимняяодежда , самыекрасивыевещи , толькоунас , Москва , санктпетербург , челябинск , Россия , ка	1	
Москва , Кучин переулок , 14 , Россия  .	1	
По мере того , как развивались события , Совет безопасности ООН выработал по Сирии резолюцию о прекращении огня в Гуте , которую Россия блокировала , заявив Москва согласится на резолюцию только при условии , что прекращение огня не будет применяться к поддерживаемым США террористическим силам  .	1	
Потому что Москва и Питер-это не Россия	1	
Россия , 125368 , Москва , Митино	1	
Россия это не только Москва и область , есь ещё и другие города , которые нуждаются в этих деньгах	1	
Шикарные туфли MANOLO BLAHNIK , шикарнаяобувь , женскиетуфли , каблуки , лучшиеунас , красота , Россия , Казахстан , Москва , Сан	1	
Это Россия ту наверное только Москва все знвет	1	
#Стокгольм,	Швеция
#Оттава,	Канада
#Рим,	Италия
#Ханой,	Вьетнам
#Пекин,	Китай
#Бангкок,	Таиланд
#Осло,	Норвегия
#Багдад,	Ирак
#Фунафути,	Тувалу
#Мадрид,	Испания
#Париж,	Франция
Например она говорит Франция , а ты говоришь столицу Париж	1	
#Нассау,	Багамские острова
#Мапуту,	Мозамбик
#Тегеран,	Иран
#Вьентьян,	Лаос
#Бамако,	Мали
#Анкара,	Турция
#Вадуц,	Лихтенштейн
#Асмэра,	Эритрея
#Розо,	Доминика
#Душанбе,	Таджикистан
#София,	Болгария
#Бухарест,	Румыния
#Тунис,	Тунис
#Лусака,	Замбия
#Кито,	Эквадор
#Хартум,	Судан
#Монтевидео,	Уругвай
#Антананариву,	Мадагаскар
#Киев,	Украина
Красавец Киев встретил холодном на улице и тёплом душевным , Украина	6	
Это точно , но в Киев нам не надо , Украина воинствует	1	
#Рим,	Италия
#Ханой,	Вьетнам
#Дамаск,	Сирия
#Осло,	Норвегия
#Вильнюс,	Литва
#Алжир,	Алжир
#Ташкент,	Узбекистан
#Токио,	Япония
#Хельсинки,	Финляндия
Финляндия тоже понравилась , я там был в 3 городах Хельсинки , хамильяти и тампаре , все понравились	1	
#Дублин,	Ирландия
#Кишинэу,	Молдова
#Манагуа,	Никарагуа
#Парамарибо,	Суринам
#Бишкек,	Кыргызстан
#Каир,	Египет
#Амман,	Иордания
#Будапешт,	Венгрия
#Доха,	Катар
#Астана,	Казахстан
#Кабул,	Афганистан
#Монровия,	Либерия
#Дакка,	Бангладеш
#Могадишо,	Сомали
#Бужумбура,	Бурунди
#Валлетта,	Мальта
#Нуакшот,	Мавритания
#Кингстон,	Ямайка
#Бейрут,	Ливан
#Пекин,	Китай
#Бангкок,	Таиланд
#Хараре,	Зимбабве
#Мускат,	Оман
#Багдад,	Ирак
#Конакри,	Гвинея
#Таллинн,	Эстония
#Джорджтаун,	Гайана
#Тайбэй,	Тайвань
#Рабат,	Марокко
#Ереван,	Армения
#Гавана,	Куба
#Тхимпху,	Бутан
#Nuuk,	Гренландия
#Баку,	Азербайджан
Спасибо папа , Гянджа , Баку , Азербайджанялюблютебя , Азербайджан , Нафталан , ОтельЧинар , Chinarhotel , папаидочь , проводимвремявместе , выходной , week	1	
#Кигали,	Руанда
#Дакар,	Сенегал
#Сува,	Фиджи
#Бельмопан,	Белиз
#Банджул,	Гамбия
#Афины,	Греция
#Рига,	Латвия
#Загреб,	Хорватия
#Скопье,	Македония
#Ашхабад,	Туркменистан
