#oscuro,	más oscuro
#oscuro,	oscurísimo
#suerte,	más suerte
Soy gran creyente en la suerte , y he descubierto que mientras más duro trabajo , más suerte tengo  .	2	
tengo muchísima suerte de conocerte , y aún más suerte por compartir esta extraña parte de la juventud que es el amor y más que nada la amistad	1	
#suerte,	suertísimo
#dulce,	más dulce
#dulce,	dulcísimo
#Tailandia,	tailandés
#Tailandia,	tailandesa
#India,	indio
Ahora será India de las finas con un indio de los finos	1	
Muy charro sabiendo q la mamá es bien peli India y el papa tambien es peli indio	1	
#India,	india
Que hacen India maldita , maldita india	3	
India no enojar si india mayor querer regalar esas	2	
Bueno a usted le vale verga la neta no quiero tener problemas con tigo pero si los buscas adelante y de India nd mamasita por que de india a india usted ea mas pinche d	1	
India es del país de la india ey gracias por eso amo ese país bye perras ladren a gusto	1	
#Portugal,	portugués
Emm seria , aprender bien portugués y francés para viajar a Brasil , Portugal y Francia	1	
#Portugal,	portuguesa
#Bielorrusia,	bielorruso
#Bielorrusia,	bielorrusa
#Suecia,	sueco
#Suecia,	sueca
#España,	español
Ay y acaso vives en España para apoyar a un equipo español	3	
Deja de digo no le gusta que me digan lindo por que el no lo es el es sexy le gustan las latinas quiere visitar rusia , España y no se que mas habla muuuuuuuy poco español bueno solo mamacita , papacito'hola como estas y estupida	2	
Si estybiera en España usted , Dios no quiera que un español lo insulte como usted lo hace con los venezolanos  .	2	
Ami se me hace que en este grupo más de uno apoya a España y no es español	1	
Ay y acaso vives en España para apoyar a un equipo español no pues wauu	1	
El Siglo de Oro español fue un período de florecimiento del arte y la literatura en España , que coincidió con el auge político y posterior declive de la dinastía de los Austrias o Habsburgo españoles  .	1	
En España entienden mejor el español	1	
En las regiones de España con lengua materna propia , el nombre decastellano parece más adecuado queel de español , porque el catalán , el gallego y el vascuence son también lenguas españolas aunque no son la lengua española , el español  .	1	
Es español y voy a verlo cada año a España	1	
Ese chabon esa noche se hizo pasar por español hablaba como si fuera de España y la vir lo paro para sacar una foto	1	
España es nuestro país y estar orgulloso de él , es ser español	1	
Esto es lo que queremos yo no soy español soy mexicano y para nada quiero la ley sharia en México bien por España al sacar a esos invasores	1	
Feliz Navidad que también es muy español , y también a los que llevan tirantes con la bandera de España o rastas y piercing pero son gente de bien	1	
La Conquista de México se refiere principalmente al sometimiento del Estado Mexica o azteca , logrado por Hernán Cortésen el nombre del rey Carlos I de España y a favor del Imperio español entre 1519 y 1521  .	1	
La polémica en torno a los términos español y castellano se basa en la disputa para decidir si resulta más apropiado correcto denominar a una de las lenguas hablada en España , en Hispanoamérica , en Guinea Ecuatorial y en otras zonas hispanohablantes español o castellano , o bien si ambas son formas perfectamente sinónimas y aceptables  .	1	
Lo de español de renacimiento de un mapa conceptual y una obra literaria en España y 5 obras literarias	1	
Pablo Valdes Afiliación online España en ingles Estados unidos español ingles DIRECCIONES DE ALMACENES HERBALIFE EN 93 PAISES actualizado al 03 / 04 / 2016	1	
Pasaporte español 10mil dólares el pasaporte le dura 10 años puede ir y venir de España y le sirve para USA también	1	
Q el español quiere q renuncie a mi trabajo y me vaya a España	1	
Rap es bueno pero no me finta mucho el mexicano prefiero el que esta en ingles o si es rap en español que sea de España	1	
Se supone que este equipo es de España y su idioma es el español  .	1	
Ser un deportista destacado ser reconosido Y bueno desde hace muchos años es poder viajar a varios países Sobre todo España , ya que mi vizabuelo era español	1	
Si tío yo soy de España no vez mi acento español tío joder	1	
Una amiga de mi madre aprendió hablar en español en menos de un año porque vino a España a vivir y eso que hablaba búlgaro , que no tiene NADA que ver con el español	1	
Yo me tendria q ir a España así aprendo hablar español bien	1	
#España,	española
Jaja todo el mundo es del Barcelona ya que cosas pero nosotros perdimos un partido ustedes perdieron champions y la Liga de España nosotros fuimos bicampeones 5 títulos aparte la Liga española un título para lucas Modric y llevar al Portugal a ganar la Copa del mundo lo que Messi a intentado con el Argentina pero no a sido capaz a y un balón de oro para cristiano ronaldo dos Santos Aveiro  !	2	
Renovando el documento española muy pronto volveré a España yaa	2	
Ahora se ira a España trabaja en una empresa española	1	
Cuenta para los amantes de la aviación española o del mundo pero principal mente de España  .	1	
En la actualidad muchos intérpretes cantan esta canción , como el grupo de Rock Pesado Stravaganzza , y una hermosa niña española de nombre Barbara quien concurso con esta canción en la Voz Kid España , en lo personal esta es la versión que mas me gusta de todas  .	1	
He vivido en España , he trabajado como promotora de ventas , mi compañera era española pero yo ganaba mas que ella porque mis ventas eran mas altas	1	
Inglaterra y Francia se disputan la hegemonía de Europa , Napoleón invade España , Fernando séptimo legimo heredero de la corona española  .	1	
Se te ha olvidado decir viva España chica que eres española	1	
Sólo soy catalana pero igual seguiré siendo española aun que ahora España sea otro país	1	
Yo no voy tanto a España a pesar de que tengo la ciudadanía española	1	
Yo si sabia que da lesbiana y se caso con Laura en España la chica es española	1	
Yo soy España , yo amo España yo soy la monarquía española	1	
Yo soy de España de Malaga pero por parte de familia soy media española y media sevillana	1	
#México,	mexicano
Vamos México se que no somos los mejores pero con empeño y pasion podremos pasar ganarle a Alemania y a todos los de nuestro grupo y hacer un mundial mexicano expectacular vamos mi México hay que darle con todo al campeón del mundo y vamos por el campionato	3	
La bandera mexicana es un símbolo muy importante para todos los mexicanos que se ejemplifica el Día de la Bandera ; un día dedicado a la celebración de la bandera donde cada mexicano jura lealtad a la bandera de México y al país  .	2	
Un día como hoy pero de 1950 debutaba esta jóven promesa del fútbol mexicano , marcó época en el club mas antiguo de México , El Hidalgo hoy club Pachuca Yo tengo la dicha de decir que es mi amigo , gracias figura por haberte entregado en cada partido , tus 300 goles cómo profesional no quedaran en vano aquí en pequeño homenaje  .	2	
5 millones deeuros ; que le convirtieron en el jugador mexicano por el que , jugando en México , un equipo extranjero pagó más dinero  .	1	
A México el pais no , al fútbol mexicano si y es la neta jaja	1	
Al parecer es de un partido político mexicano , a mi el partido político me la pela , México nos lleva nos de ventaja en campañas electorales	1	
Al parecer es de un partido político mexicano , a mi el partido político me la pela , México nos lleva nos de ventaja en campañas electorales  .	1	
All plasmaron con gran maestria y colorido la naturaleza exuberante de México , mostrándonos dos visiones diferentes del paisaje mexicano  .	1	
Dijeyo s epor eso te lo digo porquedice que erws mexicano y que estas lejos y yo digo que Tampa no es lejos de México en la península de la florida	1	
En realidad era de argentina hablo mas argentina que mexicano porque éste año me vine a México por familiares jaja	1	
Es chistoso a lo mejor no te gusta que musica pero demostró demasiado amor a México que le exigió a los gobernantes pero el mexicano es tan cerrado que solo se concentra en criticar en lugar de entender que hay que cambiar la actitud que tienen	1	
Es que hace algunos años oi una canción de un grupo de rap mexicano llamado bastón y tratan la problemática de México y dicen Diciembre 22 del 97 Y precisamente habla de indígenas masacrados entonces tenia esa duda 3	1	
Es que mi mexicano le toco irse para México urgente por una chimbada dectrabajo	1	
Esto es lo que queremos yo no soy español soy mexicano y para nada quiero la ley sharia en México bien por España al sacar a esos invasores	1	
Guerra México Estados Unidos , causas y consecuenciasMéxico en protesta a la anexión de Texas , rompe las relaciones diplomáticas que mantenía con los Estados Unidos ; aun así , antes de la confrontación armada , el gobierno estadounidense pretendió negociar la compra de la Alta California y Nuevo México , hecho ignorado por el gobierno mexicano de la época a cargo de José Joaquín Herrera  .	1	
Hay , pero si eres mexicano no te pueden deportar de México , a menos que hayas hecho algo malo	1	
Jajaja por eso México esta como esta por puro mexicano como tuuuuu	1	
Jajajajajajaj ese nano ya nas mas lleva meses en México y habla como mexicano no manches nano	1	
Me das tristeza México en donde esta el orgullo de ser mexicano en donde estan los huevos bien puestos que tenemos  ?	1	
Mejor un mexicano , no se , conozco uno en es Estado de México	1	
Mi mejor amigo mexicano el cual ayer se fue a México otra vez v	1	
Okey madre pero yo quiero saber la cantidad o el cambio de peso mexicano que el peso colombiano osea un ejemplo si me manda 50 mil peso México lo cambio a quien en peso colombiano cuanto seria	1	
Otro importante muralista es el mexicano David Alfaro Siqueiros 1896-1974 , formado en la Escuela de Bellas Artes México D  .	1	
Pero como voy a México y tengo recidencia mexicano	1	
Pobres pendejos México ya no los quiere y el mexicano que los quiera es por que realmente está bien	1	
Por que como dijiste que a la morra esa así se dice chica en México bueno así me decía un amigo mexicano la aceptaste por que yo me había ido jajajaj Oshea esta como rara la cosa hay we	1	
Raioz y es de México Por eso mi esposo sera mexicano	1	
Si , me he dado cuenta de que eres de esas personas que disfrutan de la literatura mexicana y de el cine mexicano , casi no hay personas así aún que pues vivimos aquí en México y somos mexicanos	1	
Si , me he dado cuenta de que eres de esas personas que disfrutan de la literatura mexicana y de el cine mexicano , casi no hay personas así aún que pues vivimos aquí en México y somos mexicanos jajaY pues so , hay demasiado arte mexicano que en su mucha mayoría es muy bueno	1	
Soy mexicano y vivo en México jejeje	1	
Super amiwis y hermanas perdidas Niña Lucero Ultrasuperrecontrabien Mi super amiwis y hermana perdida en México Obvio Tu personalidad , tu voz y tu pinche acento mexicano Me algo hermoso OBVIO WEEE NelYa lo hice we , no joda	1	
Un día como hoy pero de 1950 debutaba esta jóven promesa del fútbol mexicano , marcó época en el club mas antiguo de México , El Hidalgo hoy club Pachuca	1	
Un día como hoy pero de 1950 debutaba esta jóven promesa del fútbol mexicano , marcó época en el club mas antiguo de México , El Hidalgo hoy club Pachuca , yo tengo la dicha de decir que es mi amigo , gracias figura por haberte entregado en cada partido , tus 300 goles cómo profesional no quedaran en vano , lástima tu lesión en la rodilla te orilló al retiro , pero siempre seras recordado	1	
Un día como hoy pero de 1950 debutaba esta jóven promesa del fútbol mexicano , marcó época en el club mas antiguo de México , El Hidalgo hoy club Pachuca Yo	1	
Un día como hoy pero de 1950 debutaba esta jóven promesa del fútbol mexicano , marcó época en el club mas antiguo de México , El Hidalgo hoy club Pachuca Yo tengo la dicha de decir que es mi amigo , gracias figura por haberte	1	
Un día como hoy pero de 1950 debutaba esta jóven promesa del fútbol mexicano , marcó época en el club mas antiguo de México , El Hidalgo hoy club Pachuca Yo tengo la dicha de decir que es mi amigo , gracias figura por haberte entregado en cada partido , tus 300 goles cómo profesional	1	
Yo soy mexicano y no busque eso verga le falle a mi México	1	
porque aca en México se maneja el peso mexicano	1	
#México,	mexicana
Curiosamente , mientras que la gente piensa que la bandera mexicana es simplemente la bandera tricolor italiana con el escudo nacional de México superpuesto , la bandera mexicana se diseñó en realidad antes que la bandera italiana  .	2	
El águila en la bandera de México alude a la cultura mexicana y el pasado azteca  .	2	
La bandera mexicana es un objeto de gran orgullo nacional en México  .	2	
Me dan pena Ajena , que vergüenza de ser humano , por gente como ella Sin Educación no progresa México y el mundo entero , que bueno que no soy mexicana me daría vergüenza tener a personas de la misma nacionalidad como ellas , Si ban	2	
Anduvimos en limpiemos México y después una pequeña presentación en la constancia mexicana	1	
Aquí en México es 52 Y Mane , por lo que dices es mexicana alv xd	1	
Aunqe así son lad de México aunqr yo prefiero a alguien qe no sea mexicana por lo mismo de qe son fasilonas	1	
Buenas tardes joven perdón por contestarle apenas pero tuve un problema con mi correo tenemos en toda la república mexicana , estado de México y distrito federal	1	
Coco porque es sobte México y ella es mexicana	1	
Es imposible salga en la rosa de Guadalupe bb yo soy del estado de yucatan pero pertenece a la república mexicana y la rosa de guadalupe se graba en en el estado de México bb claro q pertenece igual a la república mexicana amor	1	
Es que quizo jugar con México en el clásico mundial por que tiene sangre mexicana creo	1	
Exacto ya jugo en México creo en la liga mexicana del pacífico con culiacan hola en la liga del norte de coahuila donde jugo por 2 años en el equipo mineros de nueva rosita	1	
Gracias bella un saludo desde México q nivel mi amiga mexicana	1	
JaJaja yo tengo planeado irme a México y casarme con una mexicana y tener solo 1 hijo	1	
Jorge búscate una mexicana vete a Cancún México para que vean lo que es un paraíso	1	
La que me hace poner todo loco es Dana Perez y tiene 16 al igual que una mexicana o bueno venezolana que se fue a México y Njd tiene tatuaje y piercing y me mata mrca aaaaa  !	1	
Leyendas mexicanas en la majestuosa Arena México , recordar es vivir y las figuras de la lucha libre mexicana regresan a pisar el	1	
Lo unico k usted me puede mandar de México eres tu ala mexicana k me enamoro	1	
Owww amo México jején siempre e dicho que me casare con una mexicana y me iré a vivir a mexico	1	
Planisferios , república mexicana , estado de México de esos no quiere	1	
Si en esa carpeta viene los otros estados de la república mexicana incluyendo estado de México y df	1	
Tengo en toda la república mexicana , en el estado de México y d  .	1	
Tiene su origen en la Revolución mexicana de 1910 , paralelamente al movimiento de transformación en México  .	1	
Un planusferio sin nombre ubica los climas del mundo Ubica en un mapa de la república mexicana los climas de México dos hojas en blanco tamaño carta	1	
Weeeey consiguete una novia mexicana para que vengas a México xddd	1	
Y eso K es la voz México y la mayoría es ingles hacen a un lado nuestra música mexicana tan bella solo utilizan el nombre a su gusto	1	
Yo nací aqui en México mi nacionalidad es mexicana Delegacion gustavo a madero	1	
#Brasil,	brasileño
#Brasil,	brasileña
#China,	chino
Aplacste pinche chino te voy a reportar para que te manden a China no tienes nada que andar haciendo aqui	1	
China mas boba fuera un chino q valiera la pena	1	
China pues déjele el mensaje , pero ese chino es raro porque lo llame y no me contesto y a la segubda vez ya colgaba la llamada sera que robaron al chino  ?	1	
China se nota que ese chino te quiere	1	
China ud sve quien es este chino	1	
Eso me vendió a ese proverbio chino que dice El Gobierno de la República Popular de China ONUDI , el Ministerio de Educación de la República Popular de China , Ejecutivo caza paradaEn esta área , podremos lograr el objetivo de mejorar la calidad de nuestros productos y servicios  .	1	
No es chino porque no es de China  !	1	
Porque un chino en cualquier momento puede llegar o la China se puede olvidar de ud si pilla cagada	1	
Www k lindas palabras chino salgo yo hay vendiendola pero con mi China	1	
Yair o Lay o YixingEs chino , ahorita esta en China , saco su album , pero sigue siendo miembro de Exo dicen que ya se va a regresar	1	
#China,	china
Arturo AdriEliudSoldadoAlfredo y su weyYuya ale aroValeria BetoBetsLalo China jorgePuma y su vieja 2amigas Vanesa Chabelo 3 carnales de la china karla	2	
China unos ojos de huevos tiene pero ella se pone china	2	
Te vano a contactar para modelo fotografico , esta muy buena , averigua con tiempo para la camaradas 4 k de China importarla , pregúntale a tu tío Ale , el importo una de china y la mandaron a Israel de China	2	
Anda a China y Traeme un Koreano-Pero en china no hay KoreanosSon inmigrantes te acorda	1	
China , sii muy vieja se ve la china no le dije q ese marido es un chinito	1	
China estoy en casa de la china jaja	1	
China la dejo poque me boy a dormir ablamos lueguito y fuerza china palante ed paya patras ni a recoger el sombrero	1	
China mañana le tengo que decir algo china pero yo no quierooooooo	1	
China pero buenos para todo el mes china	1	
China pero me toca cerrar china	1	
China pero pensandolo bien mejor no china por que la verdad usted se queda sin plata	1	
China por q el monito te lo estoy diciendo de amigos china	1	
China pues de k hay un problema y yo no tengo para los pasajes china	1	
China pues según eso el es novio de esa china que sale hay , a mi también se me hace raro si el hace nada estaba con	1	
China pues según eso el es novio de esa china que sale hay , a mi también se me hace raro si el hace nada estaba con Gisela	1	
China que hago sera , que esta china si estudia , juiciosa no se si meterla o no	1	
China ud tanvien lo tiene china me envio la solucitud	1	
China y eso que tiene toda la berraca tarde china para hacerlas y no las hace	1	
China y le dijo a la china q no quería volverla a ver donde el estaba	1	
China y usted no se tiene que aguantar todo china vea yo a mi mama le corro	1	
China ya hablamos de eso china	1	
China yo amo a esa mujer la amo china	1	
Duvan si sele arrecho ala china porq le dijo q botara el perro aa mk le dijo China hp acaso usted me lo mantiene ok para q lo deja dentran porq no en cerro ese hp pedaso d conejo	1	
Era de la China y Tampico , cuando la china tocaba el techo	1	
La ropa China no es mas basura que la ropa américana por que ropa china hay mas que	1	
Mi China Preferida , Te amoooo china , siempre con vs voy a estar	1	
No pero si se entera la china es fijo Jajajajajaj Q conoció otra China y no sabe si dejarla o no	1	
Ps como yo cuando subi al rodrigo me miro re rato por que como yo le falla al hermanó y ps me quiere parar la china pero no se si a China me casque	1	
Si es China o original síes original esta en 500 su es china esta 2100 bs donde la compraste y saber si es original solo hay una tiendad	1	
pero es que es verdad uno estaba a punto de salir a recreo acompañada de la China volteabas y pummmmm aparecía ore en la cara de la china diciéndole podemos hablar aggg que tipejo ese enserio insoportable	1	
#Perú,	peruano
y te me hablan del Perú Y me hago mas peruano que la papa Imposible olvidar Hyo	2	
Aparece en Perú y no puedo ver los precios Jajja nose cuanto vale el peso peruano	1	
Claro como el peruano marcos te va a dar para que te vayas al Perú con el	1	
Ese perro es peruano v lo dicen los libros de historia del Perú	1	
Por que eres cholo peruano macho serrano come camote papa choclo crj naces en Perú y publicas esa webada	1	
Recordara de un jucumero peruano , necezitsmos ayudar a un muchacho del Perú	1	
Yo hablo argentino Pero Cuando estoy en mi Perú yo hablo a lo peruano pe	1	
y te me hablan del Perú Y me hago mas peruano que la papa	1	
#Perú,	peruana
Eso en Perú hay muchos ese video es incluso del bello y hermoso Perú de la selva peruana	1	
Y no me digas que tiene familia por que ella es la peruana que estuviste en Perú jajajajajajja  .	1	
#Argentina,	argentino
Aunque tu mamá sea de júpiter y tu papá de marte , si tu naciste en Argentina eso te convierte automáticamente en argentino  .	2	
Hacen envíos a Argentina y aceptan dinero argentino	1	
Lo entrevistarob aqui en Argentina y ya anda hablando super argentino	1	
Tránsito puede referirse a el tránsito astronómico , paso de un astro por delante de otro más grande ; el tránsito vehicular , el flujo de vehículos en una vía de comunicación ; el Tránsito Aduanero Internacional , régimen aduanero por el cual la mercadería es trasladada entre países ; el Tránsito de la Virgen María , un concepto usado en el cristianismo ; Tránsito , localidad y municipio del departamento San Justo de la provincia de Córdoba , Argentina ; oMario del Tránsito Cocomarola , músico y folclorista argentino	1	
Y cuando paso eso de la 2da gerra paso tiempo y mi tatara abuela se fue a Argentina y ay conocio a un argentino y tuvieron a mi bisabuelo y ay sigio la historia	1	
Y los bolovianos vienen a Argentina y es tratado como un argentino mas  .	1	
#Argentina,	argentina
Nunca se lesiono , nuca se enfermo , muchos en el mundo los critican asta en su mismo pais Argentina lo critican , siendo el masimo goliador de argentina , y apesar de las criticas Este hombre sigue de pie , poreso es que lo sigo admirando y lo voy a seguir asiendo toda mi vida , Este es D 10s gracias messi x ser argentino y tengo toda la fe de que Este año ganamos el mundial , y de Seguro muchos falsos le van a agradecer	2	
23 Argentina uno , minuto 19 argentina mete otro gol	1	
Argentina pero de q parte sos de argentina	1	
Asi alienta ah la argentina te amo bebote hermoso te queda el conjunto de Argentina te amo mi cielo	1	
Ayer me llamo mi jefe de argentina y me pregunto si no quería ir a trabajar con ellos a Argentina me dijo que el pagaría los pasajes le dije que lo pensare nada mas	1	
Claro el dice no va a ver mas pobres en argentina después en la calle ve un pobre y lo saca cagando de Argentina que vivo entende	1	
Conmigo nunca miren un partido de argentina porque soy capas de cagarte a piñas ya por ver que Argentina jugo mal	1	
De argentina , estoy en medellin pero pasado mañana tengo q irme a Argentina	1	
Dijo que la argentina no puede ir al mundial q la selección de fútbol de Argentina si por q argentina se tiene que quedar en el lugar nc puede mover del mapa	1	
El idioma lo aprendi sobretodo en argentina , por eso me digo Argentina	1	
El sabado estube viajando a argentina el domindo llegue y antes de aller bolvi a Argentina ya no creo bolver	1	
Es que chile es donde vivo y Argentina es donde esta mi hermano y que le gusto argentina	1	
Estamos en la aduana argentina , osea que ya estoy en Argentina otra vez	1	
Exacto eso es cierto , pero el profesor este es muy bueno con respecto a que ama la Argentina y dice que le gustaría que volviéramos a la argentina de antes por que ahora casi todo es importado de otros países  .	1	
Fede se ofreció a llevarla a puerto madero en el auto del pero para el paso terrestre desde uruguay a colón dice q esta re complicado con los turistas que vienen de Argentina a Uruguay a horas de retraso para poder cursar asi argentina	1	
Holaa , podrias venir el lunes para grabar a las 7 de la tarde , tendrías q traer puesta alguna remera de argentina , y algun gorro o una bubucela o algo q tengas de Argentina	1	
Jaja neel yo no soy de argentina soy de Colombia pero hablo como hablsn en Argentina Jeje desde bb	1	
Lo dices xq perteneces a la parte de la gente que es ignorante x no ver q el tipo esta ayudando a sacar a la argentina del pozo q armaron todos los presidentes anteriores q undieron a la Argentina	1	
Nunca se lesiono , nuca se enfermo , muchos en el mundo los critican asta en su mismo pais Argentina lo critican , siendo el masimo goliador de argentina , y apesar de las criticas Este hombre sigue de pie , poreso es que lo sigo admirando y lo voy a seguir asiendo toda mi vida , Este es D 10s gracias messi x ser argentino y tengo toda la fe de que Este año ganamos el mundial ,	1	
O deverian venirce la Argentina ya fue ya paso sus buenos tiempos Bolivia esta mejor que la argentina	1	
Padres son españoles pero mi madre se embarazo en españa y luego fue a argentina a visitar a mis abuelos que estaban de pasada y nací yo en Argentina tengo raíces españolas y argentinas	1	
Qué yo creo que esta niña no le falta un poquito de conocimiento y cultura cuando dice que Argentina es el rey cuando si no fuese por un español argentina no existiría y que no tiene huevos a decírselo a alguien en	1	
Qué yo creo que esta niña no le falta un poquito de conocimiento y cultura cuando dice que Argentina es el rey cuando si no fuese por un español argentina no existiría y que no tiene huevos a decírselo a alguien español que por m	1	
Qué yo creo que esta niña no le falta un poquito de conocimiento y cultura cuando dice que Argentina es el rey cuando si no fuese por un español argentina no existiría y que no tiene huevos a decírselo a alguien español que por móvil todo el mundo es valiente	1	
Si halloween en argentina se festeja pero en estados unidos piden caramelos y eso en Argentina no muchos y si en México si creo	1	
Te amoooooooooooo rrruarr soy gaticornia saludos desde argentina cuando vas a venir a Argentina , provincia neuquen	1	
Tengo una amiga en colombia que escucha música argentina y le encanta el mate jajajaja parece más Argentina que Colombiana con sus gustos jajjajaja	1	
Va Querer que gane Los ingleses este traidor que me chupe la pija yo se que para Argentina ni un país va tirar , todos quieren que argentina pierdan , pero esta es nuestra muchachos	1	
Xq la Argentina se los esta pagando y no les corresponde xq no son de la argentina algo asi	1	
Y Argentina el sabado alas 10 30 de la mañana hora argentina juega contra russia	1	
Y el pasaje desde Argentina a mexico es lo mismo que ir desde mexico a argentina	1	
estamos es corea o en argentina , digo por wue no se si hace frío Corea o calor Argentina	1	
#Corea,	coreano
Es que yo lo vi y dije ese man no es de Corea no tiene los ragos faciales de un coreano y vi y era gringo	2	
Estoy aprendiendo coreano ya que quiero irme a Corea jejej	2	
Con motivo de la Feria del Libro de Fráncfort 2005 , en la que Corea participó como país invitado , se construyó un jardín coreano en el Grüneburgpark , el parque más grande de Fráncfort del Meno  .	1	
Es mejor porque aprendes ingles y si vas a Corea podes hablar en ingles , ademas si buscas tutoriales de aprender coreano pero lo buscas en ingles aprendes coreano pero no se te olvida el inglish	1	
Es que iré a Corea muy pronto pero quisiera hacer un curso de coreano por unos 6 meses	1	
Hice q una amiga que es de Corea escriba tu nombre en coreano D	1	
Mañana temprano aré un en vivo cantando en coreano por medio del grupo Mi Mundo Es Corea Del Sur para las que quieran verlo sera a las 10 00am	1	
Sabe tanto coreano como ingles , con su madre lo hablaba mucho ya que ella a pesar de vivir en Corea y estar casado con un coreano , no sabe el idioma v	1	
Sabes eres una persona muy especial para mi , ya que haces felices mis dias , compartimos gusto en música , idols , k-dramas , etc y es hermoso porque nos emocionamos igual y es bonito Tu y yo iremos a Corea del Sur juntas Veremos doramas juntas Aprenderemos coreano y hablaremos entre nosotras Tu y yo juntas para toda la vida SIHL & SRM	1	
Se cumplira mi sueño Viajare a Corea Me casare con un coreano Próximamente No te pierdas esta triste hidtoria	1	
Su fama es tan grande que ha sido comparada a la de Michael Jackson en los años ochenta , e incluso está considerado como el rey y creador del K-Pop , padre del Nu-metal coreano y colaborador a la creación del Heavy Metal en Corea del Sur  .	1	
Wnn casi muero estaba en el negocio de abueli y viene un coreano y mi abueli le pregunto de donde era y dijo de Corea del sur , Daegu y casi me voy a la shusha	1	
Él nació en New York , pero a la edad de 5 o 6 años se mudo a Corea , por lo que se considera más coreano que estaunidense	1	
#Corea,	coreana
No , hablaron de la belleza coreana porque están mostrando sus compritas que hicieron en Corea y salió la fotito de Hae	1	
#Egipto,	egipcio
#Egipto,	egipcia
#Ucrania,	ucraniano
#Ucrania,	ucraniana
#Australia,	australiano
#Australia,	australiana
#Rusia,	ruso
Un médico ruso comenta Eso tampoco es nada , en Rusia la medicina esta tan avanzada que le sacamos la mitad del corazón a una persona se la ponemos a otra y en dos semanas , ambas están buscando trabajo  .	2	
Irala que perra , si viajas a Rusia me secuestras a un ruso nalgon y barbon	1	
O Rusia porque amo el ballet ruso	1	
Un médico ruso comenta Eso tampoco es nada , en Rusia la medicina esta tan avanzada que le sacamos la mitad del corazón a	1	
Y este es uno de los mas famosos , aunque creo que no era nacido en Rusia , canta en ruso	1	
#Rusia,	rusa
Le diré a Oscar que me pague mi boleto para Rusia para llevarme a mi rusa y a las dos tuyas	1	
#Japòn,	japonés
#Japòn,	japonesa
#Camboya,	camboyano
#Camboya,	camboyana
#Grecia,	griego
El griego en griego , elini ci losa o elini ka es una lenguaoriginaria de Grecia , que pertenece a la rama griega de las lenguas indoeuropeas  .	1	
#Grecia,	griega
Antecedentes del período pre-socrático Ha trascendido como época clásica griega , la cultura que floreció en el Ática , al sudeste de Grecia  .	1	
El griego en griego , elini ci losa o elini ka es una lenguaoriginaria de Grecia , que pertenece a la rama griega de las lenguas indoeuropeas  .	1	
Euge me pasas una ft de la parte del resumen de Grecia que dice segunda colonización griega	1	
#Países Bajos,	neerlandés
#Países Bajos,	neerlandesa
#Inglaterra(英格兰),	inglés
#Inglaterra(英格兰),	inglesa
#Polonia,	polaco
#Polonia,	polaca
#Irlanda,	irlandés
#Irlanda,	irlandesa
#Eslovaquia,	eslovaco
#Eslovaquia,	eslovaca
#Albania,	albanés
#Albania,	albanesa
#Chile,	chileno
En una parte d lo estudiaba decia Chile , me acorde de vos y dije le voy a escribir al chileno por si esta despierto  !	1	
Es qe va cambiando a veces más barato y ya mucho no van a Chile y si aumenta el dólar aumenta el chileno	1	
La verdad , soy chileno , esto ocurrió en Chile amigos  .	1	
No tenes ningún camion chileno aca en mza para hacer una IMO a Chile  ?	1	
Pero justo en programa de TV de acá estaban pasando un programa y estaban haciéndoles una Nota de todo lo que sentían porque lo discriminaban , entonces quería saber como ibas responder vos que por las fotos de Chile me di cuenta que era chileno	1	
#Chile,	chilena
Fue una cantautora , pintora , escultora , bordadora y ceramista chilena , considerada por algunos la folclorista más importante de Chile y fundadora de la música popular chilena  .	2	
Porque no se cuanto equivale los bolivarws a moneda chilena pero de seguro equivalera a ka moneda mas baja de Chile	1	
#Alemania,	alemán
Un médico alemán comenta Eso no es nada , en Alemania Le sacamos parte del cerebro a una persona , la ponemos en otra , y en cuatro semanas ya está buscando trabajo  .	3	
6 Los sajones , que provenían de la Baja Sajonia en la Alemania moderna ; en alemán , Niedersachsen y de los Países Bajos  .	1	
Mi mamá se va a casar con su novio alemán y quiere mudarse a Alemania	1	
Si ya veo a Emilio Gamboa y los del Prian y Prd y más aprobando esa ley mejor aprende alemán y huye a vivir a Alemania	1	
Soldados argentinos alla por los 40 con el uniforme alemán y el casco Aleman recordemos que Argentina tenia muy buenas relaciones con la Alemania nacional	1	
#Alemania,	alemana
#Austria,	austriaco
#Austria,	austriaca
#Italia,	italiano
Durante más de 20 años , estudió historia , arqueología y el entorno natural de Egipto , donde comenzó a trabajar en 1988 como director de la misión Horus , dirigido por el Ministerio de Asuntos Exteriores de Italia , que quería relatar los itinerarios del italiano  .	1	
El murió siendo italiano pero no vivía en Italia	1	
Osea q te digo q a mi mama no le dan haci son los italianos a las esposas no dan x eso la otras mujeres de mi papa tampoco no tienen pero yo si puedo pedir para q ingreses a Italia x lo q yo ya soy italiano y si te dan y no importa no seamos casados ni nada tranquila mente pido y me dan tengo para tres pedidos cada italiano	1	
Por ejemplo la empresa bonzo necesita un traductor Idioma ingles , ruso , italiano Va a viajar a rusia Italia no recuerdo mas	1	
Que sad , me acorde de la chica de Venezuela con la que hablaba mucho , ella esta en Italia y nmms habla bien bergas el italiano xd	1	
Sería italiano , dijimos que iríamos a Italia	1	
Si hablo italiano pero nose quien quiera casarse conmigo en Italia	1	
Soy de descendencia Italia y española pero el italiano ni ahi	1	
Tilsa aprendió italiano en esas idas y venidas a Italia cuando visitaba al Loco , ella misma lo confesó	1	
Toluca we ni modo k de Italia esta bn k soy italiano pero no te la jales Pirrureishon	1	
Y no me hables italiano que tebgo a mi tío de Italia te hace 2 semanas vinieron los padres	1	
mira a su alrededor no se en que lugar pero es una mansión , en un campo dice mirando por la ventana estoy encerrada en un cuarto en el 3 piso y todos hablan italiano , supongo que en Italia pero no se en que parte de Italia sus ojos se cristalizan	1	
sabes que mi abuelo tambien hablaba italiano porque nació en Italia y después vino para acá  .	1	
#Italia,	italiana
El libro de la autora italiana ha sido ya líder de ventas en Italia y se inspira en la frase esposas , estad sujetas a vuestros maridos , de San Pablo a los Efesios  .	10	
Bueno Armando estaba lavandole el cerebro a mi mama de que se vayan para Italia , porqur Armando es hijo de Italianos y puede pedir nacionalidad italiana y al estar casado con mi mama le dan nacionalidad mas rapida	1	
Kilian Tu futuro prometido tuvo la culpa , su padre era el lider de una mafia italiana , este por no tener a la mejor bailarina y cantante de Italia decidio matarla , tu tenias apenas 6 años , Ian es tu hermano eso obviamente lo sabes pero tienes otro hermano que desaparecio cuando tu madre murio	1	
Y en Italia tambien dan becas en sociedad italiana o asi	1	
no bobito porq se esta haciendo los papeles y los de nosotros porq el se va a Italia en mayo a laburar ahí y tenemos que tener los hijos la ciudadanía italiana asi podemos visitarlo asi qe esta en la plata haciendo todo	1	
#Noruega,	noruego
#Noruega,	noruega
Con una ONG de Noruega , se llama ayuda popular noruega	1	
#Suiza,	suizo
Me vas a llevar a Suiza para casarme con un suizo	1	
#Suiza,	suiza
#Malta,	maltés
#Malta,	maltesa
#Israel,	israelí
#Israel,	israelí
#Moldavia,	moldavo
#Moldavia,	moldava
#Colombia,	colombiano
y la constitución de Colombia dice que hijo de Colombiana es colombiano , o sea si el dice que es Venezolano , tiene doble nacionalidad , y no puede ejercer ese chofer de busetas que , es su profesión Presidente de Venezuela  .	2	
Amigo si tu bb nace en Colombia por ley es colombiano a ustedes para que les den papeles colombianos tendrían que esperar a que ese bb cumpla 18 años para que el los pida pero igualmente ustedes pueden iniciar las vueltas para pedir su nacionalidad y el tener un hijo colombiano les daría un poquito mas de ventaja	1	
Definitivamente ai personas que parece que cuando uribe fue presidente no haniam nacido y hoy lo veneran como si fuera Dios sabiendo que lo mas corrupto que a tenido Colombia es esa familia de apellido uribe ademas es un genocida del pueblo colombiano	1	
En Colombia es mejor porque yo e visto película y lo colombiano le dan plata asus mujeres para que se compren lo que necesitan	1	
Es como en Colombia por que hay cantantes si no hablan colombiano	1	
Es que Alla la constitución no permitía que hubieran expropiaciones pero comboco a una asamblea constituyente cpmo lo quiere hacer petro y yo me se la historia de Colombia si yo leo Marik pero solo digo lo que pienso como todo colombiano con su derecho a exprecion	1	
Es que yo estoy en Colombia no me deja agregar su número y nesecito en valor de peso colombiano	1	
Esta mañana , por parte de un ciudadano colombiano , leí que Gustavo Petro hizo parte con bombas en la independencia de Colombia , y para rematar la noche , yo , le debo de probar la buena fe a un vigilante de la Universidad en la que estudio Derecho	1	
Esta mañana , por parte de un ciudadano colombiano , leí que Gustavo Petro hizo parte con bombas en la independencia de Colombia , y para rematar la noche , yo , le debo de probar mi	1	
La gente de Colombia es como Bruta se alegran que pierda un equipo colombiano	1	
No nomas porque como me dijiste de Colombia por eso te dije que si eras colombiano	1	
No si con estos mandatarios que a tenido colombia como éstas Colombia para adelante con altos congrecistas robando al pueblo colombiano , con mermeladas , obras inconclusas que an costado millones de dólares acaso eso no lo sabe el pueblo y el fenómeno petro a sido culpa de éstas ratas	1	
Pero fabio es de Colombia y ese numero no es colombiano jajajaja	1	
Pero k tiene igual y se nos hace o a Colombia me encantaría conocer Colombia igual y el amor de mi vida sea un colombiano jajajaja	1	
Pero naci aquí en Colombia y fui militar colombiano y tengo mi cedula de vzla	1	
Soy colombiano y como tu soy futbolista juego muy Bn pero aca en Colombia no vale el talento si no la plata si me ayudaras te agradecería neymar	1	
Soy el único colombiano o hay alguien mas de Colombia  ?	1	
Yo soy colombiano y estoy aca en Colombia jajajaj	1	
#Colombia,	colombiana
Ella es colombiana y nunca había salido de Colombia	1	
Hola debes darme cédula colombiana o cédula de migración Colombia de 6 digitos	1	
Hola soy una joven colombiana quiero conocer y manejar sus productos de belleza para venderlos en Colombia me parecen	1	
Mentiras caro es el man que trabaja conmigo en el bar , el ya lleva casi el año creo , y obviamente no es un trabajo formal , tiene ingresos de 150 semanal osea 600 mensual el nacio en venezuela pero tiene cedula colombiana por que se crio aca en Colombia , no ha tenido creditos  .	1	
Porque la empresa es colombiana y solo su uso esta en Colombia para ninguna otra país mas de pronto en un futuro la empresa podra expandirse pero mientras solo esta disponible para colombia	1	
Sady Ramírez se dio a conocer como la voz líder del grupo clase , una prestigiosa agrupación colombiana y fue también reconocido como uno de los grandes compositores de Colombia al recibir el premio La Lira de Oro , entregado por la sociedad de autores SAYCO  .	1	
Si ami me voy para Colombia ya estoy arreglando los papeles para nacionalizarme colombiana cuando la tenga me voy	1	
Si pero tengo sangre colombiana y de que parte de Colombia eres	1	
Te reenvío el correo que me envio mi amiga desde españa , es colombiana llega esta semana a Colombia	1	
Y pero tengo año de vivir en Colombia osea soy venezolana y colombiana	1	
Ya vi eres mexicano yo soy colombiana y aki en Colombia se la entierran todiata x mala	1	
Yo pensé que era a lo colombiana xq cm hablavamos de Colombia	1	
Yo se que no soy colombiana mialma soy una de tamtas venezolanas que vienen a Colombia a trabajar	1	
#Bulgaria,	búlgaro
#Bulgaria,	búlgara
#Macedonia,	macedonio
#Macedonia,	macedonia
#Croacia,	croata
#Croacia,	croata
#Dinamarca,	danés
#Dinamarca,	danesa
#Islandia,	islandés
#Islandia,	islandesa
#Francia,	francés
Emm seria , aprender bien portugués y francés para viajar a Brasil , Portugal y Francia	1	
Pues los convenios que tienen son en Ecuador , Chile y no me acuerdo más son para estudiantes de los primeros semetres Y pues ya para los que ya van avanzados en ingles y francés se van a Francia , estados unidos y asu	1	
Y aparte el contrato lo hacen en portugués Se supone que si están en Francia deberian hacerlo en francés	1	
Y el pastelero fue con el embajador francés quien se comunico con Francia para hablar de lo ocurrido	1	
#Francia,	francesa
Eu eso de Camille viste que puede ser porque a Harry le gustaban las más grandes y encima francesa con lo que él no ama Francia	1	
La Segunda intervención francesa en Méxicofue un conflicto armado entre México y Francia entre los años 1862 y 1867  .	1	
#color,	colores
Yo era de color gris , hasta que llegaste tú y me pintaste de colores  .	18	
Su ropa interior siempre suele ser muy sexy y elegante , con encaje y algún lazo entre medias de los sujetadores y en su ropa de cama , suele usar ya sea camisones de tirantes con bastante escote y saltos de cama ya sea en colores claros o en color negro o rojo que son colores más elegantes  .	10	
Buenos dias mi gorda pero yo muchisismo mas bb Ayñ sii bb sera muy lindo andale bb asi mero Jajaja naa sacaron mas tu color amor Ayñ mi cielo shii bbJejeje andale bb combinamos nuestro colores Ya no pienses mal jajaja que neta casi te daba un infarto Ayñ mi amor andale cariño muy pronto vamos a comenzar nuestea linda relacion pero tu eres muchisismo mas linda bb andale mi amor asi mero ambos nos seguiremos siendo fiel físicamente no me engañarias amor pero mentalmente sii  ?	9	
Buen día , programación semana del 5 al 9 de febrero Alcides Guzmán Lunes 5 prepacion de colores factory pack Imlar base color  .	7	
La vida no es color rosa pero hay personas que se encargan de alterarnos los colores	7	
Pues si ya se cumplieron 1 año 4 meses desde la primera vez que te conocí me di cuenta que lo recordaste pero no creo que tanto como yo porque sinceramente no se lo que me sucedió en ese instante te vi y todo mi mundo se puso de cabeza descontrolaste todo mi ser al , te lo juro que no hay nada mas hermoso que estar contigo le das color a mis fias grises y a los de colores maas brillo  .	7	
Me gusta ayudar a los demás en especial cuando son mis amigos Amo a los animales Me fascinan los colores pasteles Las rosas color rosa son mis preferidas Todo lo Kawaii me vuelve loca Me fascina la música en inglés El POP y el K-POP son mi género preferido Amo las peliculas infantiles También me gusta mucho el anime mi Princesa Disney favorita es Mulan Soy fan de Justin Bieber Me gusta mucho el chocolate Me gusta cantar Se bailar danza arabe desde los 5 años	6	
Admito que amaba mucho los colores fantasía , pero joder , que amo este color y como me queda ; Pero no puedo subir foto hasta el martes  ?	5	
Me toca ver tus lagrilas hoy ver caer por alguien que no te supo valorar pero el tiempo todo sanara mientras tu lloras el sonrie sin ti y no puede ser asi tu te mereces ser feliz y si no fue con el eso es cosa del destino de un mundo de colores pasaste a uno color gris  .	5	
Nene , se supone que los formatos van de algún color característico de la empresa , pero colores así como en cuadros  .	5	
Me gusta ayudar a los demás , en especial cuando son mis amigos Amo a los animales Me fascinan los colores pasteles Las rosas color rosa son mis preferidas Todo lo Kawaii me vuelve loca Me fascina la música en inglés El POP y el K-POP son mi género preferido Amo las peliculas infantiles T	4	
19 Aunque cada gota dispersa todo el espectro de colores , un observador solo puede ver la luz de un solo color de cualquier gota  .	3	
Además , las agujas , los tubos y otros accesorios necesitan ser limpiados cada cambio de color para evitar que los colores oscuros se mezclen con los claro  .	3	
Cuando ya tienes tu mundo de colores y por hacer 1 escarmiento se te vuelve a el color original negro  .	3	
Decidi ó salir a caminar al parque , se desvió lleno a la playa , se sentó a orillas del mar buscando inspiración , mirando los hermosos colores del cielo , el color anaranjado del atardecer y el azul con las estrellas del cielo que hoy parecían mas brillantes  .	3	
Di en voz alta cada uno de los colores , no lo leas , di el color que ves  .	3	
Me gusta ayudar a los demás , en especial cuando son mis amigos Amo a los animales Me fascinan los colores pasteles Las rosas color rosa son mis preferidas Todo lo Kawaii me vuelve loca Me fascina la música en inglés	3	
Te veía de mil colores y ahora ni siquiera se que color eres	3	
Uno de los colores que te gustan es el color neon c	3	
Yo era buena a comprar sandalias de diferentes colores antes me gustaba andar del color de la comisa las sandalias	3	
colores de cabello de moda color rosa y morado	3	
Alguien que ponga gelish en mis uñas naturales que tenga colores que cambien de color  !	2	
Bno mira como t decia Me gustan las gorras ropa que me quede grande tenis d bota odioo los Zapatos Amo el color morado Aúnk igual me gustan los colores Mi música preferida es Reggae rap hip hop y un poco de Rock y asíY amm ps me encariño demasiado rápido con las personas k muestran afecto interés X miii y cuando pasa eso ps literal mente daría todo por esa persona	2	
Bueno amor , creo que las correas y collares están por allá -Dije señalando la sección-Vamos , parece ser que hay varios colores -Al acercarnos tomé un collar de color verde , ya que si no mal recuerdo era el color favorito de mi preciosa Min-Que te parece este , linda  ?	2	
Buenos dias mi gorda pero yo muchisismo mas bb Ayñ sii bb sera muy lindo andale bb asi mero Jajaja naa sacaron mas tu color amor Ayñ mi cielo shii bbJejeje andale bb combinamos nuestro colores Ya no pienses mal jajaja que neta casi te daba un infarto Ayñ mi amor andale cariño muy pronto vamos a comenzar nuestea linda relacion pero tu eres muchisismo mas linda bb andale mi amor asi mero ambos nos seguiremos siendo fiel físicamente no me engañarias amor	2	
Combo 122 bloc de hojas 1 rayado y otro cuadriculado 1 paquete de folios 1 caja de colores simball 1 paquete de fibras 1 TIJERA 2 lápiz negro 3 lapiceras de color 1 lapicera azul Bic 1 liqui 1 resaltador Sharpie 1 caja de crayón 1 plásticola 1 goma 240 ESO TRAE	2	
Cree yo misma el color aveces me toca hacer los colores que me gustan porque hay en Venezuela estamos limitadas de colores	2	
De los dos colores rojos y azules o un solo color  ?	2	
Gustos jugar 7u7 , bailar , cantar , leer , los colores le fascinan los de color , lo pockys no se si se escribe asi , salir a pasar en la noshes , etc  .	2	
Hola compañeros hice una crew en la cual cada semana se va a poner un color raro de crew por si ustedes son de los que quieren colores raros  .	2	
Hoy mi pincel no tenia colores , solo pintó mi día de color gris  .	2	
Me gusta ayudar a los demás , en especial cuando son mis amigos Amo a los animales Me fascinan los colores pasteles Las rosas color rosa son mis preferidas Todo lo Kawaii me vuelve loca Me fascina la música en inglés El POP y el K-POP son mi género preferido Amo las peliculas infantiles También me gusta mucho el anime y Mi Princesa Disney pr	2	
Me gusta ayudar a los demás , en especial cuando son mis amigos Amo a los animales Me fascinan los colores pasteles Las rosas color rosa son mis preferidas Todo lo Kawaii me vuelve loca Me fascina la música en inglés El POP y el K-POP son mi género preferido Amo las peliculas infantiles También me gusta mucho el anime y m	2	
Me gusta ayudar a los demás en especial cuando son mis amigos Amo a los animales Me fascinan los colores pasteles Las rosas color rosa son mis preferidas Todo lo Kawaii me vuelve loca Me fascina la música en inglés El POP y el K-POP son mi género preferido Amo las peliculas infantiles También me gusta mucho el anime mi Princesa Disney favorita es Mulan Soy fan de Justin Bieber Me gusta mucho el chocolate	2	
Me gusta ayudar a los demás en especial cuando son mis amigos Amo a los animales Me fascinan los colores pasteles Las rosas color rosa son mis preferidas Todo lo Kawaii me vuelve loca Me fascina la música en inglés El POP y el K-POP son mi género preferido Amo las peliculas infantiles También me gusta mucho el anime mi Princesa Disney favorita es Mulan Soy fan de Justin Bieber Me gusta mucho el chocolate Me gusta cantar Se bailar danza arabe desde los 5 años y me gusta mucho la persona que soy / / es decir  .	2	
Mide 35 cm cuadrados y va del color que gustes pueden ser 2 colores  .	2	
Mira tengo estos dos colores son papel contal brilloso que decís vos quedara lindo hacer las alas en color celeste , xq la cartulina que tengo en blanca esta media sucia va manchada , yo decía pegarle el papel contal a la cartulina para hacer las alas y así quedan un poquito más dura las alas	2	
No si yo ni la voy a ver lo q voy a ver es el color del pantalon q parece q los colores se lo hizieron mal	2	
Pero las que tengo son rosas jsjsjs Las quiero transparentes de colores , o negras , azules , grises , o color crema No se que color aún  !	2	
Pistola de silicón si tenemos nada más falta Las barritas poema Sólo tengo dos hojas de cada color papel verde tengo de China si tengo hojas de colores Dime Cuántas Y de qué color	2	
Pues me gusta estar en mi casa escuchar musica , salir en el carro y Creo que ir al GYM Mmmm Comer Galletas y helado Me gusta el color Negro combinado con colores Muy llamativos rosa , Azul , Amarillo etc  .	2	
Si no que me toca comprar mas pañoletas de mas colores Se que el rojo me encanta , pero un mismo color siempre aburre	2	
Tintas en base de agua 420 el paquete para 1 persona SMYKTinta base solvente de 40 mlt en color negro , rojo , Amarillo y azul en 270 en paqueteEl caltex de 5 colores de cuarto , cada color esta 420El policat igual los 5 colores de cuarto esta 525 , lo pueden comprar por 4 personas P 4000 esta en 110 el litro , igual lo pueden usar 2 o 3 personaLa prensa en 450	2	
Tu color no esta dentro de mi diminuto grupo de colores favoritos  .	2	
Tu color no esta en mi diminuto grupo de colores favoritos  .	2	
el hombre de mis sueños mi principe nose de q color o mejor dicho no solo mi principe azul sino el de todos los colores  .	2	
-un corrector de brocha o sinta-plumines de colores-sacapunta que se me ronpio el otro-goma-lapiseros de colores se me acabaron los ocupo mucho-una libreta de rayas color naranja para formacion	1	
//yo en secundaria llevaba una cartuchera gorda con solo lapices de colores para dibujar en clases pues no usabamos color	1	
2 block de hojas X 480 uno rayado otro cuadrículado 2 liqui 2 lapiz negros 2 gomas 2 colores x 122 fibras x 12 Lapiseras de color rojo , verde y negro dos de cada uno 2 lapiseraa azul 2 carpetas de nena 2 carpetas para nene 8 ganchitos grandes 1 carpeta de dibujo n 62 block de hoja n 64 separadore 2 de nena y 2 de nene	1	
2 carpetas número 3 , hojas rayadas y cuadriculadas exito , 12 folios , hojas canson número 3 blanca y de color , 1 cuaderno de 50 hojas rayado tapa dura , 1 cartuchera de nena , 1 lapiz negro , 1 caja de colores , hojas canson n 5 de color y blancas , 1 sacapuntas , goma , tijera punta redonda , voligoma , regla de 20 cm , transportador , compas	1	
#sueño,	sueños
Parpadeo através , de las profundidades de un sueño El Dios de los sueños ríe elgentemente , mientras juzga la muerte humana El espacio tiempo toma sus cadenas , que se funcionan con el más hayaUn programa de fantasía dado por un Dios Ahora vamos , un , dos , tres  !	111	
No quiero cerrar mis ojos , no quiero quedarme dormido porque te extrañaría & no quiero extrañar nada porque incluso cuando sueño contigo el más dulce de los sueños no alcanzará , aun así te extrañaría & no quiero extrañar nada  .	27	
Que descanses super iper mega recontra bien y duermas muy a gusto como estaría perfecto para ti y que a compañía de eso cuando hayas logrado consolar el sueño tu cabecita se llene de unos sueños tan mas preciosos llenos de amor y tranquilidad y donde las pesadillas malas y feas no vallan a abitar y arruinarlo mi pedacito de cielo lleno de vida y amor  .	21	
buenas noches amor mio Ten dulces sueños yo cierro los ojos para poder alcanzarte en el sueño Para poder iluminarte y endulzarte tu sueño Espero no aburrirte por estar tan pegado a ti amor mio Tu eres la unica Tu eres quien me ilunina cada mañana  .	17	
Ahora , mi sueño más grande , es estar siempre a tu lado y cumplir todos nuestros sueños  .	15	
Una mañana con lagrimas unos sueños q no se cumplen y solo me queda un sueño para cumplirle a mi angelito	14	
De que yo nunca te dejare creme que no lo aré tu tienes tus sueños por cumplir yo tengo los mios , tu quieres irte lejos para cumplir tus sueños ya que siempre lo has deseado y sin tener una familia ; por otro lado yo quiero vivir mi sueños contigo si te digo que sueño contigo sentados en un lago y un hermoso paisaje creme que no nada mas somos nosotros si no otras personitas babys yo si quiero tener una familia pero ya mas adelante talvez nunca lleve a ser grande talvez muera  .	13	
pero cualquier momento que paso contigo me encanta , quiero que se pare el tiempo o que pasa muy lentamente , para disfrutar el momento a tu lado Que conviertas mis puntos en comas ; o que me comas y punto Todas las noches quiero soñar contigo , pues cuando sueño contigo no me quiero despertar , es hermoso tenerte en mis sueños El amor es un sueño  .	13	
Pues sí preciosa Me hiciste sentir muy bonito , que me digas que soy el único con el que sueñes con el que tienes todos tus sueños y que te sueño más grande se a poder estar conmigo para siempre  .	11	
Dulces sueños morTe veo en mis sueños y me agrada sueño con tus hermosos ojos y tus labios sobre los mios  .	8	
Hoy hace 2 años se formo CNCO , estos 5 chicos que tenian un sueño y que ahora lo estan haciendo realidad ellos me enseñaron que los sueños si se cumplen si lo deseas demasiado , y que Nunca nos demos por vencidos  .	8	
Haz de tu vida un sueño y de tu sueños una realidad  .	7	
Pues obvio en ningun lado por que eres unico mi niño En verdad que eres el niño de mis sueños El niño que sueño todas las noches Y sabes  ?	7	
Yo quiero en serio todo lo bueno para ti , ayudarte a cumplir tus sueños es mi mayor sueño , hacerte feliz , demostrarte todo el amor que te tengo , es una meta a la que quiero llegar , y es la meta que me propongo todos los días , al momento de estar contigo , hacerte feliz , darte todo mi amor , consentirte , dandote la energía que necesitas para estar bien  .	7	
Mi amor mi único sueño es que tu y yo podamos cumplir todos nuestros sueños	6	
en mis sueños una noche y solo sueño desde entonces para verte cada día junto mi  .	6	
Ayúdanos a no derrumbarnos compa , danos fuerza para no quebrar al despedirte , contagia en nosotras tu paz , aparece en cada uno de nuestros sueños y calma nuestro dolor con tus palabras , en cada sueño contesta todas nuestras preguntas , sorprendernos hai , juguemos a la pelota en tu paraíso , abrazame fuerte antes que despierte de cada sueño en la cual te encuentre y muestrame esa sonrrisa que todos vamos anelar , disfraza este dolor en alegría , guianos por un camino donde volvamos a vernos amiga  !	5	
Deseo que puedas tener dulces sueños , Siempre estás presente en mis pensamientos y cuando estoy durmiendo sueño contigo  .	5	
Entonces ya hay que ir a dormir mi pequeña hermosa , hasta mañana te quiero te amo , te tapas super bien he , siempre sueño contigo tu eres lo mas lindo de mis sueños lo que me da color a ellos , tu igual sueñas conmigo  .	5	
Me encantaría ganar este M&G , porq seria un sueño realidad y saber que los sueños si se hacen realidad  .	5	
Oye las veces que sea necesario esconderte tras de un armario cobijarte las noches y abrazar tu llanto y ser por siempre tus risas tus sueños tu canto y ser tu sueño fugaz	5	
Buenas noches mi niño hermoso Ten un sueño bonito y calido Nos vemos en nuestros sueños mi niño hermoso Te amo TE AMO descansa mi niño hermoso , te amo mi vida , descansa Te amo F&C ohana Nunca , NUNCA déjare de amarte Nunca , NUNCA te dejare Nunca , NUNCA perderé el interés en ti	4	
Mi amor mi único sueño es que tu y yo podamos cumplir todos nuestros sueños que estemos siempre juntos apoyandonos el uno al otro	4	
Parpadeo através , de las profundidades de un sueño El Dios de los sueños ríe elgentemente , mientras juzga la muerte humana El espacio tiempo toma sus cadenas , que se funcionan con el más hayaUn programa de fantasía dado por un Dios	4	
Pero ya x , yo ya tengo sueño , hasta mañana descansa buenas noches bellos sueños hablamos mañana te amo	4	
Que descanses super iper mega recontra bien y duermas muy a gusto como estaría perfecto para ti y que a compañía de eso cuando hayas logrado consolar el sueño tu cabecita se llene de unos sueños tan mas preciosos llenos de amor y tranquilidad y donde las pesadillas malas y feas no vallan a abitar y arruinarlo mi pedacito de cielo lleno de vida y amor	4	
Que felicidad tengo Dios me cumplió el sueño de tener a la nena de mis sueños te esperamos anciosos y no veo la hs de tenerte ya en mis brazos mi bebee	4	
Sueño tu eres mi sueño hay k nadie me levante y entre tus sueños solo kiero abrazarte	4	
Y nunca , pero nunca , por más que caigas no dejes de intentar las veces que te sean necesarias , todo aquello que tenga como fin realizar tus sueños , porque cada sueño logrado y cada meta alcanzada son lo que nos llena de alegría , felicidad y orgullo día a día y por siempre  .	4	
Yo también te extraño y no tienes idea de cuanto , no se pero siempre que estamos así algo malo pasa , hoy tuve un sueño de eso y no se pero mis sueños tienen a convertirse en realidad y yo no quiero que este sueño se haga realidad y te juro que en verdad no quiero perderte	4	
en mis sueños una noche y solo sueño desde entonces para verte cada día juno	4	
poeta vaga solo en el azul del cielo y las hojas secas Lucha contra el sueño que le hace perder los sueños Y algún día llena la Greca Y va solo , buscando magia En un tono , me impregna de nostalgia	4	
Amor tengo sueño ojala estuviera en tus brazos te amo mi amor que tengas lindos sueños tuve una noche hermosa a tu lado	3	
Amor ya me dormiré porque esta asiendo a lo monto de sueño mañana platicamos amor te amonunca lo olvides felices sueños amor	3	
Amor ya me dormiré porque esta asiendo a lo monto de sueño mañana platicamos amor te amonunca lo olvides felices sueños amor descansa no te duermas muy tarde	3	
Amor ya me dormiré porque esta asiendo a lo monto de sueño mañana platicamos amor te amonunca lo olvides felices sueños amor descansa no te duermas muy tarde TE AMO	3	
Awww Mi amor sabes mis sueños mas hermosos son en los que sueño contigo	3	
Awww Mi amor sabes mis sueños mas hermosos son en los que sueño contigo Si mi amor gracias Si mi amor yo te aviso cualquier cosa	3	
Awww Mi amor sabes mis sueños mas hermosos son en los que sueño contigo Si mi amor gracias Si mi amor yo te aviso cualquier cosa Ya veras que pronto te ganare yo	3	
Awww Mi amor sabes mis sueños mas hermosos son en los que sueño contigo Si mi amor gracias Si mi amor yo te aviso cualquier cosa Ya veras que pronto te ganare yo Igual te mando muchisimos beso y abrazos para que puedas dormir y soñar muy bien amor	3	
Buenas noches mi niño hermoso Ten un sueño bonito y calido Nos vemos en nuestros sueños mi niño hermoso	3	
Buenas noches mi niño hermoso Ten un sueño bonito y calido Nos vemos en nuestros sueños mi niño hermoso Te amo	3	
Buenas noches mi niño hermoso Ten un sueño bonito y calido Nos vemos en nuestros sueños mi niño hermoso Te amo TE AMO descansa mi niño hermoso , te amo mi vida , descansa Te amo F&C ohana Nunca , NUNCA déjare de amarte	3	
Buenas noches mi niño hermoso Ten un sueño bonito y calido Nos vemos en nuestros sueños mi niño hermoso Te amo TE AMO descansa mi niño hermoso , te amo mi vida , descansa Te amo F&C ohana Nunca , NUNCA déjare de amarte Nunca , NUNCA te dejare	3	
Bueno , te dejo porque muero de sueño , que descanses y tengas lindos y hermosos sueños , obvio por que seran conmigo , jajaja ntc	3	
Bueno bb te dejo ya me dio sueño hasta mañana dulces sueños linda noche que descanses chao te kiero	3	
Bueno mira esta noche e soñado con una persona , pero mi sueño fue muy raro sabes , y a la vez gracioso jeje pero no es justo xq esa persona a invadido mi sueño e hizo que mis sueños	3	
Bueno mira esta noche e soñado con una persona , pero mi sueño fue muy raro sabes , y a la vez gracioso jeje pero no es justo xq esa persona a invadido mi sueño e hizo que mis sueños fueran solo para esa persona	3	
Bueno mira esta noche eh soñado con una persona , pero mi sueño fue muy raro sabes , y a la vez gracioso pero no es justo por que esa persona ah invadido mi sueños eh hizo que mi sueño fuera solo para esa persona	3	
Es que fue unos de mis sueños convertido en otro sueño que yo quería	3	
#mango,	mangos
, gracias por lo mangos mi abuela hizo marcianos de mango y estan mas feos , me toca hacer ami siempre dejando mal a mi familia en la cocina	1	
A ti te regalan mangos y yo aca muriendo de las ganas x comerme un mango	1	
Calmate que vi unos mangos , baby , se me antojo pero ya no llevaba dinero , mango y piña se me antojo , haber si no va don martín mas tarde al tianguis	1	
Congelado de piñaCongelado de mango 3 tomates 1 lechuga 2 de pan Azucar Una papaya 3 mangos Jamón 10 pepinos	1	
Jajajaj tranquilo que aca mango e slo que ay cuando llegue de viajarvtraje mangos yo ay le guardo jajajaj	1	
Me comí un mango y a mi no me caen los mangos , siempre lo vomito	1	
Muy bien ya esta vamos a bailar con los mangos ay perdón k digo bailar la canvion del mango	1	
O mango en la caja de Avon estan los mangos	1	
Pero sin querer se me cayo el mango de la boca al plato encima de dos mangos	1	
Si voy a gastar 480 mangos x vos y no tengo un mango así q agradece , ok esta bien dejo de ser forro	1	
Soy chico escucho la naturaleza cuando de gamin me subo al palo de mango y riiiiinnnn suenan los mangos	1	
Ya no hay mango pero apenas vea bajo mangos	1	
Yo quiero a mi mango ésta grande y da mangos ricos	1	
aL vecino de los mangos que les de internet a cambio de mango	1	
los mangos de mi vecina tenuenfo planta de mango	1	
omg q mangos a no digo q bonita cancion del mango jajjajaja	1	
#elefante,	elefantes
25El conejo vio a 6 elefantes cuando se dirigía al rio y cada elefante 6 vio 2 monos dirigiéndose al rio con 1 loro	1	
25El conejo vio a 6 elefantes cuando se dirigía al rio y cada elefante 6 vio 2 monos dirigiéndose al rio con 1 loro 2x6 12 12 24 1 25	1	
A sam un montable de elefante le encantan los elefantes weii machin unos ponys , una bebe , la señora cara de papa un piano que queria una vez que lo vio en wallmart	1	
Ahí dice que el conejo vio a los elefantes mientras el conejo de diría al rio Y dice que cada elefante vio a los monos mientras se dirigían al rio	1	
De la peli me gusto en la parye q aparece el elefante por q a mi me e cantan los elefantes y tambien me gusto cuando apenas entraron a jumanji	1	
El conejo 1 , vio 6 elefantes pero no fueron al rio V cada elefante vio 2 mono 2x6 12 y cada mono tenia 1 loro en sus manos 12monos 12loros 1conejo a 25 negro rata de mierda	1	
El elefante es que haci les llamo a mi colección de elefantes jej	1	
Si a las hormigas les da dolor de hormigas , a los elefantes les da dolor de elefante , o dolor de hormiga  ?	1	
Un conejo vio seis elefantes mientras se dirigía al rio , cada elefante vios dos	1	
Un elefante morado se mata con un arma para matar elefantes morados	1	
#mono,	monos
5 , el conejo y los 2 monos con los 2 loros ya que cada mono tiene uno	1	
Ahora todos con fotos de sus monos yo pondré a mi mono tambien	1	
Cuando te lleva a comer y te saca monos y te compra un mono muy grande un hosky hermoso y globos y yo le regale el reloj hermoso y chocolates te amo bejar mi celostino	1	
Keria ponérselos en los monos 3 en cada mono	1	
La cara de cuateee tiene cara de mono pero de esos monos feos con F de foco fundido	1	
Mas un mono , me dan miedo los monos	1	
Mk porque Bart y lisa son monos si March ni homero lo son y no hay nadie en Springfield mono	1	
Monkey King es un mono que invoca un ejercito d monos  ?	1	
Mu mono aunque no se el vea pero po los perros son monos	1	
Osea tu te identificas como un mono osea si tu crees q venimos de los monos dime por q no han revolucionando ya se tardaron para q sean humanos	1	
Por eso es que tengo bellos monos , el cabello castaño mono y rojiso a la luz , y me sale barba mona y cafe  .	1	
Porque el conejo va hacia el ríoY son 6 elefantes Cada elefante vio 2 monosTodos los elefantes vieron a los mismos monos que son solo 2 Y cada mono sostiene un loroSólo son 2 monos así que son solo 2 loros Y contandolos son 5 animales en total	1	
Porque me parece que los seis elefantes ven a los únicos dos monos , mas el conejo , mas los dos loros de cada mono , son cinco en total	1	
Pues vanPpLoisCrisMisaCarlos 1 mono de carlos 2 monos de cris	1	
Que se vayan con sus monos , tiene cara de mono	1	
Son monos cortos algo lindo en largo ose mono largo  .	1	
Son todos unos monos aca una crusa de mono y zorro	1	
Sueña con monos porq vs le enseñaste a ser mono	1	
Wey ese mono es un gremli así se llaman eso monos , paro si puedes si ese precio pide la de mujer y la de ese mono y la de donde dice kin y ken al precio que se pueda sea de 75 o 94	1	
Y si en la esc en el recreo parece un mono xq hace como hacen los monos	1	
ai no hay ningún mono de dorrego del treinta y del dorado los monos  !	1	
un mono x q los monos son bondadosos 8-Dedicame una cancion  .	1	
#águila,	águilas
#mano,	manos
Extraño muchísimo sus besos y sus manos cuando me habrazaban y me tomaban de la mano com fuerza y suamente extraño mucho su ultimo beso y el primero extraño mucho sus labios su mira  .	7	
Pongo en tus manos este martes , por favor bendíceme , tómame de la mano y llévame por sendas de dicha , triunfo y prosperidad , Amén  .	6	
Minna-Posó una de sus manos sobre su mejilla y otra sobre el dorso de su mano  .	5	
Aaa ps la señora me agarraba las manos y me mandava mano ps a	4	
La vida es una carrera de obstaculos , solo debemos ir de la mano de Dios para ser el ganador en tus manos mi rey	4	
Pastina de la ceramica así quedó mi mano le dije que me va a tener que pagar las manos jajaj encima me duele todo no puedo mover nada me siento re inútil porque el llego de trabajar y se puso a ayudarme hasta las 11 nos quedamos limpiando todo	4	
Recargué mi mejilla sobre la orilla del sillón y llevé las manos hacia atrás , todavía percibía el escozor de su mano estampada ahí  .	4	
-Sonreí deteniendome para esperar al menor , pasando las bolsas que llevaba en una de mis manos hasta la otra , así dejándola libre para poder tomar la mano del menor que se encontraba tomando mi manga-Ah , ni yo sé qué es , es una mezcla rara de naturaleza  .	3	
Extraño muchísimo sus besos y sus manos cuando me habrazaban y me tomaban de la mano com fuerza y suamente	3	
Extraño muchísimo sus besos y sus manos cuando me habrazaban y me tomaban de la mano com fuerza y suamente extraño mucho su ultimo beso y el primero	3	
Extraño muchísimo sus besos y sus manos cuando me habrazaban y me tomaban de la mano com fuerza y suamente extraño mucho su ultimo beso y el primero extraño mucho sus labios	3	
Pastina de la ceramica así quedó mi mano le dije que me va a tener que pagar las manos jajaj encima me duele todo no puedo mover nada me siento re inútil porque el llego de trabajar y se puso a ayudarme hasta las 11 nos quedamos limpiando yodow	3	
Y tome tu mano y la cubrí en mis manos y te dije al oído mil veces TE AMO que voy a vivir solo para quererte hay estaré contigo mi amor JxS	3	
por que te digo al oído leticiaaaaaaaaaaaaa por que pongo mi mano en tu cintura por que sientes algo mio por que soy algo rudo y tienes miedo que te lastime por que me ves sin gorra por mis manotas por mis piesotes por que me nalgueas y me dices como me llamo por que tu mano también se resbala por que te abro la chamarra por que pongo mis manos en tus	3	
uiga mire que esta , mano no tiene tendones y no tiene lo que tienen las manos	3	
-Sonreí deteniendome para esperar al menor , pasando las bolsas que llevaba en una de mis manos hasta la otra , así dejándola libre para poder tomar la mano del menor que se encontraba tomando mi manga	2	
-sonríe y baja su mano recargándose en su pecho esta se acomodo un poco y puso sus dos manos en su pecho mientras lo tomaba de la camiseta	2	
-tuvieron que hacerme unos puntos en una de las manos porque por los dientes , me vende la otra mano mientras	2	
19 Aplica su mano al huso , Y sus manos a la rueca  .	2	
30 en derecha y izkierda , sube derecha y izkierda descansar 30 segunfis tu brazo meter x la huacha echarte y subir los dos piernas y viajar uno descansar 30 subir tus manos por tu pirrna echarte y poner tu piernas arriba y tocar con tu mano la pantorrilla descansar poner tu mano al pecho y subir y levantar tu mano y tu pirrna	2	
A mi también me gustaron mucho tus besos Enserio ya sabiendo y eso que esa ves tenia la otra mano ocupada o sino hubiera sido con las dos manos y hubiera sido mucho mejor	2	
Bueno consiste en hacer un edificio de manos ahi se dice un numero sigamos 6 entonces comenzamos a sacar la mano al que le caiga el numero a ese se le pone el reto	2	
Cuando la libertad llega con las manos llenas de sangre , es difícil darle la mano  .	2	
D Gaster eligió ese camino , él se obsesionó tanto con sus experimentos que incluso se sacó dos piezas de las palmas de la mano , cortando el hueso y dejando sus manos vacias todo para crear dos sujetos de prueva a los cuales tortura en su laboratorio privandolos por completo de la vida exterior , ellos no saben ni como es el mundo  .	2	
En tus manos Señor estan aquellos sueños por cumplir pues estoy seguro que de tu mano podre alcanzarlos  .	2	
Gracias Dios xq fue tu mano de Poder las q guiaron las manos de esos medicos  .	2	
Gracias mi hermano vos también cuenta conmigo en todo yo no te daré la espalda siempre estaré ahí para darte una mano no solo una manos las dos	2	
Hola pueden orar X Dani X q sé le incho las manos y le pica mucho las mano	2	
Luego dijo a Tomás Pon aquí tu dedo , y mira mis manos ; y acerca tu mano , y métela en mi costado ; y no seas incrédulo , sino creyente  .	2	
Quien pone todo en las manos de Dios vera la mano de dios en todo  !	2	
Sali y me lave lad manos y me agarralo la mano	2	
Tal vez porque ellas no son tú , ellas no me hacen temblar , ellas no me hacen sentir que tengo el mundo en mis manos cuando siento su mano en la mía , ellas no me provocan nada cuando sonríen , en cambio tú , tú provocas un millón de emociones inexplicables cuando te veo sonreír	2	
Un dia la maestra le dice a pepito pepito si tengo 7 naranjas en una mano y en la otra mano 8 que tengo pepito le dice manos muy gr	2	
Unir las manos , extiendo mi mano suavemente , en ste lugar me enamore de ti , tus manos sn dda eran cálidas , m enseñaste el significado de pq	2	
Y ahora se ponr a chocarme la mano , sonreirme y hacer corazones con las manos	2	
Ya no resistí mas y me agache para ponerla en mi boca y tratar de meterla , era casi imposible pero la punta si pude chuparla y me daba cuenta que mi mano no alcanzaba a rodearla por completo , me esforcé en chuparla mientras mis manos recorrían y tocaban sus huevos que colgaban impresionantes  .	2	
- un pocoSusurraba sonriendo mientras tomaba la mano del mayor y entrelazaba sus manos  .	1	
-Al instante de sentir la mano del menor , entrelacé nuestros dedos , sintiendo su calida temperatura-Lamento mis manos frías , siempre tan sido así  .	1	
-Al instante de sentir la mano del menor pude sentir su cálida temperatura-Lamento mis manos frías , siempre han sido así  .	1	
-Al notar su forma de desviar la mirada , nuevamente volví a tomar su cintura con una de mis manos , atrayendo al menor hasta dejarlo a mi lado , tomando su mano para entrelazar sus dedos con los míos-Siento que si te dejo ir tan distraído , alguien podría robarte  .	1	
-Gruñí muy bajo al sentir las mordidas en mi cuello , llevando de inmediato mis manos hasta la bragueta del menor para abrirla , metiendo sin pensarlo mucho mi mano y comenzar a acariciar el miembro del menor-	1	
-Me separe para asi poner lubricante en mis manos y bajar mi mano a tu trasero-	1	
-Mm Traté de regularizar mi mano respiración mientras levantaba un poco mi rostro con mis manos en el pecho de SeHun y le sonreí	1	
-Paso mis manos por tu espalda y te beso bastante intenso mientras bajo mi mano para acariciar tu pene y lo agarro pasandolo de arriba abajo en mi intimidad- Mmm descuida aprenderemos de nuevo	1	
-con mis dos manos saco su boxer y miro su erección , procedo a tomarlo con una mano y me lo meto en la boca-	1	
-con una mano le quita ambas manos de su boca- porque te tapas así aah	1	
-meto mi mano debajo de su ropa , acariciando su espalda , haciendo que sienta mis manos calientes-	1	
-mira sus manos y sonríe- Amo que me tomes las mano uwu	1	
-no puedo creer que se esté resistiendo , ya no podía esperar , así que con la mano que me quedaba libre me quite la camisa para después atar con ella sus manos y empecé a acariar todo su cuerpo , mientras desplacé una mano hacia su miembro y empecé a masajearlo-No podrás conmigo , vas a arrepentirte de hacer enojar a tu amo	1	
-retiro mis manos de la cara viendote , tomo tu mano besando tu frente a la ves que intento bajar tus piensa para sentarte y ayudarte con la ropa-	1	
#botella,	botellas
8 botellas don julio blanco 1 botella don julio reposado 4 botellas don julio 70 66 botellas maestro tequilero blanco 1 botella maestro tequilero añejo 9 botellas maestro tequilero dobel diamante 2 botellas herradura antiguo 24 botellas 7 leguas blanco 2 botellas 7 leguas reposado 3 botellas black and white 7 botellas etiqueta roja 6 botellas etiqueta negra 3 botellas buchanans 122 botellas jack daniels 1 botella old par silver	2	
Confirmado el 14 de abril absolut les habré las puertas a este nuevo evento Habrá 10 botellas de absolut que se darán Para poder ser el afortunado en llevarte una botella habrá diferentes dinámicas esas se darán a conocer poco a poco en la página evento estará al obviamente en metepec como debe ser Esperó su asistencia y compartan el evento para ser mas en este desmadre , No TeLoPuedesPerder	2	
000 la botella por 150 ml es un licor italiano cuantas botellas  ?	1	
1 Pack casa real rojo 1 café coñak normal 2 botellas tequila José cuervo 1 botella estolisnaya	1	
1 Pack casa real rojo 1 café coñak normal 2 botellas tequila José cuervo 1 botella estolisnaya 1 pack kolber tinto 1 Pack kolber blanco 1 pack campos de solana 1 caja cuba lata	1	
2 botellas yo sola casi me acabe 1 botella	1	
A poz me compraron 2 botellas pero sólo usé la mitad de 1 Y la otra mitad y la botella completa , me las tomé el 31	1	
Confirmado el 14 de abril absolut les habré las puertas a este nuevo evento Habrá 10 botellas de absolut que se darán Para poder ser el afortunado en llevarte una botella habrá diferentes dinámicas esas se darán a conocer poco a poco en la página evento estará al obviamente en metepec como debe ser Esperó su asistencia y compartan el evento para ser mas en este desmadre	1	
Cuando mira la botella se da cuenta que esta siendo explotada y que vendian las botellas del agua que ella daba y por la protesta del pueblo hace que halla una inundacion y puede salir	1	
Cuando tomes agua llena la botella , no hagas el amontonamiento de botellas porque después no tenés agua	1	
Entonces cuando empeso yo me quede viendo cerquitica y los q estaban al lado mio cogieron unas botellas y yo no me di cuenta cuando el otro cogió botella cuando veo es que la va a tirar y yo estaba detras del que iban a cascar y el se quito y yo iba a salir corriendo y la botella me dio fue a mi en el pie	1	
Esque vi que uno presumía mucho papi y a los demás no les gusto y que lo golpean papi pero llevaban botellas y a mi tia que le toca un golpe con una botella papi	1	
Eu juan tu mama juega al juego de dejar la botella parada pero no usa botellas usa su boca y una porongaa	1	
Fuimos a mi departamento por unas botellas por que era de cada quien pone una botella o un six	1	
Había muñecas hechas con botellas y los vestidos estaban tejidos sobre la botella	1	
Hola , Yaris te encargo la bolsita de Mimi la de sandía y el collar , pirfis y el viernes te paso a dejar con tu mamá lo de las botellas y que si me dejas la botella negra , que ya te había dicho , y también te dejo pagada la bolsita de mimi , y lo demas asta el día 10 que ya me pagan pirfis , gracias y asta nañana	1	
La venden en PriceSmart y la venden por caja sale a 20 cada botella y la caja trae 6 botellas	1	
Me tome 3 botellas de tekila y una botella de gran	1	
Mejor lleva una botella oye quien llevara las botellas  ?	1	
Mm estoy acostumbrado a beber alcohol siempre que me siento solo o mal vengo aquí a beber al final acabo bebiendo como 8 botellas acabo muy ebrio pero bueno-reí mientras terminaba la cuarta botella	1	
Mmm vendí dos botellas de tequila y una botella de ron	1	
No pues amor pero la botella de tampoco esta a 11 creo por eso puse como de 4 botellas	1	
No te imaginas se me pincharon dos botellas de coca de 3 litros y una botella de cervesa y para completar casi me hagarro a las piñas con unos drogaos de mierda	1	
Nosotros cervezas 2 botellas de hornitos 1 botella de jack daniels	1	
Osea yo tengo las botellas seria mas bn en mi caso xq yo no tomo botella	1	
Oye , que le hables a pedro serna y que si anda aquí que le traega a mi mamá 2 litros , 1ltr en botella de coca que sea de coca y no en otra y 2 botellas de 1 / 2  .	1	
Oye ami abuelo le di una botella que estaba fregamdo como ves si se ara con las 14 botellas	1	
Perdoname q te moleste , pero mi nene dejo las botellas de agua en el auto , hay posibilidade de q le den una botella de agua y les mando la plata	1	
Por que tu sabes que si vienen estos pelaos Cule viaje por que no quieren poner para la botella entonces las compramos solamente las botellas nosotros dos y yate	1	
Pos siii ya habian comprado dos botellas d black y ahorita jalo otra botella de wisky	1	
Primero comentarles que el sábado 20 de enero estará en el boliche 18 kilates la entrada será de 60 bs y la reserva de loungue o mesa será con prepago de tragos Para un loungue 2 botellas Para mesa 1 botella	1	
Se alarmsron esa 6 botellas q están en la caja en bodega 330 cada botella	1	
Si , hoy un compa se llevo 2 botellas de Sprite , y a cada botella le ponemos un paquete de Halls	1	
Si ni con una botella amaneces sin calzon que sera con dos botellas pediras reconstrucción de los hechos	1	
Si tienes una botella de 3 litros traela , le encargaron a tus hinos dos botellas para mañana	1	
Sii sacó y estara aquí pero siempre toma un vasito o una botella ya hasta pusimos las botellas a enfriar	1	
Sí pero ahora la doctora me dijo que tenía que haber perdido las botellas ahí en el laboratorio ahora me dice por teléfono y yo compré botella agua mineral en esa foto en mi pipi	1	
Te decía que tengo 10 botellas de sidra del valle la argentina y que esta costando 20 Bs por botella	1	
Te guarde una botella de tomate que estaba entre las botellas en el  .	1	
Te platico , mi hija Montse se casa el 17 de ferbrero , su prometido es de Aranda de Duero España y van a venir muchos amigos de ellos y de el de allá de España y quieren poner en cada mesa varias botellas entre ellas tequila y vi la botella que presentaste y me gusto para ponerles algo referente a su boda	1	
Tengo dos botellas de ron venezolano y hace poco tome con unos amigos media botella	1	
Tenés que ser compinche con el chino , no sabes nada jajajaja , con mama siempre íbamos a hacer las compras y nos daban una botella de vino de regalo , colección de botellas tenemos	1	
Trabaje em la rioja y hay vivía sintiendo el vino en la finca y aveses limpiavamos las botella y una ves se callo un paquete de botellas lena de vino vinos y nosotros la tuvimos que juntar el vino todo el piso avía yo miraba y decía como llorarían si ven esto los borrachos como vs jajaja ni la conocía	1	
Voy a ser el mejor chef ya m vi a si aver si mañana voy a ver lo de las botellas hay le pregintas a jessi q d cual botella quiere en espesifico para ir a buscala	1	
Wow-le quite la botella- no hagas eso , si te tomas asi todas y cada una de las botellas vas a morir-sonreí tiernamente y agarre la cuarta botella	1	
X eso t digo mientra le digo a mi ma q m traiga una botella de agua y cuando vengas t llevas las botellas y las llenas ahi amor	1	
Y deperdido son dos o tres botellas de sprite para una sola botella	1	
Y en donde las botellas asi va a decir botella de 750	1	
Ya espera esq le gusta jugar con botellas y para que me haga caso estoy yendo a traer una botella	1	
agarrate desde ahorita , enpieza a abentarle besos a una botella o has de cuenta que la botellas soy yo y hechamelos a mi	1	
#mujer,	mujeres
Feliz dia de la mujer A una de las mujeres mas importantes de mi vida Sis que mi Diosito te lleene de muchas bendiciones y exitos mi negris  .	37	
Yo quiero exactamente lo mismo , demostrarte lo mucho que te quiero , lo mucho que me encantas , seria hermoso una carta tuya , no soy de esos que les gustan verles las partes a la mujeres , pienso que la mejor curva de una mujer es su hermosa sonrisa  .	34	
Quiero tener una mujer que utralizado pero cuando uno tiene plata hay las tiene uno a las mujeres pero cuando no tienen uno plata hay si ya no están son interesdhay y que esa mayo que tenga mi edda 23 o 25 o 29 a que nose menor de edad ni mi	19	
Estas son las mañanitas que cantaba el rey David a las mujeres bonitas se las cantamos así despierta mujer despierta mira que ya amaneció ya los pajaritos cantan	8	
Si lo deseas también puedes echarle un vistazo a estas frases de cumpleaños para mujeres , ya que son versátiles y valen para cualquier mujer , ya sea amiga , hermana , esposa , mamá , tía , sobrina , etc Qué mensajes hay en este artículo  ?	8	
Para todas las mujeres que mr rodean , Feliz día de la mujer  .	7	
Y juegan con los sentimientos de la mujeres Y los verdaderos hombres son los que luchan por esa mujer que de verdad quieren hacer feliz y la aceptan como ellas son  .	7	
estas son las mañanitas que cantaba el rey David a las mujeres bonitas y hoy te las cantamos a ti despierta mujer despierta mira que ya amaneció ya los pajaritos cantan la luna ya se metió  .	7	
Pues tu kien eres para andar ofendiendo alas mujeres recuerda k de una mujer naciste culero y ati no tw gustaría k le faltaran el respeto a tu pa	6	
Suerte tenés que sos una mujer , y yo a las mujeres NO le pego , pero te juro que te volaría la cabeza , POR PUTA , QUILOMBERA Y EMBROLLERA COSAS Y TU AMIGA  .	6	
Suerte tenés que sos una mujer , y yo a las mujeres no le pego , pero te juro que te volaría la cabeza , POR PUTA , QUILOMBERA Y EMBROLLERA COSAS Y TU AMIGA  .	6	
debes de conocer a otras mujeres , espero que encuentres aquella mujer que te de todo lo que tu buscas , yo no cumplo con tus espectativas  .	6	
Antes no se permitía a la mujer alistarse , hay mujeres y hombres acosadores  .	5	
Entre mujeres no se debería de hacer estas cosas Pena ajena mujer	5	
Esta es la cadena del dia de la mujer pon tu nombre en la cadena y juntas construllamos la cadena solo de mujeres Cande Julii Luci Martii Zairuchis Mia Emii Mily Pri cii	5	
Mensajes de cumpleaños para una amigaSi lo deseas también puedes echarle un vistazo a estas frases de cumpleaños para mujeres , ya que son versátiles y valen para cualquier mujer , ya sea amiga , hermana , esposa , mamá , tía , sobrina , etc Qué mensajes hay en este artículo  ?	5	
Mi reina le doy gracias a Dios ala vida por haber puesto en mi vida a una mujer hermosa luchadora una mujer la cual es de cuidar de respetar por q mujeres como tu mi amor no hay si no una y eres tu  .	5	
Un verdadero hombre no es aquel que enamora a mil mujeres sino aquel que es capaz de enamorar mil veces a la misma mujer  .	5	
De todo corazón para esas mujeres hermozas les deseo un super dia , feliz día de la mujer	4	
Feliz dia de la mujer , a esas mujeres luchonas 4x4	4	
Feliz dia de la mujer A una de las mujeres mas importantes de mi vida	4	
Feliz dia de la mujer A una de las mujeres mas importantes de mi vida Sis	4	
Feliz día de mujer A todas las mujeres del mundo	4	
Las mujeres van y vienen , pero la vida no te premia con una buena mujer 2 veces  .	4	
María se ha beneficiado de la gracia más extraordinaria que nunca ninguna otra mujer ha recibido y recibirá ha sido elegida por Dios , entre todas las mujeres de la historia , para ser la Madre de aquel Mesías Redentor que la Humanidad estaba esperando desde hacía siglos  .	4	
No por ser mujeres tenemos razon en todo no por ser mujeres podemos hacer y pedir lo que quieramos no por ser mujeres somos débiles y no por ser mujer voy a estar deacuerdo con esta matanza  .	4	
No soy tu novio pero lo hice con mucho cariñoo Te amoo Y te respeto eres una gran mujer mi vda la mejor de todas mi favorita ojala huvieran mas mujeres como Te amooo  .	4	
Para las mujeres mas importante de mi vida Mi Madre una mujer que siempre me cuido te amo , mis hermanas que nos divertíamos a nuestro modo , Mi Suegra que me ama como una madre , GRACIAS A TODAS ESTAS MUJERES Y QUE DIOS PUSO EN MI VIDA  .	4	
Por que hoy y siempre reconozcamos lo importante que son las mujeres , feliz día mujer  !	4	
Que sea desanimado y frío con otras personas , que se desanime y sea frío con todas las otras mujeres , que cualquier otra mujer que este con nombre de nuestro amante se estrese y se desencante de el , y quiero que se peleen , y que el salga inmediatamente de la vida de ella , y le tome enojo , odio , aversión , rabia y rencor  .	4	
Yo tengo varias fantasías como hacer un trio ya sea con dos mujeres pero primero quiero hacelor yo una mujer y otro hombre también quiero	4	
Amorsito feliz dia de la mujer , sabes que haces mi vida mejor y mujeres como tu tan maravillosas e increibles ya no hay en este mundo , agradezco a dios por tu vida y por haberte puesto en mi camino	3	
Aunque parezcan frases hechas , el día internacional de la mujer reivindica y reconoce los derechos de las mujeres trabajadoras , a partir de un hecho trágico que costó la vida de casi un centenar y medio de obreras textiles , un 8 de marzo a principios del siglo pasado  .	3	
Buen día bueno hoy es un día especial ya que es el día de la mujer quiero desearles a todas las mujeres que en su día la pasen lindo y no los olvides	3	
Buenos dias amor de mi vida , amor de mi corazón no soy muy dado a estas fechas , a la verdad no le pongo mucho cuidado , siempre he pensado que todos los dias son especiales para las mujeres , y tu no eres cualquier mujer , eres mi idóneo mi mujer virtuosa	3	
Como mujer te digo no me gusta pelear y menos con otras mujeres  .	3	
Danna Sarmiento y Yojanna Arias Bejarano Mirenlas Jajjajajaj estas dos mujeres que dicen ser damas enviando este tipo de fotos a un hombre con mujer Jajajaja por di	3	
De que te sirve llegar a la intimidad con varias mujeres si a la hora de dormir estás sólo , de que te sirve tener varias de ellas y subirlas a tu auto , si cuando el mismo ya no funcione no vas a tener quien camine a tu lado , un verdadero hombre no necesita muchas mujeres , sino una que lo complemente día con día , si tienes una mujer así a tu lado , entonces dale VALOR , sabes porqué  ?	3	
En el caso que se refiere a cuantas mujeres hay serian 1 sola mujer , la otra es una nena  .	3	
Esta es la cadena del dia de la mujer pon tu nombre en la cadena y juntas construllamos la cadena solo de mujeres Cande Julii Luci Martii Zairuchis Mia Emii Mily Pri cii Brii	3	
Estas son las mañanitas que cantaba el rey David a las mujeres bonitas se las cantamos así despierta mujer despierta mira que ya amaneció	3	
Estas son las mañanitas que cantaba el rey David a las mujeres bonitas se las cantamos así despierta mujer despierta mira que ya amaneció ya los pajaritos cantan y la luna ya se escondió Feliz Cumpleaños Mami querida te quiero mucho gracias por todos esos momento , por enseñarme tantas cosas en esta vida por darme alegrías de verte cada día gracias	3	
Feliz día d la mujer fabysita fridita y mami somos mujeres y siempre sobresalimos siempre soñadoras y exitosas fuertes y tenaces un ejemplo cm ustedes me hace querer ser mas y mas cada día gracias x todo y hoy a pasarla bonito ni la lluvia opacara este día y nos consentiremos hiendo d compras jiji  .	3	
Feliz día de la mujer a todas las mujeres	3	
Feliz día de la mujer para todas las mujeres del mundo , en especial a ella que me acompaña en todo por mas que siempre aya diferencias o discusiones como toda pareja te agradezco por estar ahí siempre y por darme lo mas hermoso de la vida nuestro pequeño  !	3	
Feliz día de la mujer para todas las mujeres del mundo , en especial a ella que me dio lo mas hermoso de la vida nuestro pequeño	3	
Feliz día para todas las mujeres Especialmente tu madrecita linda Que eres sin duda alguna la mujer mas luchadora Te Amo Blanca rosa	3	
HOLA Feliz día de la mujer hoy celebramos nuestro día especial para nosotras las mujeres	3	
No soy tu novio pero lo hice con mucho cariñoo Te amoo Y te respeto eres una gran mujer mi vda la mejor de todas mi favorita ojala huvieran mas mujeres como	3	
Para mis hermosas divinas y preciosas mujeres de este grupo le deseo un maravilloso feliz día de la mujer y que Dios me	3	
#melòn,	melònes
#nube,	nubes
Tengo tu rostro frente a mi y intento darte un beso pero tu rostro se desvanece como las nubes en el cielo pero aunque el cielo este despejado siempre habra una nube a si mismo me pasa a mi aunque estemos lejos yo no dejo de pensar en ti Te amo Con todo el corazón y toda mi alma y no descansare hasta tenerte junto a mi x 100 pre  .	2	
Buenas tardes hoy se encuentra nublado muchas nubes pocos grados mucha nube montaña	1	
Es una nube que se formó más arriba de las nubes normales	1	
Esas zapatillas estaban por las nubes por eso No la nube	1	
Vas a llegar a las nubes no vas a querer bajar de esa nube	1	
hay cual nube hoy no habían nubes grises	1	
#leòn,	leones
#ratòn,	ratones
#cerdo,	cerdos
00150 súper pollito extra distribuidor-1 bulto 00152 super engorde extra distribuidor quebrantado-7 bultos 0001 super pollito extra-1bulto1920 cerdos nueva raza iniciación-1 bultos 1940 cerdos nueva levante-4 bultos 2000 cerdos nueva raza engorde-2 bultos 0810 super cerdas ceba-2 bultos 0560 cerdo engorde campesino-30840 super cerdas-2 bultos 0426 supercat deli carne 8kg-1 bulto 0418 supercat deli pescado 8kg-1 bulto 221515 supercan deli adultos 1  .	9	
00150 súper pollito extra distribuidor-1 bulto 00152 super engorde extra distribuidor quebrantado-7 bultos 0001 super pollito extra-1bulto1920 cerdos nueva raza iniciación-1 bultos 1940 cerdos nueva levante-4 bultos 2000 cerdos nueva raza engorde-2 bultos 0810 super cerdas ceba-2 bultos 0560 cerdo engorde campesino-30840 super cerdas-2 bultos 0418	3	
Metro cuadrado por cerdo para manejar 20 cerdos en un solo corral	1	
Por que no al polo que esta cerdo o a tros que están cerdos y no se cuidan	1	
Que los cerdos valen 100 o por ahí y te coy a comprar un cerdo tmb	1	
#asno/burro,	asnos/burros
#máquina,	máquinas
Burnas ing acabó de hablar con el ingeniero Gustavo Y Me confirmó para mañana Tonces quería ssber si la hora si va desee las 2 de la tarde ya estoy haciendo prueba de conexión con otras máquinas por si es la mía para ver si uso otra máquina para enviarle El correo al ingeniero confirmando la hora Nada más	1	
Inventó una serie de máquinas , como la máquina diferencial , diseñadas para solucionar problemas matemáticos complejos  .	1	
Las máquinas 5105 , distribuidores Clientes 6200Pero la máquina ya dura para siempre  .	1	
Tengo también ya negociadasunas máquinas , Por que igual que hago con tanta máquina Ahí invertida plata quieta	1	
Y como te digo q tengo todas las máquinas trabajando no puedo estar checa y checa una máquina amor	1	
#camino,	caminos
A veces la vida nos ofrecen caminos diferentes y nosotros somos responsable del camino q elijamos q @a	5	
Pero por sobre todas las cosas valoro la libertad que tiene cada uno de elegir su camino , no juzgo los caminos ajenos , cada uno sabe que lo hace feliz y que no , pero exijo el mismo respeto , si soy rebelde  .	5	
He visto a Dios arrancar del camino los espigos que me atrasaban y abrir caminos nuevos para mi  !	3	
Te amo como no tienes idea , te amo muchisisisimo , me encantas mucho , me encanta tenerte conmigo a mi lado , todo esto es un sueño echo realidad , siempre soñé con tener a alguien como tu , que me amaras de la misma manera que yo te amo , amarnos de verdad y que todo esto fuera muy sincero , le doy gracias a Dios por haberte puesto en mi camino , por haber juntado nuestros caminos	3	
A veces la vida nos ofrecen caminos diferentes y nosotros somos responsable del camino q elijamos , pero siempre cuando caigamos siempre hay q levantarnos xq de cada caída aprendemos y es un reto luchar contra la vida	2	
Cuando hayas de elegir entre varios caminos , elige siempre el camino del corazón  .	2	
El tiempo nos asalta con olas ascendentesRespondo a las voces ahogadas que merodean los caminos en la nocheNunca me olvidaré de tiTodavía estoy solo en este camino desolado y brutalCon la elegancia de un ave herida voy a soportar la lluviaBañados en la sangre de la Tierra , dormimosOh , estrellas , narran lo acontecido esta nocheNunca te olvidaréSimplemente existo solo en esta noche congeladainagotables voces , revivan ahora con su poder absoluto	2	
Hay veces que el camino principal esta bloqueado , asi que para seguir el recorrido podemos buscar mas caminos y quizas al hacerlo encontremos mejores rutas para llegar a nuestro destino	2	
Pastora Muchísimas felicidades que se la pase de lo mejor hoy y siempre en compañía de todos la que la queremos , usted es una persona muy especial para mi , ya que ha estado con migo en las buenas y en las malas muchas gracias por cuidarme , consentirme , quererme , y por guiarme en los caminos de Dios , le agradezco a Dios por ponerla en mi camino La amooooooooo	2	
Podemos elegir muchos caminos , pero el camino del corazón , siempre cuidara de nosotros y de nuestros seres amados  .	2	
Si tenés que elegir entre dos caminos , o dos maneras de hacer una cosa , elegí siempre el camino del AMOR Elegí perdonar , abrazar , comprender , esperar , bendecir , guardar silencio , buscar la paz  .	2	
Yo se que estas ahí conmigo guiandome en este camino y se también que haz abierto también nuevos caminos en mi vida profesional  .	2	
tenía dos caminos que elegir y gracias a vos elegí el buen camino  .	2	
15 Sus pies se apresuan para derramar sangre ; 16 Quebranto y desventura hay en sus caminos ; 17 Y no conocieron camino de paz  .	1	
A cada final del camino encontré solo mas espinas que en el comienzo y de tantas espinas y caminos recorridos las espinas lastimaron mi piel frágil como mi corazón se que si lo deseara podría volver por mis propios pasos siguiendo el rastro de sangre que al caminar por las espinas he dejado  .	1	
Aaun esta muy lejos para mi me ago dos oras de camino para llegar a cuatro caminos estan muy bonitos rapidos los venderas mmmm malo para mi	1	
Aca estoy ya salí de mi retiro las invito a Q se unan a éstos retiros ustedes dos mujeres pecadoras Q estan en el camino de la perdición a Q por favor enderescan sus caminos Q anden por la senda del amor la amistad y no por esos caminos pecaminosos cordialmente invitadas te esperamos	1	
Agradezco a dios por cruzar nuestro caminos y que sigamos juntos , aunque cada quien vaya por su camino pero siempre en algún punto nos juntamos para poder platicar un rato	1	
Ahora sólo el que sea magia lo podrá comprender en su totalidad , y el que no lo ha logrado aún , tiene dos caminos muy marcados para seguir El primero camino es el de la perseverancia y para eso hay que tener la voluntad suficiente , para no bajar los brazos hasta que se manifieste la magia en su vida  .	1	
Antes de hablar prepara el camino invoca al Espíritu Santo q Abre los caminos	1	
Ay si bebé , me encanto haberte conocido y le doy gracias a Dios por haberte puesto en mi camino , por haber juntado nuestros caminos	1	
Bueno mi papa dise que los gompes de la vida solo te dan dos caminos o ser mas fuerte o mas devil tu decides que camino tomar	1	
Bueno x ahi hay un camino q te lleva , tenes q entrar x esos caminos del ingenio	1	
Creo que si siguen aferrandose al pasado Mejor es que cada uno siga su camino Y si algún día sus caminos se vuelven a juntar ps tan sólo caminen mirando hacia adelante y no intenten algo Ya que siempre se haran recordar su pasado y no funcionara nada	1	
Cristhiam 91 camino 1Vikingo camino camino 2Ra úl camino 3Cuajarot camino 4Mario camino 5Irvin camino 6Gian camino 7Feryf camino 8Lord y mrs pool acompleten caminos Hay casi nada de contricantes	1	
Cuando una es todo terreno los camino , lo que le sobran son caminos	1	
Dios hace perfecto los caminos , y vos estas en mi camino  !	1	
Dios te puso en mi camino y si dios quiere recorreremos los caminos juntoporq eres Del camino	1	
El tiempo nos asalta con olas ascendentesRespondo a las voces ahogadas que merodean los caminos en la nocheNunca me olvidaré de tiTodavía estoy solo en este camino desolado y brutalCon la elegancia de un ave herida voy a soportar la lluviaBañados en la sangre de la Tierra , dormimosOh , estrellas , narran lo acontecido esta nocheNunca te olvidaréSimplemente existo solo en esta noche congeladaOh , inagotables voces , revivan ahora con su poder absoluto	1	
Empezamos un camino juntos dificil con obstaculos , por cosas de la vida seguimos caminos distintos pero hoy estamos en la meta llegamos  !	1	
En esos caminos encontraremos alegrías , tristeza y dolor pero al final del camino encontramos el amor , ese amor que quiza no lo habias sebtido , y x el cual lucharas contra todos x conseguirlo  .	1	
En la vida , tienes a elejir 2 tipo de caminos 1-Un Camino rodeado de flores , animalitos , un arcoíris , etcPero ese camino te lleva a un avismo en el cual te hace caer hacia una muerte segura llena de sufrimiento	1	
En la vida , tienes a elejir 2 tipo de caminos 1-Un Camino rodeado de flores , animalitos , un arcoíris , etcPero ese camino te lleva a un avismo en el cual te hace caer hacia una muerte segura llena de sufrimiento 2-Un Camino lleno de espinas , un lugar oscuro , demasiado peligroso pero al final te encuentras con el paraíso	1	
En la vida , tienes a elejir 2 tipo de caminos 1-Un Camino rodeado de flores , animalitos , un arcoíris , etcPero ese camino te lleva a un avismo en el cual te hace caer hacia una muerte segura llena de sufrimiento 2-Un Camino lleno de espinas , un lugar oscuro , demasiado peligroso pero al final te encuentras con el paraíso Dime Que camino tienes pensado tomar  ?	1	
En mi cado no supe que camino tomar porque ambos caminos parecian ser buenos mas solo uno era el mejor  .	1	
Es hora de que nuestros caminos se separen y sigan su camino original hacia una muerte segura jajajjqjq	1	
Es muy interesante a mi parecer , me gusta mucho el del tiempo , ya que me gusta pensar que en la vida siempre hay varios caminos y que con las decisiones que una persona toma , vas eligiendo cada camino , y con cada decisión/acción o palabra , por más pequeña que sea , es dónde se abre otro camino , ya que al alterar algo de eso , una pequeña cosa puede causar grandes cosas  .	1	
Es una carretera y camino a la carretera hay un camino de tierra y para al fondo hay mas caminos por uno de esos esta la cabaña	1	
Felicidades a mi prima bella q Dios me la lleve y me la cuide por el camino q se dirija y q ilumine todos los caminos donde ella valla porq de parte mia puedo y hago q mis angeles cuando yo este en mi casa me la acompañen y me la cuide mucho  .	1	
Feliz año mae , y otro año mas juntas , mil gracias x todo x guiarme en el camino espiritual y terrenal Q el pae barra nos abra los caminos , y siempre juntas ala par , alupooo pae bara	1	
Feliz navidad y noche buena , que el señor tenga el mejor regalo en el camino de tu vida y que se abran todos los caminos de la mano de Dios  .	1	
Fiuu estas muy retirado de mi yo estoy en cuatro caminos podría en pantiones ya k de camino me ago 2horas	1	
Fue lo que fue y así terminamos , gracias x tu tiempo en mi camino hoy nos toca seguir caminos Diferentes y como  .	1	
Gracias mi mar por acompañarnos en esta meta , una meta dura pero no imposible , miles de gracias por tu amistad , te quiero mucho que sea un camino de grandes logros y felicidad , se que los caminos seran	1	
Gracias mi mar por acompañarnos en esta meta , una meta dura pero no imposible , miles de gracias por tu amistad , te quiero mucho que sea un camino de grandes logros y felicidad , se que los caminos serán diferentes pero espero que esta amistad sea cada vez mas grande  .	1	
Hay caminos que a el hombre le parecen derecho pero su fin es camino de muerte	1	
Igual yo créame que esa carta que le di nunca fue con la intención de despedirme simplemente tomamos caminos diferentes y en ese camino hicimos vidas diferentes yo conozco tu situación y no pienso decir nada simplemente espero que nunca te olvides de mi y sepas que este donde este te llevaré en lo más profundo de mi corazón	1	
Mi dios es el único que nos puede sacar de los malos caminos y guiarnos X un buen camino	1	
Mi vida te convertiste en mi adicción completamente , no puedo estar sin ti , eres demasiado importante para mí , si a ti te pasa algo yo me muero , por eso quiero estar siempre junto a ti , para cuidarte y alejarte de los malos caminos , quiero que me tomes de la mano y recorramos juntos este camino de vida , te juro que saldremos adelante pase lo que pase , eres mi vida entera y nunca te voy a fallar	1	
Mmm , siempre hay un momento en el que el camino se bifurca , cada uno toma una dirección pensando que al final los caminos se volveran a unir  .	1	
#rata,	ratas
A eso es que vienen , a robar , mira aquí esta tu compatriota , una miserable rata , y como este han cojido a varios venezolanos robando y robando , ratas  .	1	
Amor pues casi siempre es con ratas negras y q los ojos son rojos pero la rata es mas grande que yo	1	
Amor tengo una ijuemadre rata que molesta debajo de mi cama sera que ese mata ratas si la estermina	1	
Ay estan ratas y mas ratas abusivos eso de que son unos pocos es mentira todas esas son unas ratas de las mismas que ay en el comgreso y aya con la rata mayor llamado presidente sigan botando por esos ratas y ay para donde va colombia a seguir comiendo mierda	1	
Ay tienen a su honorable presidente la rata mas rata de todas junto a su compinche santos tome vaya voten nuevamente por estas ratas	1	
Conchudo , burro deberían sacarte mas bien a ti , una rata menos , mucho nido de ratas en el congreso	1	
El que mató a mi hijo es una rata grande , qué debe estar rodeados de ratitas , ratas HDP  .	1	
El rata eres tu , te emputaste por fifa y eso es d ratas , yo no me empute por halo pinche rata puta	1	
Es que el problema no es Timochenkoo esa maldita rata esta aniquilada , son las otras dos ratas de Petro y Fajardo , lobos disfrazados de ovejas , ademas que tienen engañados a unos incautos aue creen en ellos	1	
Eso esta muy bien , la razón por la cual todo caco que sale de la carcel quiere volver de nuevo allí , pues tienen el bongo al día y cuando le bajan el bongo los derechos humanos , ongs y todo amigo de las ratas salen en defensa , es por ello tanta rata por todo lado y estan en evolución	1	
Esq dice que parece rata y no me gusta para nd las ratas	1	
Jaja le decís ratas y vos sos mas rata que ello	1	
Jajajaja naaaa fue gracioso muyyy el tema es que en esta casa al lado hay un descampado y se cruzan muchas ratas , y hoy una rata bebe apareció en la puerta de mi patio y justo la vi	1	
Jajajajaja alucina que me dijeron que un tiempo creían que Martínez era cabro porque tanto trabajar con ratas pensaban que le gustaba la rata jajajaja	1	
Juegos ratas que juego y no son rata solo le dicen hasi hasiendo que se inutil todo esto ya que importa clash royale , clash of clans , maicra	1	
La rata ni siquiera les apunta con el arma , y por eso existen mas ratas que les hace falta unos buenos masajes	1	
Los triple hptas esos son re ratas y a toda rata le va mal en la vida	1	
Los verdaderos niños ratas son lo que insultan a otras personas insultandolas y diciéndoles niño rata y demas insultos sólo por jugar un juegon que no a todos les puede gustar pero a otros si Los niños ratas se enfadan mucho cuando pierden y se creen súper pros entonces no solo viendo la publicación no se lo puede llamar niño rata	1	
Otro niño rata por favor dios mata a esos ratas	1	
Para todas las putas ratas , a la rata caída caerle y con	1	
Parce rata con los q son ratas	1	
Ps si esta bonitos pero parece rata y no me gustan las ratas	1	
Ps ya hasta le abra cobrado a esa rata , bueno a esas ratas	1	
Pues me gusta ir al cine al Parke me encanta la música de banda y de reggeton me hace reír todo soy muy risueña y pues llorar solo q me lastimen o ver a una rata me dan pavor las ratas y ratones mi color favorito es el azul turquesa y mi pasa tiempo es ver caricaturas jaja o ver videos de música	1	
Pues sabes que yo soy asi cuando son ratas conmigo yo me vuelvo una rata con la gente	1	
Siempre cuando pasa algo así llega el típico wey que se siente la super verga y superior porque le pasa a alguien mas , seguramente es lo que dijo Antonio Kaym Nuñez , eres rata y andas defendiendo ratas	1	
Son unas ratas señor son unas ratas ni ala probrese le tienen conpacion Jajajaja uribe rata hpta pero presidente	1	
Tomamos leche de vaca porqur es el animal que mas lechr genera , pero quédate tranquilo que si las ratas harian mas leche , tomariamos leche de rata	1	
Un tiro en la frente a cada uno x rata mangas de hdp q son encima los encierran y cuanto duran adentro nada ratas inmundas	1	
Una rata acusando a dos ratas	1	
Una rata mas una rata menos , que mas da si esa casa esta llena con ratas que caminan a dos patas  .	1	
Veo una rata , a mi no mr gustan las ratas	1	
Y ustedes me dijeron rata cuando ni ago nada de ratas	1	
Y yo una Pinshi rata gigante , tres ratas pequeñas y un Pinshi titán v	1	
Yo fuera ud antes de haberme metido en medio de tanta rata hubiera conocido todo lo malo de esas ratas de alcantarilla	1	
allá los burros son presidentes , y responde la rata yo me quedo en Colombia aqui las ratas son Senadores	1	
en el verano pasado estaba muy rata el chabon , ósea jugaba al batllefield 4 con Chilenos ratas	1	
son unas ratas chango pero el gordo del frente es mas rata	1	
veneno para rata o los triangulitos porque vinos ratas grandes estos dias	1	
voy donde esta la rata no se por que a la gente les da miedo las ratas	1	
#cebolla,	cebollas
-algunas cebollas coloradas para los que nos gusta con cebolla	1	
2 cebollas , 1pepino , 1 aguacate y si vas hacer tu la cebolla	1	
2 cebollas 1k papa 1 cebolla verdeo 1 zanahoria 1morron	1	
2 cebollas cabezonas , 1 lb cebolla larga , 1kg tomate rojo , 1 pimentón , 1 lb papa negra pastusa y amarilla pequeña , 1 / 2 habichuela , un pedacito de ahuyama , cilantro , 1 lb frijol de cáscara , 2 mazorcas  .	1	
2 cebollas cabezonas , 1 lb cebolla larga , 1kg tomate rojo , 1 pimentón , 1 lb papa negra y amarilla , 1 / 2 habichuela , un pedacito de ahuyama , cilantro , frijol de cascara	1	
3 calabazas , 13 tomates , 3 chayotes , 2 pepinos , 2 cebollas , una ramita de apio , una cebolla morada y 2 pimientos verdes	1	
Añadir la cebolla y el pimientón rojo y saltee hasta que las cebollas estén transparentes , unos 3 minutos  .	1	
Licuado 4 cebollas cabezonas , tomillo , cebolla larga parte 2 cabos  .	1	
Mita tiene cebolla no ve que lorenzo no me trajo cebollas y estaba esperando pr hacer el arroz  .	1	
Nano dígale a su mama que si me regala una cebolla esque lorenzo no me trajo cebollas	1	
Necesitaba una cebolla pero no hay v porque los ogros son como cebollas	1	
Ponele 3 cebollas y un pedacito de cebolla	1	
Pues alcance a comprar algo y me habían dicho que había cebolla pero apenas habían 3 y eso no alcanza para mucho era solo unas cebollas	1	
Rremojelo el chancho en agua i sal Luego ai hacer coser las pechugas de pollo Ai q precoser el arroz Piqué las ciruelas pasas Ai q picar cebolla bastantes nomas luego licuee pimentón rojo los hace sofreiir con las cebollas picadas un poquito de comino i pimienta poco pisca Luego que este todo sofreido lo deja enfriar un poco desmenuza el pollo Todo se mezcla con el arroz precocido sal a gusto	1	
Talle 37-38 cambio por oferta de papa y cebollas O un kilo de papa y un kilo de cebolla	1	
#serpiente,	serpientes
Igual dicen que es una serpiente magica , osea como que de por sí las serpientes tiene un aura mistica	1	
Que tal bro , mira la serpiente la compre en reptile ink junto con otras serpientes y el documento de legal procedencia desconozco donde quedo realmente , de hecho aparte ellos quedaron en mandarme ese documento por correo pero no me llego y la vdd jamas le vi inconveniente ya que tampoco es tan esencial a menos que quieras reproducir y sacar el pims	1	
Y ademas seria una serpiente dócil porque hay serpientes dóciles pero son muy peligrosas igual que Ari	1	
Yo ni en pedo quiero ver ese nido de serpiente si quiero ver serpientes voy al serpentanrio de temaiken	1	
#coche,	coches
A ps es que me salí a caminar we , iba caminando ahi en churubusco y ps hay una parte donde salen coches y así hacia la avenida y ps yo vi el coche que iba a salir we pero se detuvo porque ps no podía salir si nomas , pero el wey no volteo y justo cuando yo iba pasando el arranco y me pego en la pierna pero ps me quite alv y nomas fue un golpesillo ahi leve  .	1	
Armar uno asi con el almorol y un cepillo , shampoo para coche y un trapo obvio decorado como de coches	1	
Avía una cosa q nose si le gustara es una rueda de coche q la abres y es garjae dd coches de tres planta	1	
Ay te puse en el face para qie veas el coche y de paso le mandas msj son nuevos los coches ese mismo esta como 15000 aca	1	
El otro día Jonathan le pregunto a la profe q cuanto cobraba Xq ella a viajado montón y dice pues en vez de comprarme coches de lujo tengo un coche de mierda y guardo el dinero	1	
Excepto a los coches , para un coche , para eso hace falta un complejo sistema de poleas y un negro que tire de el , para no cansar a los caballos	1	
Fuimos a donde tu me dijiste y nos dibo que ya no recogía coches que el ultimo coche que recogió fue el de jose y con l pensión mia no se puede	1	
Gustavo los tres coches se me fueron a merlo a la terminal así que estoy sin coche hasta dentro de una hora calculo o un poquito mas te aviso	1	
Hola paComo estas ya averigue el coche aquí solo ahi 2 almacenes q venden coches	1	
Illo k guarros enserio hacerloo en un coche y k pase los coches y te vea	1	
Jajaja che perdón q te aburrí con lo de los coches es q nose en realidad con los únicos que puedo hablar de coche es mi papa y un amigo jajaja pero osea yo no puedo hablar de coches xq se tanto q aburro	1	
La casa d coches ya cobro el coche entero	1	
Lo que avía uno que solo lo podías conseguir si tenias un coche de otro dlc de coches y dije que hdp	1	
Los coches híbridos son un tipo de vehículo que usa la combinación entre coche eléctrico y el de combustible fósil  .	1	
Mas seguro que el seguro de coche que asegura tener seguro en la aseguranza de seguros de los seguros de coches asegurados	1	
Muchos me dicen que no compre el coche porque Sergio regala coches	1	
No mk me puse a cuidar coches en Santiago y se me robaron un coche aggg me denuncio el dueño	1	
Pero fui en coche , y con mi primo y pues como no hay coches íbamos súper rapido	1	
Porque vi tu coche y me tarde en pasar porque no dejaban de pasar los coches y cuando vi salio un chavo y después tu ya estabas afuera de la farmacia tenias una playera azul de manga larga	1	
Pues si vamos en coche para alla y para aca se supone que hacen falta dos coches , y de momento solo hay 1 , seria lo que te costara comer donde sea del metromar depende del sitio que querais y lo que comais y el cine tb depende si compras palomitas y bebida en el cine o si te las compras abajo en el mercadona o si no te compras nada mas si tu quieres llevar algo mas por si acaso	1	
Un amigo que tiene uno y que conoce bien esos coches fue xon nosotros a verlo y nos dijo que el coche estaba bien	1	
Vajando pal pueblo bijeo hay un parkin que aprcan muchos coches que hay nadie nos ven i nos escondemos detras de un coche	1	
Y empezamos hacer el amorr y sas y sas y sas , y dspj x la ventaba vi k venia un coche k era tu papa creo k era general de algo y venian varios coches	1	
Y he visti en videos d instagram q los coches si estan dirculando y mi padre a llevao a mi hermano en coche camo	1	
el coche exploto , y atras , adelante , y a los lados había coches de el , entonces la explosión hizo reaccionar a los otros y también exolotaron , la explosión hizo que uno de los pilares que sostiene la casa de destruyera y la casa de vino encima de una camioneta de mi papa	1	
espera aquí iré corriendo a ver si ya se fueron los autos corrí hasta donde estaba el coche con un poco de cansancio , llegué y efectivamente ya no estaban los coches di gracias al cielo o a la función por haber terminado pronto y que todos se fueran con respiración agitada saqué mis llaves abriendo el auto , entré y lo encendí saliendo del estacionamiento y avanzado hasta donde estaba el menor  .	1	
no es que no le guste que le toquen el coche , es por el tema de sensores , que tu sabes que esos coches son delicados de cojones	1	
#edificio,	edificios
A mi no me gusta este edificio no tiene nada que ver con los edificios que lo rodean pir lo menos hubieran hecho algo que no decentona con su alrededor	2	
Pues aquí son edificios los salones y en cada 1 Es una licenciatura así que un edificio	2	
Ahí vivía yo , va ahí fue en el último edificio que viví , antes de ese viví en dos edificios más jaja	1	
Bueno sigues esa calle Te vas a chocar con lo edificios de frentes y hay un parquiadero el ultimo edificio que esta frente al parqueadero es veis con verde entras por hay el ultimo piso el 402	1	
El tema es si esta en un edificio bajo porque el sol te lo pueden tapar los edificios de al lado	1	
En el año 1997 se había construido un edificio de 20 pisos , su función no era mas que ser un edificio residencial pensado de clase media , dicho edificio estaba ubicado en el centro de Ditroy ciudad que es conocida por sus edificios y muchas veces de situación económica  .	1	
Pero de edificios digo , porque yo vivo en un edificio	1	
Por hay construyeron un edificio blanco , en esos edificios blancos hay un justo y bueno y una ferretería godoy	1	
Teníamos que hacer un edificio dividido en bloques , onda edificios separados	1	
Y el otro en los edificios en la calle principal edificio yo lo espero abajo	1	
#hombre,	hombres
Tú has sido parte de mi vida desde hace un tiempo y hoy es momento de agradecerte todas esas veces que no me permitiste hacer una tontería , que me regañaste por volver a buscar a ese hombre que me rompió el corazón o que me cuidaste de todos esos hombres mientras estaba un poquito borracha  .	9	
Porque hay tantas personas que piensan que cuando una mujer habla de morirse , es por un hombre no que los hombres fuera oxigeno	6	
no es por creerme pero soy muy debunas para los hombres pero con el unico hombre q quierobestar en con usted  .	6	
Lo unico que sabia ers que los hombres siempre presumian a otros hombres cosas asi intimas pero yo no le eh dicho nunca a un hombre nada de eso en primera no me llevo con ellos pero pero creo que eh dicho cosas malas aunque eh evitado decir su nombre por respeto a ella pero creo tambien esta mal verdad  ?	5	
Por éso tu eres hombre y a Luis le gusta los hombres como tú ángel	5	
Talvez por eso te encontré porque Dios sabia que estaba sola y necesita un hombre a mi lado no para reemplazar el amor de esos dos grandes hombres que tanto extraño y me duele saber que no esta a mi lado apoyandome y verme crecer , porque el amor de ellos es irremplazable pero te agradezco por todo el esfuerzo que has echo por mi  .	5	
Tú has sido parte de mi vida desde hace un tiempo y hoy es momento de agradecerte todas esas veces que no me permitiste hacer una tontería , que me regañaste por volver a buscar a ese hombre que me rompió el corazón o que me cuidaste de todos esos hombres mientras esta bien mensaMe has visto llorar más veces que mi mamá y aún así me sigues consolando cada vez que acudo a ti a contarte un problema  .	5	
A pero alas mujeres les vale madres jugar con lis sentimientos de un hombre y aparte los hombres también tenemos sentimientos we	4	
Entonces , el hombre pensóPensó pensó pensó Pensó pensó pensó Pensó pensó pensó Los hombres demoran mucho pensando  .	4	
Se confía mas en un hombre que en una mujer la mujer abre la boca y los hombres se quedan callados	4	
huy la entiendo de verdad esos son los hombres q no valen la pena para q vas a querer un hombre q juega con tus sentimientos  .	4	
A veces me envía mensajes diciendo que todos los hombres la tratan mal , menos yo , que yo soy el único hombre que realmente vale la pena eso me dice , ahora si no son invenciones miasv	3	
La mayoría de los hombres piensan q una mujer busca un hombre galan , con dinero que pueda cumplir lujos , y lo único q buscamos es amor verda	3	
Las mujeres inmaduras lastimadas por un hombre , hacen que todos los hombres paguen por eso  .	3	
No seguimos a hombres que se hicieron dioses seguimos al Dios que se hizo hombre Jesus , único mediador , entre Dios y los hombres nombre sobre todo nombre , a ti cantamos	3	
Porque quién de los hombres sabe las cosas del hombre , sino el espíritu del hombre que está en él  ?	3	
Vea Mamacita dejé de estar buscando hombres ajenos y balorese que una mujer nunca se le insinúa a un hombre y pues si el no quiere estar con usted es porque no le probucas	3	
-Me dijo que tengo muchos amigosQue cuando quiera tener hijos me va a costar que voy a necesitar ayuda de los médicos Que este año en la escuela se me va a hacer difícil pero que soy inteligente Que voy a estar pobre sin plata hasta por lo menos que termine de estudiarQue me va a llegar el amor , que ese hombre esta , que me duran un pedo los hombres porque yo quiero que no me dejo jajaja y que hay alguien que me gusta pero es oscura esa persona y	2	
A pero alas mujeres les vale madres jugar con lis sentimientos de un hombre y aparte los hombres también tenemos sentimientos w	2	
Asher hombre felizSasha protector o vencedor de los hombres	2	
Asher hombre felizSasha protector o vencedor de los hombres Romina	2	
Esq ese es el problema d muchos hombres ay q complacer ala mujer en todo no la mujer al hombre	2	
La mayoría de los hombres piensan q una mujer busca un hombre galan , con dinero q pueda cumplir lujos , y lo único q buscamos es amor verdade	2	
La mayoría de los hombres piensan q una mujer busca un hombre galan , con dinero que pueda cumplir lujos , y lo único q buscamos es amor versa	2	
La mayoría de los hombres piensan que una mujer busca un hombre galan , con dinero que pueda cumplir lujos , y lo único q buscamos es amor	2	
La mayoría de los hombres piensan que una mujer busca un hombre galan , con dinero que pueda cumplir lujos , y lo único q buscamos es amor ver	2	
Los hombres elegiran cualquier chica que se mueva yo quiero un hombre que se mueva a Mi	2	
Los hombres piensan q una mujer busca un hombre galan , con dinero q pueda cumplir lujos , y lo único q buscamos es amor verdadero	2	
Mi 2017 en 1palabra Feliz Cm espero mi 2018 Amor y felicidad y pura buena onda pal k me iso dalo ahh y k oído k nazcan hombre pero pd k sean hombres porfaa aahh y lo ultimo k pido ehh k mi mama nunca me falte soy bn mamona	2	
Osea se que los hombres fallamos si en eso me incluyo porque yo soy hombre	2	
Porque hay tantas personas que piensan que cuando una mujer habla de morirse , es por un hombre ni que los hombres fuera oxigeno	2	
Proverbios 20 6-7 Muchos hombres proclaman cada uno su propia bondad , Pero hombre de verdad , quién lo hallará  ?	2	
Pues mira yo como hombre se que la MAYORÍA de hombres lo hacen porque les gusta , es decir como achs me la bese y listo ya  !	2	
Sabes q pelotudo d mierda si t sentís tan poco hombre para conseguirte una mujer sin pagar m das pena t juro lo q yo valgo no tiene presio infeliz t equivocaste y si estas tan nesesitado andate a la ruta poco hombre y con tu plata podes limpiarte el orto por hombres como vos existen tantas mujeres q no confían en nadie o comprate una muñeca inflable aunque con tu plata ni para eso t alcanza q lastima me das	2	
Yo pregunto algo las mujeres de este grupo dicen que no hay hombres buenos , que no hay hombres romanticos ni detallistas y que todos somos iguales entonces cual es el hombre que ellas quieren y sino los hay que quieren entonces , un hombre perfecto en un mundo donde hoy por hoy nadie es perfecto y todos tenemos cosas buenas y cosas malas o acaso ellas son perfectas  .	2	
Yo se no soy el mejor hombre soy el peor , se q hay muchos hombres mejores q yo pero soy un hombre q aceptar sus errores y que pide perdón	2	
mucho mas valoradas xq vienen de un hombre y muchas veces estas señoritas piensan q mostrandose logran la atención de los hombres  .	2	
pero algo si te digo yo mantengo decepcionada también triste no soy la mujer mas bella tampoco la mas joven pero si me encantaría encontrar un hombre que me quiera me valore me entristece ver que los hombres solo lo ven a uno como un objeto sexual no como mujer solo es eso bb pero no pasa nada nene por ejemplo contigo me gustaría tener algo lindo  .	2	
son hombre q lo hacen con otros hombres por dinero y sin nisiquiera sentir atracción por el mismo sexo  .	2	
una mujer me pregunta a un sabio por que cuando un hombre tiene varias mujeres es llamado yave maestra y cuando una mujer tiene varios hombres	2	
una mujer me pregunta a un sabio por que cuando un hombre tiene varias mujeres es llamado yave maestra y cuando una mujer tiene varios hombres es llamada puta	2	
-solo una forma , tiene que cazarse antes de la luna llena y consumar el matrimonio-si es lo único que puedo hacer bien lo haré-tomo su libro y con una reverencia se fue del lugar y regreso al que era su hogar empezo a redactar un anuncio para convocar a todas las personas que fueran casamenteras hombre y mujer al día siguiente había mujeres y hombres en las puertas del palacio	1	
//Desearía ser también hombre , osea hay muchos Rols que requieren hombres  .	1	
100 en hombre jajaj pero sin lo que nos hace hombres	1	
15 Por sueño , en visión nocturna , Cuando el sueño cae sobre los hombres , Cuando se adormecen sobre el lecho , 16 Entonces revela al oído de los hombres , Y les señala su consejo , 17 Para quitar al hombre de su obra , Y apartar del varón la soberbia  .	1	
3 hombres de negro 4 el hombre araña Jajaja	1	
6 Babuchas gris talle L Short seda fría talle 7 Short acuadrille talle 3 Short rayado con Lazo tallé 3 Short coral c/ Lazo talle 4 Capri mujer talle 5 Short rosa c/letras tallé 3 Pantalo gabardina Nene talle 10 Jeans mujer talle 48 Jeans hombre tallé 38 Mosculosas hombres talles 5 , xl , 4 , 6 Remeras hombres talles 5 , Xl , xxl Remeras mujer XL , L	1	
@antoxsb ella solo dijo que no le molestaría estar con una mujer , solo que ella prefiere estar mas con hombres y su elección es mas para esta con un hombre que con una mujer  .	1	
@caticamur lo siento mucho pero como hombres y mujeres deberían cambiar y ademas lo hombre son lo que estan peleando no las mujeres , tanto mujeres como hombre son los que pelean	1	
@feminismoesunamoda , es verdad tienes razón , y por respuestas así , los hombres les dan igual las mujeres , pero siempre wl hombre queda de malo , machista etc  .	1	
#piña,	piñas
Suuuu piña me comí molgolo A las piñas se hacen los vagos pero igual metí un botellaso	2	
Ayer fue que ella trajo unas piñas y bueno es jugo de agua de piña	1	
Compra una clavel , crema de coco , leche , vodka , canela en polvo , piña , hielos y jarabe de licor y tu rompope ara unas piñas coladas si  ?	1	
Cultivas piñas bueno veo una piña je je je	1	
El me peja una piña y después yo lo tiro y le pego dos piñas rre sarpadar y me separa Camilo y me dice para boludo lo estas haciendo mierda y después nahuel se levanta y no me acuerdo que dice corte llorando con la boca llena de sangre y se va para la parada de 314	1	
El trago de la piña era opcional le decía si gusta se podía hacer piña colada o otro tragó solo para las piñas o también servirles alguno de los tragos que ya	1	
El trago de la piña era opcional le decía si gusta se podía hacer piña colada o otro tragó solo para las piñas o también servirles alguno de los tragos que ya le di las recetas es depende de usted profesor	1	
Fui a mi depa hoy y me traje el descorazonador de piña para preparar ese día unas piñas coladas	1	
Laa cago a piña o las cago a piñas	1	
Le pegue una piña al banco de la profesora y como 6 piñas a la puerta	1	
Lo agarro a las piñas a jere lo cago a palos no sabes de dieron piña piña en la cara todo	1	
Martha no se te valla a olvidar traer una botella de jimador 2 botes de jugo de piña 2 botes de cocoPara las piñas coladas	1	
Mmmm es que como que ya no me emocionan comadre las piñas jajaja vivo con un piña y de pilon ya tengo 3 piñitas ya me ostigaron jejeje y mi cuerpesito busca algo nuevo jajaja apoco no comadre Esther Calzada	1	
No no me pegabas piña xq con la derecha puedo piñas pero cachetadas no xq no puedo estirar bien los dedod pero piñas si	1	
No que pegar piñas amor no , nos la va a pagar es quise decir no piñas amor mi no me va tocar porque la desarmo a piña y a vos menos Perde cuidado que no es boluda	1	
No sabe si nieto ayer lo agarro a las piñas al otro hermano de Mia , le dio piña en la cara y la decia dale Tenes miedo y se pegaba el puño en la mano jajaja no no ricardo se muere si lo veia , re enojado y Colorado	1	
Por que me pelie yo solo contra 10 y los cague a piñas y a uno le corte la cara de una piña por eso	1	
Tenía ahí unas piñas en almíbar mm pues le heche piña jajajjaa	1	
Una amiga mia se agarró con una wachina y corte le pego y la otra chica estaba con el abuelo y el viejo hdp le pego tres piñas a a mi amiga y corte saltamos todas y nos empezo a pegar piña a mi me roso la cara , igual saltamos todos y lo cagamos a palo al hdp hese no le puede pegar a una nena de 12 años	1	
#gato,	gatos
Si no tenes gatos , y un gato callejero entra en tu casa adoptándola como su hogar , es porque necesitas de un gato en ese momento en particular  .	3	
Amo a mis gatos pero odio que cuando me pintó las uñas terminen con algun pelo de gato pegado v	2	
Jajajaja ash perdon Ya no quiero gatos bravos Jajaja mucho mejor Ese gato si me gusta	2	
Seiya Si zen tuviera a sus hijos siendo un gato sus hijos serían gatos o humanos Zen	2	
V Me gustan los gatos v Igual vIgual v Mi animal favorito es el gato	2	
3 gatos locos que habían quedado de la anterior marcha a favor del gato cuando eran 4 gatos locos  .	1	
4 gatos tienen 1mes y 2 semanas 1 gato tiene 3 meses x si quieren saber	1	
A mi la vacuna de los gatos me salen 350 cada una con 3 y por cada gato	1	
Aca en el barrio estamos buscando hogar para ellos nelson los alimenta todos los días , junto a los vecinos yo no los puedo tener adentro ya que albano es alérgico al pelo de los gatos y perros , tengo un gato pero desinfecto todo el día , albano esta triste por los perros igual a sus amigos y una vecina frente a casa dice los veo otra vez y pongo la denuncia , la ree putie	1	
Ah no eso porque los gatos me miraban y cuando subo me dicen cornudo y le digo que onda gato , y me dice si sos re cornudo	1	
Ahora una anecdota un día encontré un gato en la calle , lo recogi , lo cuide y ahora tengo 5 gatos , 3 dinosaurio	1	
Ahora una anecdota un día encontré un gato en la calle , lo recogi , lo cuide y ahora tengo 5 gatos , 3 dinosaurios y 8	1	
Ahora una anecdota un día encontré un gato en la calle , lo recogi , lo cuide y ahora tengo 5 gatos , 3 dinosaurios y 8 dragones fin	1	
Aisladores NeftalinaChupos cerdoAtomizadores grandesLinternas todasJaulas pajarosCubiertas bonitas Guantes todos menos los de puntosCollares como el que tiene sharol Collares para gatos y perrosComida de gato en lataAgujas sucutaneas osea chiquitasTijeras negras grandes	1	
Ammm Okii mi amor Pero me avisas si te lo llevas amor sii Es un gatito amor No me gustan los gatos pero ese sii tengo una playera con un gato de esos y son hermosos amor	1	
Amor la gata tuvo sus gatos y nisikiera tienen pelos y lo peor un gato chiqui le mordió sus patitas y su colita a un gato bb	1	
Amor mira q esta fue la camada de gatos que regalo miller y mira q hermoso gato	1	
Arre pues te doy 10 hijos , un perro y un gato pues 2 perros y 2 gatos	1	
Arre pues te doy 10 hijos , un perro y un gato pues 2 perros y 2 gatos ,	1	
Arre pues te doy 10 hijos , un perro y un gato pues 2 perros y 2 gatos , siempre de voy a corresponder porque al final tu estas echa para mi y yo para ti	1	
Arre pues te doy 10 hijos , un perro y un gato pues 2 perros y 2 gatos , siempre de voy a corresponder porque al final tu estas echa para mi y yo para ti , solo quiero verte ya amor	1	
Arre pues te doy 10 hijos , un perro y un gato pues 2 perros y 2 gatos , siempre de voy a corresponder porque al final tu estas echa para mi y yo para ti , solo quiero verte ya amor a y otra cosa claro que te voy a permitir estar en mi vida por siempre nada me haría mas feliz que estar a tu lado porque eres la que siempre endulza mi sal , la que me alegra los días , la mujer que mas amo	1	
Arre pues te doy 10 hijos , un perro y un gato pues 2 perros y 2 gatos , siempre de voy a corresponder porque al final tu estas echa para mi y yo para ti , solo quiero verte ya anoe	1	
Así como cuando tu papa te trae un gato para que mate a la rata y tu me temes a los gatos	1	
Así como cuando tu papa te trae un gato para que mate a la rata y tu me temes a los gatos y también a la rata	1	
Así como cuando tu papa te trae un gato para que mate a la rata y tu me temes a los gatos y también a la rata triste historia	1	
Claro y el gato no es seguro todavía porque no se si estarán regalando esos gatos que a visto el elvis	1	
Comadre mandeme ese gato bolador para yo enviarlo a alguien que es fanaticaalos gatos	1	
Con el gato de una barrio de gatos jaja fernesito tranquiii	1	
Cosa que no hacen los gatos normalmente , si uno ve a un gato jadeando hay q preocuparse	1	
Creme q cuando temando cosas te digo lo q siendo todo mensiento intenso por q yo si soy frio muuy frio jajjaa pero con tigo no ne sale te dare un ejemplo von gatos yo spy un gato salvaje si jaja tuuu me llevaste a tu casa si y muerdo a todo menos a ti con tigo ronrroneo si jajajaja	1	
Cuando Quieres correr a gatos ajenos y X error casi correr a tu propio gato  .	1	
Cuando salí a mirar si ya comieron todo mis gatos le veo al gato negro grande comiendo la comida de los chicos	1	
De mi Hermana que llego con un gato y yo le tengo pavor a los gatos los aborresco	1	
El es gato y yo no te dejo andar con gatos	1	
El famoso gato azul q t gusta , t gustan tds los gatos	1	
El gato fest de mañana es para perros y gatos	1	
El gato mas gato de todos los gatos	1	
El gato pa q operete los gatos	1	
El gato we todos son gatos el gigolo para ser mas preciso	1	
El origen del gato Savannah está en los años 80 , a partir de cruces entre gatos domésticos y el S	1	
El pan hara que caiga de espalda el gato , pero como los gatos siempre caen de pie	1	
En la foto esa de los canales de Venecia y en tus gatos , como yo estoy con mi gato aca me acordaba	1	
Entonces no es comida de gato , mi gata es la reina , si ella no lo consume otros gatos tampoco	1	
Eres un gato que debe estar en la cárcel para gatos	1	
Es gracioso que Edward vista a Peggy de gato , la coshe como gato y le tenga fobia a los gatos  ?	1	
Es gracioso que digas que tu perrita actúa como gato porque en la tarde vi un video de un chico cuyos gatos actúan	1	
Es q cm me asen daño los gatos me da alergia y donde trabajo ay un gato y pz x eso estoy malo	1	
Es que yo no solo cuido amis gatos cuido casi a todos mis animales asta su gato de eya alos 5 peritos panbien y me biene a reclamar que no ise nada Gates 250 en la veterinaria de lo que te pusieron artas cosas para que sobre vivi eso yo puse de mi plata eya no puso nada y me reclama si todo el día ayer estaba en esa veterinaria	1	
Es un gato yo no ando con gatos pero si vz crees eso no me hables mas punto	1	
#pájaro,	pájaros
Jaja viste q te cagas ss mas cagón vz y ese pájaro cochino jaja traerlo amr a la tarde y los vamos a pillar pájaros keres	1	
#vaca,	vacas
A la vaca uwu pues que no sabés que yadira ordeña vacas y haci la ayudas a sacar lechita 7u7	1	
Acabamos de llegar con manuel estabamos pasando las vacas y dandole una purga a una vaca	1	
Creo que hay una enorme vaca en la calle le hizo como le hacen las vacas que mello	1	
Decía si ahy una vaca ahy un toro y si ahy 2 vacas ahy 2 toros y asi	1	
Dejale sus ubres a la vaca ya vez que gaby es experto en agarrar vacas	1	
En julio tengo 15 dias de vacas y nos vamos de vaca	1	
Jaja no hay vaca que se resista a mis encantos vacas vaqueras	1	
Jajaja ayyy pero es obvio estando en vacas d comer cmo vaca yo igual ajaja	1	
Jajajajaaja viene la vaca , viene la vaca jajajaja acuerdese que ya tienes herencia de vacas	1	
Jamás , nunca se me olvidara cuando te transformaste en una vaca y como amo las vacas me hacer que para verla y cambiaste tu cara diciendome soy yo , y me rompiste el corazon	1	
Listo si señor y se pueden cruzar con cualquiera de las vacas o usted me dice cada vaca con quien  ?	1	
Mk vea que anoche llegaron vacas y entonces hoy por la mañana nos tocó echarlas a un potrero y emtonses Ivan 38 vacas y supuestamente son manitas entonces una vaca negra y con unos cahotes enpeso a corretiarme y me toco meterme en una quebrada	1	
No me dieron vacas asi fue el año pasado al que le dan vaca no lo contratan mas	1	
Que hay unos parches para colocarles a las vacas y cambian de color , con eso detectan cuando la vaca esta en celo y cuando no	1	
Si esta de vaca Pero la esta trabajando a las vacas jaja	1	
Si las vacas dan leche entonces Soy una vaca  ?	1	
Sigo de vacas y soy una vaca	1	
Vos estas d vaca yo kiero mis vacas ayer dijist q m firmabas hoy no , trabajo solo d tard y x ej anoch con 12 pctes no entiendo xq ahora la supervisora no firmo mis vacaciones	1	
Y mosotrosle aviamos bendito unad bacad a él no pues el salio y nos mostró todas las vacas yaya le digo tiene una vaca muy fina	1	
Y otra me debes mi peluche de elefante pero como me gustan mas las vacas pues me debes una vaca enorme , Ahora te voy a molestar a ti jaja	1	
#cabra,	cabras
Ah ps la cabra esta a la vuelta de su casa y un dia íbamos pasando ramon y riki y yo y vimos a la cabra y a ramon se le ocurrió decir que los de la birra contratan a leonardo para que mate a las cabras a cabezazos y le dan 5 pesos para su chesco pero esa cabra no se deja de leonardo y se han agarrado a cabezasos muchas veces v y por eso le decimos esa cabra va a ver mira como te dejo v	1	
Las putas de las cabras la madre que la parió yo tenia una cabra y la muy puta se murió  !	1	
Según mi madre la de tu no metes cabras es chupa la cabra	1	
Siii amor creo que los dejan subirse a las cabras amor si se monta en una cabra hande nos cantara abuelito dime tu	1	
#caballo,	caballos
A la amiga que le gustan los caballos trate de conseguir un caballo para tu montura pero sorry no conseguí , mas bien salen caros , jajajajajaja	1	
Algo asi de y los caballos tienen dolor de caballo	1	
CUMPLEAÑOS CABALGATA EN CALDAS Incluye Decoración En una hostería Torta con vela volcánica 2 0 Número cumpleaños Media aguardiente o ron 50 caballos disponibles 5 horas de recorrido El cumpleañero paga la mitad del caballo pero si van más de 10 personas el cumpleañero no paga Valor por persona 68  .	1	
Caballo e mierda lo aiga cogido por puto q mierda tenia q correr el caballo culo si los caballos no son para estar sueltos	1	
Como el día que me preguntaste que si los caballos tenían dolor de caballo	1	
Después te voy a mostrar una foto de mis caballos tuve una yegua blanca y un caballo negro pero ese no se dejaba montar	1	
Es que la verdad el no tiene caballos bueno tenia un caballo pero ya no tiene ahora el mas le interesa el fútbol	1	
Es que yo ya había terminado mi competencia estaba con una amiga de para ir por la comida de los caballos y pues mi amiga estornudo el caballo se asustó y soltó una patada y pues yo la recibí en mi pierna	1	
Es que yo ya había terminado mi competencia estaba con una amiga de para ir por la comida de los caballos y pues mi amiga estornudo el caballo se asustó y somoto	1	
Faaa mira los caballos dijo nare , dice que kiere el cumple con un caballo haci que reservenlen uno para los 15  .	1	
Hector Martínez por cual de los caballos preguntas tu por que Galdis Silva Serrano tenia dos caballo uno mocho que no respetaba puerta y el otro que era mas quieto	1	
Hoy tarde me puse a cambiar de potrero a los caballos y andado a caballo en un gatal perdí la villetera von todo	1	
JejejePz cabe el 50 y 50 Ral ves si voy el sabado con mi amigo Cesar en caballo y vestidos de vaqueros pero pz deja ver solo ay ke conseguir los caballos	1	
K me dan miedo los caballos k el otroo diia el caballo por poco me caee	1	
Lo unico cob lo q me entretenía era con los caballos , yendo a entrenar De ahi me iba a caballo a chapingo para entrenar de la escaramuza	1	
Los huesos de los caballos tardan mucho en sanar , y no siempre pueden hacerlo bien , las heridas en patas y cascos también son lentas en la curación , cuando a un perro se le rompe un hueso en el mismo lugar que a un caballo , se le podía curar , pero en los caballos hay veces que es imposible de soldar , y si	1	
Mami , fíjate que el tipo este donde tiene el caballo ayelen me estaba contando juan cruz que el chabon los mata a los caballos  .	1	
Me fui a echarle el caballo a la yegua después me puse a bañar mis caballos después fui a traer y a dejar a la súper pulga y ya estoy aquí me bañe y comi	1	
Me llamo Cintia tengo 19 años , estudio pedagogía en educación parvularia y basica , el lunes entro a trabajar en call center , soltera sin hijos , vivo con mis padres , tengo dos hermanos soy la menor y la única mujer , me gustan los caballos y las carreras de caballo	1	
Me llamo Cintia tengo 19 años , estudio pedagogía en educación parvularia y basica , el lunes entro a trabajar en call center , soltera sin hijos , vivo con mis padres , tengo dos hermanos soy la menor y la única mujer , me gustan los caballos y las carreras de caballo y no carreteo  .	1	
Montar a caballo me da terror los caballos pero quiero hacerlo contigo amor	1	
No es realmente q guste los caballos que no ves la chica que esta alado del caballo	1	
No es un caballo perro , todos los caballos lo hacen V	1	
Pero me acorde que le gustan los caballos y la otra vez vi unos peluches de caballo bien hermosos	1	
Pero si sabe de caballos sabras lo que cuestan de buena caballo	1	
Por eso compras un caballo y lo guardas en un lugar de esos donde también guardan caballos	1	
Primero me voy al campo a buscar caballos y me voy a lujan a caballo con mi papa unos amigos	1	
Ps sigo sin ver el chiste de eso osea no se pero no se me hace entretenido o divertido ver cm corren los caballos o simplemente ver cm un hombre en un caballo tumba toros	1	
Pues porque a ti te gustan los caballos , aparte porque sabes montarlos y te gusta montar a caballo	1	
Pues si es deporte , aunque no olímpico pero lo es , a mi también me gustan mucho los caballos , mi abuelo tenia un caballo cuarto de milla y falleció hace dos años el caballo y nos dio mucha tristeza	1	
Que cuando son menos de 4 caballos hay que pagar el caballo del guía	1	
Sabes me fascina la vida de campo mi Padre fue ganadero y con el aprendi Muchas cosas , amo los caballos , ordeño muy bien , monto a caballo muy muy bien , sacaba los ejemplares de mi Padre a los concursos , tuve un caballo muy lindo llamado pretencioso que ganabamos en todos los concursos  .	1	
Sergio quería que saque ala nena que estava con el caballo y yo le tengo miedo alos caballos	1	
Si pero tiene un caballo Como su hijo Jajaa y yo le tengo miedo a los caballos el para donde va lo lleva	1	
Si yo una vez que bajen mis caballos le digo que te lleven el caballo para alla o si no el lunes	1	
Sisi no hay problema , nuestros caballos estan totalmente capacitados para niños que no saben andar de a caballo	1	
Tambien me gustan los caballos pero no para cuidarlos sino para montar a caballo	1	
Tengo 5 caballos vendo 2 y me regalan 3 cuantos caballo	1	
Un dia me quede en la ciudad parado porq puse el bot a volver a caballo y en mirror no entran caballos xd	1	
X eso es que pone perfiles de caballo X el mosito que tienes que el es montador de caballos jajajajajajajajaja	1	
Y a los caballos les da dolor de caballo xD	1	
Y si yo no pudiera llevar los dos caballos pq no caben vs tenés algún amigo para pedirle un caballo en sosa	1	
Y tampoco lo entendí porque llega un hombre en un auto y se pone a preguntar por dos caballos y cuando le esta contestando el dueño de caballo entra la llamada	1	
Ya me conto , me dijo que se fue a la iglesia a tocar , y que la boda que hubo estuvo bien bonita que porque la novia y el papa de la novia llegaron en caballo y estuvieron escoltados por mariachis igual en caballo y todos los caballos eran blancos ,	1	
Yo amo los caballos incluso mira mi caballo se llama tango	1	
Yo estaba serca de donde traian los caballos porque mi primo el inútil estaba a caballo	1	
mira que ya es insoportable aguantar tener que espérate todo el día para tener que esperar toda la noche pendejo caballo de la popó ya odio a los caballos	1	
mire q en el face tambien me pidieron un caballo perp la cabesa q para ponerla la fpto en un establo de caballos en mexico	1	
que se nurio por que tenia un apetito sexual muy fuerte y nada la satisfacía y empezó a experimentar con caballos y un encuentor la destrozo por denteo por el libido del caballo	1	
yo yba caminando y vi el caballo y se empezó a acerar ami yo le tengo terror a los caballos me faltaba el aire	1	
#niño,	niños
Ya sabéis que cada 6 de enero nosotros vamos en silencio a casa de todos los niños y les dejamos unos regalitos para celebrar el nacimiento del niño Jesús y para decirles lo orgullosos que estamos de ellos  .	12	
-suspira- el niño de papi y mami jugando a la play dos con unos niños  .	9	
que me digas ya amor parece una gallinita poniendo huevos ahhh te amo mi pendejo preferido cada día que pasa me mas d ti tus pequeños detalles n tiene precio mi niño amo cuando me haces reír cuando reímos como dos niños esas pequeñas peleas por la noche xq n de dejo dormir las amo simplemente psp de el mi tiene tu nombre mi amor  .	5	
Divino niño Viernes 2 7pm bendición de niños y velas San Rafael es día de la candelaria , si necesitan el himo yo se los porporciono Sábado 3 8am Guadalupe es día de San Blas , hay bendición de gargantas Domingo 4 9am Divino Niño 8pm Guadalupe Lunes 5 8pm sector Guadalupe  .	4	
Esta gente se merece el cielo , se merece que le pase todo lo maravilloso que puede existir , yo por esta gente es por quien voy a orar , por los niños en condición de pobreza , para que cada niño sea feliz y respetado con lo puro que son , por los ancianos que sufren el manoseo de una presidencia y el maltrato de familiares y establecimientos que los asilan , por ellos que nada ya pueden hacer para cambiar su vida , por ser muy pequeños o muy ancianos  .	4	
Hasta mañana mi vida que duermas bien corazón hermoso que sueñes con los angelitos mi vida hermoso amor dicen los niños que duermas bien amor hermoso Descansa mi niño bonito Dulces sueños amor siempre juntitos bebe hermoso Hasta el final mi rey hermoso	4	
La historia mas boba y hermosa a la vez En el inem Habitaban dos niños que no tenian ni idea el uno del otro bueno el niño si pero el tuvo pena de hablarle a ella el sabia el nombre de ella por que preguntaba por ella sin que ella lo supiera entonces un dia como otro cualquiera ella decidió ir a la cafetería	4	
Pero como en toda leyenda urbana , existen varias versiones , en 1976 Mary and Herbert Knapp en su antología llamada el folclore de los niños americanos , cuenta que un niño llamó a Mary Worth cuarenta y siete veces frente al espejo y esta apareció con un cuchillo y una verruga en la nariz  .	4	
Yo se que tu ya estas quedando con un niño y todo eso , pero yo se que esos niños en veses se aburren de las niñas , y no miento me encantan los dosss hacen sp bonita pareja , pero osea el día q el se canse de ti , y te deje de hablarr espero q eso nunca pase te juro q voy asta su casa y yo misma le rompo su madre por averte roto el corazón ati  !	4	
es un enterizo solo hasta el cuellito , la cabeza del niño sera con huleBuenas tardes el traje de los niños	4	
, y tener niños todos los años un niño	3	
Edgar es solo un niño como todos , Y como todos es que hay muchos niños muchos no solo el existe	3	
El niño me estaba diciendo cosas de sexo y que yo con los niños no le contestaba él me pegaba con la regla y también me está diciendo groserías en inglés	3	
Esta gente se merece el cielo , se merece que le pase todo lo maravilloso que puede existir , yo por esta gente es por quien voy a orar , por los niños en condición de pobreza , para que cada niño sea feliz y respetado con lo puro que son , por los ancianos que sufren el manoseo de una presidencia y el maltrato de familiares y establecimientos que los asilan ,	3	
Isaac era un niño triste , sin amigos , Aunque la mayoría de los niños estaban pasando la noche con sus familias y esperando con impaciencia la apertura de los regalos que se colocaban cuidadosamente debajo de los árboles de Navidad bien decorados , el pequeño Isaac pasó la noche a solas en su frío , y polvoriento desván  .	3	
Me dice que los niños deben compartir con otros niños , por que un niño solo q solo sea el , se vuelve egoísta antipatico , arrogante , se enfrasca q todo es el y nada mas que el	3	
Sólo los niños para que elaboren el producto y se les dará lo que cada niño tenga que desarrollar de forma teórica ; para que posteriormente nos reunamos y checar la exposición  .	3	
Sólo los niños para que elaboren el producto y se les dará lo que cada niño tenga que desarrollar de forma teórica ; po	3	
También me ha pasado cuando era pequeña lo veía y también me traumaba algunos capítulos eran muy fuertes me acuerdo que vi una donde mataban a un niño y lo hacían de tamal o cuando igual se robaban a los niños	3	
Con mi chiga exótico un amor amar los niños una feliciada da este niño	2	
Cuando jugaban fueron hacia los niños yo me fui hacia la señora Mamá del niño gordito y vinieron luego me levante y me fui hacia al otro lado dije aver si viene  .	2	
De niños pequeños y ahí un niño bellisimo	2	
El amaba los niños y uno tenia cancer pero antes de que muera el niño Michael Jackson le compro una casa con un enorme patio y juegos tmb juguetes para que lo disfrute mucho mientras podía seguir vivo	2	
Hay aves quisiera ser niño por que a los niños casi  .	2	
Hay tres niños haciendo su tarea una niña está escribiendo la otra notando y el niño está	2	
Hay tres niños haciendo su tarea una niña está escribiendo la otra notando y el niño está enseñando su tarea Ellos están contentos la niña tiene una blusa rosa con	2	
Jajaj pero no lo hagas Piensa en los niños En cual quier niño	2	
La historia mas boba y hermosa a la vez En el inem Habitaban dos niños que no tenian ni idea el uno del otro bueno el niño si	2	
Lo único incorrecto ahí es llevar al perro cuando llevas a un niño , los niñitos a esa edad pesan mucho para cargarlos irónico que cargue al perro y los niños quieren caminar y con una correa como esa sujeta al niño es lo mas seguro  .	2	
Mi amor perdón por no saber como comportarme en algunas fiestas , yo soy un niño inmaduro , descabellado y me refiero a que soy incontrolable como un niño de cinco años lleno de energía rodeado de miles de niños , y es que bueno ya lo sabías pero , creo que es por mi Hiperactividad  .	2	
Mis niños aquí les va una historia El pequeño Francisco había desarrollado desde muy niño , un miedo terrible a la oscuridad que preocupaba a sus padres  .	2	
Mis niños felices con su regalo de traído de niño Dios  .	2	
No estás solo , ni tampoco están en contra tuya , ten siempre la mente abierta ésto último , lo aprenderás con el paso del tiempo , lo único que te puedo decir ahora por experiencia propia es que saques todo lo malo de tus pensamientos , ten parte de laentalidad de un niño como cuando éramos niños	2	
No mi vida cuando todos los niños se fueron porque todavía habia mucho niño	2	
Para los niños que adoren bien bonito a nuestro niño jesus	2	
Pero eso no lo hacen los niños buenos deshonrarías el nombre de niño bueno	2	
Por mas que me puse analizar la crisis fue asi de a ver Ximena porque carajos te gusto se niño si ni siquiera es tu tipo a ti te gustan mayores no niños pedorros  .	2	
Y cuando hixo el lonche me dijo a donde fuiste le dije a preguntarle a mi hermana si me va a ayudar cn los niños y me fui Xq el niño me estaba hablando y me dijo te estoy hablando Xq no me contestas , se sintió ignorado el señor y Mas me dijo que está bien pendejo por andarme preguntando las cosas , la vdd no lo esciche mi niños me estaba hablando la tele con volumen alto y la niña gritando  .	2	
Y los que tenemos niños este mes tuvimos q vender hasta los riñones para poder solventar ropa y niño Jesús	2	
me dijo que tiene muchas vainas el niño Dios de los niños de el  .	2	
-Ve a otros niños pegandole a un niño de lentes y se acerca-oigan , ya basta  !	1	
-grite despertando a los niños antes de tomar la caja admirando todas las golosinas-OWSHHHIII TE AMO-aplaudi como niño feliz antes de dejar la caja en un lugar seguro y tirarme sobre ti-	1	
-habla la directora , el joven mira al niño y éste tenia la cabeza baja- por suerte son niños y no fue tan grave-	1	
1 para niño de 2 años 4 para niños , entre los 3 a 6 años , y 2 para 11 años  .	1	
1Hay un men regalando juegos avlos niños y le va a regalar a un niño un balon y una bicicleta pero el no le gusto porque  ?	1	
2 niños una niña y un niño	1	
2 una niña y un niño y si tengo puros niños hasta que me salga una niña	1	
3 Mito el Niño LluviaEn el bosque vivía un niño con un hombre , ahí también se encontraban varios niños , pero es éste niño de cabellos largos tenía una particularidad , el niño no era un humano , si no lo lluvia convertida en un niño , entonces el hombre como no sabia nada se quedó con el niño , cuando quiso agua para la tinaja el niño escurrió su cabello largo y se la dio para que pudiera tomarla  .	1	
5 / 3 20 57 T Jose Buenas noche al parecer nos a llegado un comunicado ala sociedad de cazadores que tengamos cuidado con los niños que hay una banda cojiendo niño para los órganos 5 / 3 20 59 T Jose En don Benito an querido cojer uno	1	
8 dos niño soy antiguos 8 dos niños mimis 5 metalicos los q nos dio aquella ves y 26 dos de mayamis vidrios engomados y tornasolados	1	
#ordenador,	ordenadores
#dòlar,	dòlares
#plátano,	plátanos
#dedo,	dedos
Acaricié su mano con mi dedo pulgar ya que había logrado hacer que quedaran entrelazadas nuestros dedos , sentí que mi estómago se hundía de sólo escucharle  .	12	
La verga de los perros es más salada pero rica así que comencé a disfrutarla toda Chester no hacía nada pero yo disfrutaba , me comencé a dar dedo muy rápido y rico mientras se la chupaba , a eso saque mis dedos mojados y le di a probar a Chester mis jugos ya que un relato decía eso , el reacciono enseguida los lamio rápido y gusto  .	9	
Acaricié su mano con mi dedo pulgar ya que había logrado hacer que quedaran entrelazadas nuestros dedos  .	3	
Estoy comiendo jiguito y estoy escribiendo con el dedo chiquito porque tengo pegajoso los dedos	2	
Me encantaría qie no fuese t dedo sino mi boca y mis dedos	2	
Nunca apuntes a nadie con el dedo ya q recuerda q al hacerlo 3 dedos tuyas apuntan directo a ti	2	
Y el vidrio resbalo y x agarrar mi dedo salio herido bueno dos dedos	2	
-//////- mmmh La abre con los dedos y con otro mete su dedo	1	
-lo saca y lo introduce el segundo dedo comienza a haces movimientos y luego hace los dedos como tijeras	1	
-obserba como los lame y después lo vuelve a besar mientras lleva sus dedos a su entrada y mete un dedo lentamente-	1	
33 Mana pero ya no me dan para mas mis dedos ya se me abrio mi dedo de enmedio	1	
Abrir la mano , ponerla sobre la empuñadura de la pistola , poner el dedo índice sobre el gatillo y cerrar los demas dedos	1	
Acaricié su mano con mi dedo pulgar ya que había logrado hacer que quedaran entrelazadas nuestros dedos , sentí que mi estómago se hundía	1	
Al oír sus géminis deje de masturba y le quete el bóxer le abrió sus penas tan sexis me exitadan y comencé a introcudir en dedo a su entrata se sentía tan apretado que después le introduco dos dedos Grita bebe grita que quieres mas  .	1	
Ayer te marque pero fue sin querer Fue mal de dedo ya vez como son mis dedos torpes ajjjajaj	1	
Bueno después me pides que meta otro dedo en tu vagina así que te meto tres dedos	1	
Bueno ya sabes tienes que dejarte meter una dedo primero y luego 2 dedos y luego el pene	1	
Cojo y me pongo boca arriba con las piernas abiertas y pongo ambos dedos índice en cada lado de la vagina y empiezo a mover el dedo índice de la mano derecho y el de la mano izquierda lo dejo quieto y empiezo hacer movimientos	1	
Cojo y me pongo boca arriba con las piernas abiertas y pongo ambos dedos índice en cada lado de la vagina y empiezo a mover el dedo índice de la mano derecho y el de la mano izquierda lo dejo quieto y empiezo hacer movimientos y siiii	1	
Con el dedo que señalas 4 dedos te señalan a ti nunca lo olvides	1	
Con la parte externa es pegarle con los tres últimos dedos y de el tobillo hasta el dedo meñique	1	
Con mi dedo pulgar froté su clitoris sin dejar de penetrarla con mis dedos  .	1	
Con un ojo hinchado , dos dedos cortados y un piquete en el dedo de mi mano que esta feo	1	
Cortate las cn el cortauñas hasta donde empieza tu dedo y lo demas remojas algodón cn acetona y t lo pones en el dedo y lo envuelves cn papel aluminio asi cn todos los dedos se va a empezar a deshacer el acrilico y lo vas a ir limando	1	
Cruce los dedos para q mañana amanezca mejor ese dedo	1	
Cundo me masturbo introdusco primero un dedo después , después dos asta tres dedos asta que sale no mis líquidos	1	
De ancho dos dedos de largo el dedo del medio	1	
De poco a poco introdujo otro dedo en la entrada del menor para así mover ambos dedos a manera de tijeras , y así su entrada se fue abriendo de poco a poco  .	1	
Eeso siClaro está , si ella quiere si no , le toca con la mano y un dedo suave un rato y después dos dedos suave	1	
El dedo jajaja todos los dedos llenos de sangre ajja	1	
El tamaño es dos dedos mi muñeca a mi dedo del medio	1	
Empiezo con el dedo y cuando se acostumbre meto dos dedos y luego así eso no te dolera porque porque ya lo hicimos una vez	1	
En el dedo aun no se si cual de estos dos dedos jaa	1	
En este momento me estoy hacien rico me estoy viniendo delicioso me metí el dedo y me salio lleno de leche rica rica y luego me lamí los dedos	1	
Entonces usted un día de estos se partir los dedos de tanto volearse dedo	1	
Eres linda mi vida-sacó mi dedo de su intimidad para empezar a rozar dos de mis dedos en su in	1	
Es cierto que algunos niños para no lastimar a su pareja primero la penetran con un dedo para ir lubricando y cuando creen seguro meten 2 o 3 dedos	1	
Es un dispositivo que es capaz de leer , guardar e identificar las huellas dactilares Generalmente del dedo pulgar , aunque la mayoría no tienen problemas en aceptar los demás dedos  .	1	
Estaba a punto de introducir un tercer dedo pero sus deseos le ganaron y saco ambos dedos , con cuidado introdujo su miembro en la entrada del menor , asegurándose de que cada vez que supiera que su rostro mostraba cierto dolor se detenía  .	1	
Haber quien mw ha manosiado mas usyed y quien me ha metido mas los dedos usted Y quiere saber algo me gusta q me meta los dedo por q me loa mete y empieza a moverlos se siente rico y despues como me cojes la cola lo cenis todo ya listo eso quwria saber hay ya le respondi	1	
Hay tiene el pie en al punta tiene los 4 dedos y el 5 dedo lo esta agarrando con la mano fíjate tiene el puño cerrado agarrandoce el dedo gordo del pie	1	
Hay ya va a empezar con sus dedos todo mi le gusta el dedo	1	
Hola amiga , le mande un shor m hace el favor de recogerlo un dedo d cintura ambos lados y 2 dedos d ambos lados de cada lado xfa	1	
Jaajaj eso es bien difícil de explicar ajajjajaja Osea mira con dos dedos te vas frotando suavemente y así luego suave te vas metiendo un dedo ajajja es que hay es difícil de explicar ajja	1	
Jajajaj yo también tengo el dedo chuecaso boluda por sonarme tanto los dedos	1	
Jajajaja cuando no metía bien usted metía sus dedos en la boca y luego me dabas dedo para que entrara bien	1	
Jajwjqha se estaba limpiando el dedo ayy que se estaba haciendo con los dedos ayy	1	
Javi dijiste dedo derecho yo no hablo con los dedos	1	
Jmmm amor metase el dedo entonces y si le caben 2 dedos mucho mejor	1	
Kenro Al ver lo que provoque meti un trecer dedo y subi para besarla sin dejar de mover mis dedos	1	
#perro,	perros
Hoy casi matan a mi perro y por salir a defenderlo me lastime , los perros solo huyeron  .	3	
Q alibio un peso menos solo dire algo se calsa los pantalones es desir se arma de valor lo mira como solo yurio y milo suelen hacer y le dice si Noah resulta lastinado x tu culpa recuerda q fui un perro mucho tiempo y los perros muerden ademas soy aun capitan de un equipo de Hokey y ese juego es viloento	3	
Yo soy fan de los perros , pero no de cual quien perro como tu así de simple y facil  .	3	
nada , venia una pareja con unos perros y de adengro de una casa salio un perro a , pelearse	3	
Con ese collar q ni para jugar al futbol con trmendo calor no te sacas te tiene atado como a esos perros y vos chocho con tu collar y ella chocha por q su perro esta usando du collar ja	2	
Hoy lo tenemos en nuestra casa pero no podemos tenerlo a causa de que tenelos tres perros mas , el perro es muy cariñoso , no es bravo  .	2	
Osea dije que si tenias perro porque me gustan los perros xd	2	
Pues si eso si el dinero no dilata , si me da risa q le dice a jas q una amiga rasura perros y q si quiere para su perro q el latrae hasta su casa jaja no se que piensa q me enojo o algo asi pero no encerio q me vale	2	
Y los intestinos darselos a los perros callejeros y hacia formar una manada de perro y así acabar con el mundo	2	
, cuida a tu perro , no tiren perros en la calle y listo  .	1	
-sigo conduciendo mientras intento evitar todos los semaforos hasta que se me cruza un perro provocando que frene el auto- malditos perros  !	1	
1 imagen de hallowen , otra de un espejo , otra de 7 perros , otra de telarañas , otra de un perro enfrente de un espejo , una de un fantasma y otra de un hueso	1	
44Tengo 2 perros una que es de mis abuelos que es tipo perro salchicha , que se llama Dumba y una caniche que es mía llamada Morita y una coballa llamada Leona	1	
A das de perro hpta hechando los perros a toda puta que ve y la perra sarnosa soy yo gonorrea	1	
A hora sacare al perro un poco mas tarde para k no vea a nadie ni perros	1	
A katrinaa la atascaron unos perros grises y yo solo tres perras y un perro mire sueltos todos	1	
A mi me gustan los perros y gatos en otros me gustaria ser un perro ja	1	
A mi menos , ni los perros o muuy raro que perro jaajajaja	1	
A mi tipo no me gustan las pelis de perros tipo nose es raro un perro q hable	1	
A no ma 6 que padreNo pues viendolo así si seria mejor no tenerlo , tanto por bien de tus perros como de el mismoPero el perro que tiene  ?	1	
A q hora gilton se pasan si ese gil del homero staba mal día antes pa q le hacen cañar perros sta mal ese gil cm perro envenenado  .	1	
A ti te cuento los que sean Había una ves un perro llego otro y ya había dos perros fin	1	
Aaaa pero son lindos perros los que joden en mi puesto no pa perro sirben jajajaja	1	
Acodate que tenes una o varias ratas nose ah , puede ser eso , y tus perros nose pero hoy me levantaron porque estaban ladrando y llorandos re locos también , se pelean con el perro de fondo creo o con otros perros que pasan	1	
Además varias veces me ha tocado ver a ese perro y a otro más como mataban a perros de la calle o perros que su dueñ había dejado salir para que haga sus necesidades  .	1	
Ahh bueno o visye que a ustedes les encantan los perros con mi amiga , diganme donde carajo consigo ese perro jjajjaa	1	
Ahh si me fui a buscar al perro de mierda que se escapo de mi casa y estaba peleando con otros perros	1	
Ahiii es mas perro dicen que adan queriedose meter esos perros de los 18	1	
Ahora mis no tengo ni un perro que me ladre mi tampoco quiero nunca mas lleve una vida de perros	1	
Ahorita hablando de perros me acorde de ese rato cuando pegaste el grito cuando se acercó el perro	1	
Ahorita que estaba bañando a Ostin , recordé que anoche tuve un sueño , que yo estaba en el CVT y que yo bañaba a los perros grandes nada más y soñé que llegó un perro negro agresivo y que no se dejaba coger por nadie y que yo lo cogí con facilidad y lo bañé	1	
Ahí fui a ver a los perros y la perra ladraba y se choca la pared y el perro ladra y se hecha	1	
Amor aijue ahy dos perros dnd trabaja papa amor q semejante perro kasi m mordio uno y el otro m salto hasta ahora m salta mi corazon amor mal	1	
Amor vamos a salir mas tarde un perro se agarro a la bombis y de esos perros que se traban	1	
Andaba con un perro chico en los brazos y dos perros la empezaron a morder wn asi a atacar	1	
Apartd muchos perros y vss a tener el bb y lo tenes q vacunar al perro y todo	1	
Aparte los perros duermen con ella y qcy y hay olor a perro y yo no puedo con mi asqerosidad y no puedo dormir ahí , asco me da	1	
Arre pues te doy 10 hijos , un perro y un gato pues 2 perros y 2 gatos	1	
Arre pues te doy 10 hijos , un perro y un gato pues 2 perros y 2 gatos ,	1	
Arre pues te doy 10 hijos , un perro y un gato pues 2 perros y 2 gatos , siempre de voy a corresponder porque al final tu estas echa para mi y yo para ti	1	
Arre pues te doy 10 hijos , un perro y un gato pues 2 perros y 2 gatos , siempre de voy a corresponder porque al final tu estas echa para mi y yo para ti , solo quiero verte ya amor	1	
Arre pues te doy 10 hijos , un perro y un gato pues 2 perros y 2 gatos , siempre de voy a corresponder porque al final tu estas echa para mi y yo para ti , solo quiero verte ya amor a y otra cosa claro que te voy a permitir estar en mi vida por siempre nada me haría mas feliz que estar a tu lado porque eres la que siempre endulza mi sal , la que me alegra los días , la mujer que mas amo	1	
Arre pues te doy 10 hijos , un perro y un gato pues 2 perros y 2 gatos , siempre de voy a corresponder porque al final tu estas echa para mi y yo para ti , solo quiero verte ya anoe	1	
Así que por comerte a tu perro pd yo amo los perros y por ponerme de buen humor te odio	1	
Aun no me siento prepara para tener otro perro , veo muchos perros a todos los veo feos	1	
Avía un perro llego otro y ahora son dos dos perros v	1	
Avía una vez un perro Llego otro perroY havian 2 perros	1	
Ay no q perro así son esos perros amix	1	
Ay no te juro que desde ese día que me correteo el perro le tengo un miedo a los perros grandotes	1	
Ay perro ya le estas echando los perros a la paola	1	
#pera,	peras
Miren hice dulce de pera , mi suegra me mando muchss peras	1	
