#Sacramento,	California
#Portland,	Oregòn
#Glendale,	California
#Jacksonville,	Florida
#Shreveport,	Luisiana
#Lexington,	Kentucky
#Tulsa,	Oklahoma
#Glendale,	Arizona
#Tucson,	Arizona
#Mesa,	Arizona
#Spokane,	Washington
#Memphis,	Tennessee
#Oxnard,	California
#Tacoma,	Washington
#Lubbock,	Texas
#Worcester,	Massachusetts
#Miami,	Florida
#Cleveland,	Ohio
#Scottsdale,	Arizona
#Louisville,	Kentucky
#Stockton,	California
#Detroit,	Míchigan
#Phoenix,	Arizona
#Filadelfia,	Pensilvania
#Huntsville,	Alabama
#Cincinnati,	Ohio
#Honolulú,	Hawái
#Nashville,	Tennessee
#Oakland,	California
#Houston,	Texas
#Fremont,	California
#Orlando,	Florida
Estamos en Florida pero no vamos para Orlando	1	
#Arlington,	Texas
#Omaha,	Nebraska
#Laredo,	Texas
#Chicago,	Illinois
#Baltimore,	Maryland
#Anchorage,	Alaska
#Plano,	Texas
#Modesto,	California
#Garland,	Texas
#hermanos,	hermanas
Bueno nosotros somos 5 hermanos , mi abuelita crió a mis 2 hermanas las mayores y a mi , mi mamá se quedo con mi hermano y mi hermana la menor  .	2	
Ellas son hermanas , nosotros somos hermanos	2	
Otros se ponían de mal genio y habían otros que hablan mal de mi , la mujer que me llevaba me decía que no les prestara atención y entre mas me iba acercando los hermanos no les gustaba , entonces nos detuvimos y yo mire a dos hermanas de la i y esas dos hermanas me miraban muy mal y hablaban muy mal de mi , la mujer que me tenía cogido de la mano me  .	2	
Pues si señor mejor papa , mejor esposo , mejor hijo y pues hasta mejor persona q usted lo soy xq n es de ninguna agrado q yo estando lejos de mis hermanos y de mi familia me escriba una de mis hermanas diciéndome q la ayude xq su glorioso padre la voto de su casa crees q eso es bonito mijo	2	
2 hermanos uno falleció y 4 hermanas	1	
3 hermanas viven en buenos aires y 3 hermanos míos tambien	1	
3 hermanos , dos medias hermanas y 1 medio hermano	1	
3 hermanos amor que se enamoran de 3 hermanas	1	
3 hermanos son mayores y 1 hermano y mis dos hermanas son menores	1	
6 hermanos varones y 3 hermanas mujeres	1	
A las hermanas morenas del grupo no tienen prejuicios con los hermanos blancos	1	
A los hermanos los meten presos por tener relaciones con las hermanas , a mi me da igual	1	
A mis hermanos un perfume y a mi papa una camisa y mi mama y hermanas unas camisas y sha	1	
A todos bien Mis hermanas ya se juntaron Mis hermanos estudiando y mi padres muy bien	1	
Aaa que bueno mi nena con mi mama y mis hermanos y eso cuantas hermanas tiene mi niña	1	
Ademas escuchar mierda que le dicen a agus me re molesta xq no saves la cosas que dicen de el las hermanas pero no puedo decir nada xq ellos son hermanos y es problemas de hermabos	1	
Ah , pero mayor , yo tengo 3 hermanas menores y 3 medios hermanos menores	1	
Ah y los 3 hermanos son de los mismos padre y madre pero las chicas son hermanas de otros padres  ?	1	
Amor voy a bajar ayudarle a mis hermanas van hacer gorditas cm yo jjjSabias q hicieron q mis hermanos hicieran las paces X bebe q viene en camino jjjj	1	
Aver cuando nos conocemos sirve me llevo a mis hermanos para que nos presentes a tus hermanas jaja	1	
Brother es hermanos y como se dice hermanas	1	
Bueno en mi familia 3 hermanos mayores y 2 hermanas	1	
Buenos días hermanos alguien vino a llevar el parlante de aquí donde las hermanas traiganloo Yaaa lo necesitamos	1	
Con los hermanos nomas me hablo despues ah las hermanas ni las registró	1	
Con mi mama y mis hermanas y mis abuelitos y hector y sus hermanos jajajaja	1	
Cuando tus hermanos té abandonan , las hermanas abandonadas arrancan el día así  .	1	
De verdad puedes preguntar a mis hermanos o a mis hermanas	1	
Dicen unas tías hermanas de mi tío que son hermanos de mi madre	1	
Dos hermanas de 20 año y mis hermanos tienen 25	1	
Dos hermanas y como siete hermanos	1	
El plan es este fanny no sospecha y no sabe nada , mis hermanas le dijeron a fanny que hoy íbamos a hacer una reunión de hermanos y que a lo mejor me iba a quedar a dormir en casa de mi mamá , y mi mamá se va a quedar con fanny	1	
El se hizo cargo de mi , pero el se la pasaba en el campo laburando , para darme de comer ah mi y ah mis hermanos Xq mi hijo nunca se hizo cargo de mi y de mis 2 hermanas	1	
Em hermanos tengo 2 y hermanas 3	1	
En el negocio de mis papás , tienen una tienda de ropa y siempre estoy yo por que mis hermanas ya se casaron y mis hermanos trabajan así que la única que no hace nada ps soy yo , y vengo al negocio diario	1	
Eran dos hermanas y hermanas d religion esta lleno d hermanos ajuera cantando	1	
Es difícil que aveses los hermanos me dicen vamos para tal parte y conocemos hermanas yo lo primero que me llevo en la mente es que no creo que conosca a nadien como tu	1	
Es distraído y veo que algunos hermanos cuidan a sus hermanas y el no lo hace	1	
Es qye mis hermanas son por parte de papá y mis hermanos por parte de mamá pero de todos modos son mis herman @s	1	
Eso que los hermanos se acuestan con las hermanas	1	
Estamos organizando un churrasco con mis hermanas hoy al medio día y todos mis hermanos van avenir aver amistad padres	1	
Fuera de mi familia estaría comiendo cuca como un hp ya hasta me preñaria con lo que les gusta a mis hermanos la cuca y a mis hermanas	1	
Gracias , esq al vivir tanto tiempo con hermanas mayores y mi mama y mi abuela y mis hermanos q somos los pequeños hemos aprendido q a una mujer se la debe respetar y tratar como tal y sacarle una sonrisa no una lagrima	1	
Gracias hermanas por estar con ella , la verdad que los hermanos de Senda de amor son la familia que Rubitsa tiene	1	
Hahahaha no , mis hermanas si no salen casi y mis dos hermanos tampoco jajaja o sea el mayor muy rara vez y el otro si sale cada 8 o 15	1	
Hay varios hermanos para proteger a las hermanas	1	
Hla viejita hla hermanas y hermano feliz día hermanos	1	
Hola como estas te saludo por el día de los hermanos sabes que te quiero mucho y me alegra que seamos hermanas saludos para tus hijos y espero que vengas a visitarnos	1	
Hoy es el día de los hermanos y bueno no tengo hermanas pero si a ustedes  .	1	
Jajaja dunda , asi son los hermanos siempre pelean , y nosotras somos como hermanas  .	1	
Jajaja yo hermanas si no tengo hermanos si y Ps siendo el mayor ps toks ke me agan kaso jijiji	1	
#padrastro,	madrastra
Cuidado y la madrastra la ve querer mas que a ti y no tendra padrastro por que me le dire la verdad que fuiste mala	1	
Tu con madrastra y yo con padrastro jajaja	1	
#su,	su
#nieto,	nieta
Como pasa el tiempo yo tengo un nieto de 7 años y una nieta de 6 años	1	
Con mi nieta Abril y mi nieto Elias me encantaria viajar con ellos	1	
Es mi esposo con mi nieta Ella y otro es novio de maryan con mi nieto Tony los cuatitos	1	
Hija yessenia cisneros nietos fabhian pereira y amber veraza hija 30 / 11 / 88 nieto 04 / 06 / 2005 y la nieta el 24 / 11 / 2016	1	
Mi dios ya se quien es es nieto de Teresa primero se le murió una nieta	1	
Mi nieta Emma y mi sobrino nieto Ivo Que verdad tienes estos comentarios	1	
Mi nieta bella y mi nieto Lewis David , son unos bendecidos por Dios y por sus padres ,	1	
No lo armó el 8 / 12 con mi nieta ahora se agrega mi otro nieto	1	
Primero se le murió la nieta Rocío y ahora el nieto pobre tere se muere con esto ella lo cuidaba al chico	1	
Si , si esta , aunq explique a su nieto que también es ex de mi nieta , y que a ella le importan todas las personas del mundo , por mas que la hayan lastimado , el tbm es muy lindo aunq muchas veces no comprende que mi nieta es muy sensible y sentimental pero bueno ya sabe los niños de estos	1	
Tu nieta saca el dedo como mi nieto jajaja ja	1	
Va no era mi abuela pero ella me quiere como nieta desde que salia con su nieto  .	1	
Wauu otra nieta vas a tener como se siente tener varios nieto xq yo tengo una nos yebamos re mal jaja	1	
Y ahora tengo una nieta de 12 y un nieto de 10	1	
Y yo también jajaja que le decía es su nieto y me dijo si mi nieta pero le destapó la cara y era la cara de una vieja bien fea	1	
Yo me la gane dandole primero una nieta después 2 y ahora me pide un nieto pero asta ahi no llego	1	
#hombre,	mujer
Un hombre no necesita una mujer que sea la mejor , tampoco necesita una mujer con el físico mas envidiable , mucho menos la mas adinerada  .	63	
Las dos pero si es chupar pero no a un hombre si no a una mujer 24  .	43	
Ahí mi amor con esos mensajes me hace suspirar y me dan mas fuerzas para luchar por ti gracias por soportarme durante todo este tiempo , donde me he convertido en el hombre mas feliz del mundo somos privilegiados amor porque nunca pensé encontrar una mujer como usted flechaste mi corazón mi amor dime si con lo que le demuestro me siento cansado  ?	36	
El hombre propone y la mujer dispone	31	
amor , mi día no puede ser mejor , soy el hombre mas afortunado del mundo , al tener tan bella mujer , al tener a la mejor novia del mundo  .	23	
Esta información es para ti , mujer , para ti , hombre , es especialmente para que la compartas con tu esposa , con tus hijos , con todos aquéllos a quienes conozcas  .	21	
Q es lo primero q el hombre le mete a la mujer cuando se casan  ?	20	
Yo soy hombre de una sola mujer	20	
La mujer salió de la costilla del hombre  .	18	
Si tu eres mi hombre , y yó tu mujer  .	18	
Que es lo primero que el hombre le mete a la mujer cuando se casan  ?	17	
Se dirigía a la estación yendo con mucho cuidado para que nada le pasara cuando la luna estaba hermosa , rebuscó en su bolsillo sacando su móvil para captar el momento de aquella noche la imagen me pareció tan bonita porque no sabia porque le recordaba tanto a la pelinegra siguió caminando cuando al pasar por un callejón vio a un hombre forcejear con una mujer  .	17	
Soy hombre de una sola mujer	17	
Cuando una mujer marca la vida de un hombre , podrán llegar miles y esa seguirá siendo su favorita , SU MUJER  .	15	
Una mujer hace lo que el hombre no puede Isabel Allende  .	14	
y trankila que de mi parteas no te voy a molestar para q continúes tu vida con la persona que te valore ya q yo no pude valorarte y le doy un consejo nunca dejé que otro hombre te pege por q una mujer como usted no se lo merece  .	14	
La razón por la que Dios creó primero al hombre y luego a la mujer , es porque lo bueno se hace esperar  .	13	
Quiero que sepas que me siento el hombre más afortunado por tenerte a mi lado , eres para mí la mujer más hermosa y especial del mundo y me siento realmente afortunado y bendecido de tenerte conmigo  .	13	
No tiene nada que agradecer mi amor yo me enamore de ti y todo lo que me brindo es con mucho amor y cariño soy un hombre inmensamente feliz porque tengo que mi lado una gran mujer no te quiero perder nunca sabes  ?	12	
Cuando un hombre ama de verdad a una mujer se convierte en su debilidad  .	11	
Tu me haces una mujer feliz , no hay duda que tu eras el hombre que estaba esperando  .	11	
VALE LA PENA LEERLO No puedo pedirte que te enamores de una extraña , eso es absurdo ; pero , quiero pedirte que , al momento de entregar tu corazón , lo hagas a sabiendo de que quien está a tu lado , es una mujer que sabrá amarte y apreciarte por lo hombre que eres  .	11	
ser bonita , Ni buena mujer mantiene a un hombre a tu lado  .	11	
Adelante de los pasos de un hombre siempre van los pasos de una mujer Elena Garro  .	10	
Enamórate de una mujer , para el cual tú seas el único hombre en este mundo ; y , que sea capaz de construirte un castillo , aunque solo tenga un lápiz y papel  .	10	
La locura de un hombre es el arte de una mujer  .	10	
Lo que más deseo al regresar es volver a sentir tu olor , tus caricias , tu cabello entre mis dedos , vuelvo a decirte que de verdad soy el hombre más afortunado por tener a una mujer como tú conmigo  .	10	
Mi amor quiero que tenga un hermosa noche quiero decirle en este nuevo mensaje que la amo demasiado que me siento feliz de haberte conocido eres una bendición de Dios , eres lo que todo hombre anhela tener , para mi eres perfecta , una maravillosa mujer gracias por ser tan especial conmigo , gracias por ser tan linda y entregarme su amor a diario no podría explicar lo que siento por ti mi amor es tan hermoso lo que siento que no quiero dejar de sientirlo	10	
Recuerda en todo momento que eres tú el ser que me llena la vida de alegrías , quien me hace ser la mujer más afortunada del planeta por tener a un excelente hombre como novio , que tú eres para mi la bendición más linda  .	10	
no como el hombre que cuando mira a la mujer ve lo lindo , lo bonito , lo satisfactorio lo que le crea algo en su carne ese es el hombre  .	10	
Cuando una mujer se enamora perdidamente de un hombre , la única persona capaz de arruinar ese amor , es ese mismo hombre  .	9	
Es un manual de uso para el hombre , y la mujer , sin prejuicios  .	9	
Soy mujer de un solo hombre	9	
Dicen por hay el hombre llega hasta donde la mujer se lo permita  .	8	
El problema es que la mujer piensa que el hombre va a cambiar  .	8	
La mujer propone y el hombre dispone	8	
La mujer salio de la costilla del hombre , no de los pies para ser pisoteada , ni de la cabeza para ser superior  .	8	
No existe el hombre perfecto , no existe la mujer perfecta  .	8	
Prostituta eso digaselo a una mujer no a un hombre lk	8	
Qué es lo primero qué el hombre le mete a la mujer cuándo se casan  ?	8	
Si tu eres mi hombre , y yo tu mujer  .	8	
Un hombre no cambia ni por una mujer ni por sus hijos  .	8	
Cuando la mano de un hombre toca la mano de una mujer , ambas tocan la eternidad  .	7	
DESCARGA GRATIS LA VERDAD De por qué parece tan COMPLICADO para un hombre seducir a la mujer que le gusta y por que realmente no lo es  !	7	
El hombre al escuchar a su mujer que abandonaba la casa con la niña , se enfureció tanto que la amenazó con prenderle fuego a toda la casa con ellas dentro si trataban de salir de allí  .	7	
La mujer al ver como el hombre agitaba una lámpara de aceite y la acercaba peligrosamente a las cortinas , decidió plantarle cara por primera vez en su vida y le comenzó a empujar mientras le gritaba fuertemente  .	7	
La mujer es mujer , No La trates cómo un hombre  .	7	
No se trata de ser la primera o la última mujer en la vida de un hombre  .	7	
Y es que una mujer con vida propia no desperdicia el tiempo tratando de cambiar a un hombre para entonces ser feliz , ella es feliz por si misma con el o sin el  .	7	
1-Puees técnicamente no soy mujer y pues no hay algo que me moleste de ser hombre 2-Mi hermana 3-Nunca lo había pensado  .	6	
#hijastro,	hijastra
#esposo,	esposa
Gracias mi amor por hacerme feliz por estar siempre conmigo gracias por tus consejos ánimos y tu amor eres y serás lo mejor , mi gran bendición y quiero que este amor siempre perdure , porque quiero ser tu esposa y que tu seas mi esposo mi futuro es contigo , siempre juntos mi amor , mi felicidad eres y serás siempre tu , nos hemos enojado pero siempre estamos juntos encontrando soluciones , porque Te Amo Mi Amor y Siempre Te Voy Amar Eres Único Mi Amor Tu Mio Y Yo Tuya I LOVE YOU FOREVER	9	
Hay mi osito no sabes como me alegro que le guste estar conmigo enserio me pone muy feliz Tranquilo mi baby ya te dije que no me agradezcas , enserio soy muy pero muy feliz a tu lado Si amor soy muy feliz de tener la gran suerte de poder tenerte a mi lado mi corazón Y si mi corazón tu eres la unica que lo hace y lo hara Mi esposo Si mi corazón , se tiene que cumplir porque yo quiero ser tu esposa mi corazón Si mi vida , nos tenemos que casar	6	
Cuando tú seas mi esposa , realmente llegarás a conocerme ; seré para ti un esposo fiel , sincero y lleno de amor  .	5	
Estaba viendo caer en tentación y woooo Damian despertó y su esposa wataba con e esposo de Carolina en el baño bien apasionados y pues les mataron la pasión	4	
Erick Vas a ver que saldremos adelante amor tomafos de las manos , somos fuertes y vamos a lograr nuestro objetivo de tener una familia y vivir juntos casarnos y vivir juntos , Quiero ser tu esposa amor y tu mi esposo Erick , tener dos gorditos	3	
Estaba viendo un H ntr donde el esposo es ciego y la esposa aprovecha y lo hace con el vecino en frente de su esposo , la mujer era chubby y de pelo corto	3	
Hay mi osito no sabes como me alegro que le guste estar conmigo enserio me pone muy feliz Tranquilo mi baby ya te dije que no me agradezcas , enserio soy muy pero muy feliz a tu lado Si amor soy muy feliz de tener la gran suerte de poder tenerte a mi lado mi corazón Y si mi corazón tu eres la unica que lo hace y lo hara Mi esposo Si mi corazón , se tiene que cumplir porque yo quiero ser tu esposa mi corazón	3	
Mira Nerleys Guzman la historia de John targaryen hijo de lyanna quien era hermana de la esposa de ned Stark y cuyo esposo de lyanna era	3	
Rosa-yo Mi esposo , Dylan y ChristopherNegra- yo Mi esposa , Dylan y ChristopherVerde- yo soy Christopher Azul- Yo soy Dylan	3	
75 aproximadamente pero muy guapo y una sonrisa encantadora el lavando su auto y yo me enamore de esa mirada morbosa yo traía un shorts muy pequeño por lo que al agacharme se me marcaba la punta de la nalga el sonreía y me saludo salio su esposa y empezamos a platicar nos hicimos amigos al pasar las semanas llego mi esposo y organizamos una cena los cuatro en casa mía esa noche tomamos tanto que no sabíamos ni lo que decíamos ni lo que asiamos  .	2	
A mi gusto el pues para que se une a una persona si va a seguir de loko mejor soltero y que se divierta con quien quiera y por otro lado la esposa cornuda por algo también la engaña el esposo hay q ver que pasa en la relación como ven  !	2	
Acuerdese cuando me empezaron a decir el nuevo q utt me puso is q esteban y eramos los 2 diciendo q utt era mi esposa y yo su esposo  !	2	
Bebe tengo miedo enserio son celos creo noc q es lo que siento bronca también Quiero ser tu primer y último novio que tengas amor ya después voy a ser tu esposo y vos mi esposa vamos a tener una familia bien bonita como siempre dijimos todo con la ayuda de Dios y la fe nuestra sos todo lo que tengo en esta vida amor sentite importante	2	
Día muy especial , hay Poder en una esposa que ora a Dios por el cambio en su esposo  .	2	
El esposo esta mirando televisión y grita no entres ala iglesia pendejo Nooo , la esposa que esta en la cosina pregunta que ves mi amor  ?	2	
Eras real Tus ojos hacen parecer que el Sol no tiene brillo te vas a sorprender cuando te regale un anillo Tu como mi esposa y yo como tu esposo	2	
Espera todo mundo me mando a la verga pero tu eres mi esposa y yo soy tu único esposo	2	
Esposa siempre te hee dicho Ven esposa andale y dices estas bien lejos esposo y así	2	
Estos 5 años que llevamos de novios han sido la experiencia más grande que he podido tener , puesto que me ha fortalecido como persona , como humano y me visiona como la futura esposa que quiero ser teniéndote como mi esposo  .	2	
Euno esposo ya quiero que su esposa abra esos ojitos que tanto lo enamoran día aria	2	
Jajajaja será por que tendremos camisas así esposa y que a la mía le pondré esposo de Paola	2	
Mi esposa como conoce a tu esposo	2	
Mi esposa como conoce a tu esposo se	2	
Mi esposa como conoce a tu esposo según tu y como se llama tu esposo	2	
Mi esposa ya volvió el esposo	2	
Mi futuro esposo va a tener la mejor esposa que habría deseado	2	
No , creo que a su esposa le gustaría ver esas fot cariñosas abrazandole tú , a su esposo	2	
Rosa-yo Mi esposo , Dylan y ChristopherNegra- yo Mi esposa , Dylan y Christopher	2	
Se a dicho que en un teatro los días de lluvia el fantasma de una bailarina rondaba ese mismo lugar el nombre de la bailarina era ELIZABETH la joven murió siendo asesinada por su propio esposo el ya difunto al no poder resistir aber matado a su esposa se quito la vida aorcandoce en dónde fue la muerte de la joven bailarina fue en el teatro donde daba sus show desde entonces la joven Elizabeth ronda en el teatro los días de tormenta	2	
Se que nunca me quieres decir cuando te sientes mal amor pero debes decirme mi amor soy tu esposa y debo saber cuando algo te duelw o te sientas mal esposo	2	
Si mi cuñado y su esposa nunca estan y mi esposo Esta en casa asta las tres y después ando con el en el taci y así	2	
Te amo esposo mio q nada nos afecte como tu esposa nunca te dejare solo	2	
Te amo mucho mi amor Eres el mejor esposo te amo me ases la esposa mas Feliz del Mundo	2	
Y siempre sere tuya porque yo ya soy tu esposa y tu mi esposo y sobre todo te amo y te amare siempre solo quiero que sigas a mi lado siempre	2	
Yo tengo a mi esposo y me pongo en el lugar de tu esposa y no me gustaría tener problemas  .	2	
/derrochar felicidad porque es su esposa y le va a demostrar a todos que ya tiene dueño , esposo  .	1	
10 Pero a los que ya están casados , les doy este mandato , que no es mío , sino del Señor que la esposa no se separe de su esposo  .	1	
50- tengo mi esposa bn besa y esposo	1	
A charal le puedes decir esposo y yo te apuesto que a alguna vieja le dijo esposa y te pusieras bien pinche loca	1	
A la ves de sentimientos bonitos y de ñapa ti esposo esta ganado contigo x tener el privilegio de tenerte y saber q la esposa q tiene le es fiel	1	
A no perdón a tu esposa X ella dice k eres su esposo y k son muy felices me da gusto k seas feliz de verdad echale ganas y hoja esta persona sea la indicada yo no kiero k ami me hagas un desmadre cuando me veas con otro chavo va yo kiero quedar bien con tigo y hasta y cuídate y lo k paso entre nosotros k quede entre nosotros X favor	1	
A nombre de mi esposo si pudieras meterle un papel que diga de tu esposa con todo el amor Feliz Navidad y Año Nuevo Perdona el Retraso	1	
Aah es que la esposa del primo de mi esposo se le adelanto su parto y no me hicieron baby shower y no tiene ropita  .	1	
Acaso hay un esposo q viva lejos de su esposa	1	
Ademas ya me a pasado con dos personas eso me caían y me decían que andaban solos y mentiras uno se cayo porq la mujer misma me escribió a mi a pararme y a decirme roba maridos y le dije que que pena que yo nop sabia y el la negaba y le mande las conversaciones y el otro fue que me vi a la esposa fotos y comentarios de feliz y enamorada del esposo y le mande eso a el y ya que mas podía decir Se estribaron ahí los dos por perros y mentirosos	1	
Afortunado tu esposo por tener a una esposa tan bonita	1	
Ah y no soño conmigooo Cual de one tiene que decir si futuro esposo , y entonces yo le digo ah si futura esposa yo aquí me la violo bien rico , mentiras no jajaja	1	
Ahi pregunta x jhan el es mi esposo yo soy su esposa amigo	1	
Ahora del beniano ese su chica esposa q miércoles sera me dijo deja de molestarle a mi esposo y el me habla pero ni amigos somos	1	
Amado mio soy tu futura esposa y tu mi futuro esposo mi rey te amooo te voya cuidar en la salut y la enfermedad mi dulsurita	1	
#abuelo,	abuela
Quiero agradecer a todo aquel que lee este comectario medio largo , Y quiero agradecerle a todos , TODOS Al usuario que leyó todo , a su mamá , a su papá , a su abuela , a su abuelo , a su perro , a su gato y si tiene ardilla , también  .	17	
Esq mi mamá me dijo que paso algo con mi abuela así que iré a visitarla porq ya q es la única abuela q tengo y me preocupa mucho ya tuve suficiente con lo de mi abuelo quería encontrarme contigo pero ufff mañana podemos si quieres  .	9	
Hoy hace 12 años que te fuiste , me dejaste sola y desde ese día , cada día te necesito más y más te extraño tanto abuela , mi vida se acabó cuando te fuiste al cielo con mi abuelo  .	6	
Siii d vdd primero mi abuela y ahora mi abuelo	4	
suena el phone de mi nono nono abuelo en italiano v Mi abuela COMO SE ATIENDE ESTA COSA  ?	4	
Buenos dale abuelo chauvinismo besos mandarle saludos a la abuela chauvinismo	3	
Esq mi mamá me dijo que paso algo con mi abuela así que iré a visitarla porq ya q es la única abuela q tengo y me preocupa mucho ya tuve suficiente con lo de mi abuelo	3	
Estaba caminando por el centro con mis abuelos y cuando yo estaba hablando con mi abuelo escucho que mi abuela estaba cantando una canción de maluma y estuvo todo el camino cantando esa misma canción hasta que llegamos a pirulo alguien que me mate por favor	3	
Gracias a todos los que estuvieron con mi negra hermosa , en especial a la madrina x la torta y los regalitos , Carla Ozcoide a la abuela Alicia Neves , Noelia Caggiano , abuelo ale  .	3	
Hola tíagracias tía igualmente feliz año Dios me los bendiga siempre a ti , a mi abuela , a mi primito , a mi abuelo  .	3	
Jajaj pues si a lo mejor si mas que mi prometido llega en 3 días Jaja no quieres ser su abuelo pero si su abuela  ?	3	
Las personas que quiero que sean parte de mi 2018 son Mi mamá , mi abuela , mi hermano , mi hermana mi abuelo , mi mejor amiga Hsue , mi mejor amigo Jared , mis tías y tíos	3	
Las personas que quiero que sean parte de mi 2018 son Mi mamá , mi abuela , mi hermano , mi hermana mi abuelo , mi mejor amiga Hsue , mi mejor amigo Jared , mis tías y tíos Los amo gracias por todo	3	
No se q ess peor mi abuela roncando o mi abuelo escuchando musica del año del pedo	3	
Que mi abuela concha venia de un lugar llamado rancho azul yi abuelo de	3	
Volví a cocinar por que mis tíos salieron con mis primos y mi abuela , después llego mi abuelo y cociné para el	3	
Y se que es daño porque aunque las personas se hagan fuertes no todo el tiempo pueden estar asi , en algún momento las personas se tienen que doblar ante alguien como yo lo hice con mi abuela cuando recordamos a mi abuelo  !	3	
Asi q se me va a ir mi abuela y despues a mi abuelo	2	
Ayyyyy , ayer mi abuela me dijo a mi abuelo , que necesitas mi amooorrr	2	
Con mi abuela te amoo , lo mejor del mundo no sale mi abuelo pero esta también va para el tambien	2	
Cuando vas a ver a tus abuelos y estan a la gresca jajajaNunca vi a mi abuela llamar cabron a mi abuelo	2	
El nombre de mi abuelo y de mi abuela	2	
Jajaja bueno después hablamos iré con mi abuela a pagar unos resivos y averiguar cuando entregan las senisas de mi abuelo Cuídate y muchas gracias por la platica	2	
Jajajaja pues , verás , mi abuela pues se casó , mi abuelo de sangre por decirlo de algun modo , pues tuvo 2 hijos con mi abuela , mi papá y un tío , después se separaron , mi abuelo es demasiado volado Daniela , demasiado , él a tenido como 5 matrimonios , el que tuvo con mi abuela fue el primero , con decirte que mi papá tiene una media hermana de 10 años	2	
Kiuvo , casi se me olvida escribirle , mire para las 60 tarjetas ya sean como las de mi abuelo 7 14cms o como las de mi abuela 9 14cms en el papel nacarado le cuestan 60  .	2	
Le dije por ke y dijo que me voy a lo de mi abuela por que ya le dieron el alta mi abuelo	2	
Llama la andrea que si la puefen ir a buscar q esta re enferma pero se le escuchaba re bien la voz , mi abuelo que le estaba agarrando lo mismo q cuando se pone duroo , mi abuela q discutio con todos por que nadie podia ir a buscarla y tiene razpn mi vieja no todos pueden andar atras de la otras cuando se le ocurra , la loca q anda loca	2	
Lo se amor lo se pero bueno es mi abuela y no hay pedo pero mi abuelo es otra cosa	2	
Me cago en su abuelo filibustero , también en su abuela aborígen  .	2	
Me entere que mi abuelo me el único que estaba vivo maltrataba a mi abuela y abandono a mi mamá y abuela  .	2	
Me levante mal porque mi abuela es re rompe pelotas y escuche que le gritaba a mi abuelo por el perro y me desperté mal	2	
Me llegó tanto ver esto Si seguirías aca , ya hubieran cumplido 40 años con la abuela Pero ella & todos nosotros te llevamos siempre en nuestro corazón mi abuelo hermoso Te amamos nuestro hermoso angelito	2	
Mi abuela esta vivo y mi abuelo no me quiere	2	
Mi abuela tiene que cuidar a los nenes y mu abuelo se esta x ir a trabajar	2	
Mi abuelo ya le dijo a mi abuela que mañana vendré a ayudarle porque quiere acomodar no se en el fondo	2	
Mi mamá Mi papa Mi abuela Mi Tía Yo Mi hermano Mi abuelo Y Mi esposo we	2	
Nada acostado Mi abuelo esta afuera en el carro mi mamá se va ir con mi abuela	2	
Nena mi abuelo tambien es afiliado junto con mi abuela y sus hijos y yo puedo pasar y solo pago lo mínimo	2	
Perdon la fui a acompañar a mi abuela a q se tome el colectivo xq se peleo con mi abuelo	2	
Pero piensa que tu abuela junto con tu abuelo están allá arriba para protegerte , guiarte y cuidarte , y lo mas importante que siempre estarán en tu corazón  .	2	
Que después ella le cuando le compre al abuelo le devuelve ah a la abuela	2	
Que los 15 de karla y que aprobecharon el momento y mi abuela esta diciendo que el caracter de mi abuelo	2	
Quiero agradecer a todo aquel que lee este comentario medio largo , Y quiero agradecerle a todos , TODOSAl usuario que leyó todo , a su mamá , a su papá , a su abuela , a su abuelo , a su perro	2	
Regalo para bauti de parte de su abuelo cristian y su abuela Andrea  .	2	
Sale de si casa , con su hermoso perro , que como obediente dueño saca a su perro cada noche , nos miramos a los ojos profundamente , pero de nuestras bocas no salieron ninguna palabra , el aparto su vista de la mia y siguio su camino a donde siempre saca a su perro , sigo caminando a la casa de mi abuela con algo de indiferencia , pero me encuentro con mi abuelo saliendo de la casa de mi abuela con Mateo , mi perro , yo le pregunto  .	2	
Si mi crush es abuelo , eso significa que yo tambien soy abuela  ?	2	
Tía María que dice papi que dijo el que abuela no dejo ir abuelo a	2	
Una Red , yo y santi un AriZona Pregúntale al chico así tal cual el nombre , fer hershys bites , abuelo unos cacahuates mafer y abuela unos polvorones	2	
Vero le puede decir a mi tio Lenin que vaya donde mi abuela y busque la cédula de mi abuelo Saúl y	2	
Y al cementerio voy a visitarlo a mi papá , mi abuela q era cmo mi mamá , mi otro abuelo y mi hi	2	
#novio,	novia
Andrea Yo seré tu novia por 30 días y tuserás mi novio  .	36	
Una novia le dice a su novio  .	14	
No sé qué hice para merecer todo esto , que vos seas mi novio , ser yo tu reina , tu nena , tu novia , la que día a día trata de hacerte feliz como vos lo hacés conmigo  .	13	
quiero que apesar de todo eso estar contigo Eres un chavo super lindo de verdad que la que sea tu novia sera la niña mas afortunada de tenerte a ti como novio  .	13	
y pues nos gustamos pero el tenia novia era mi primay no nos llevabamos y yo tenia novio era su mejor amigo Total que nos quedamos asi  .	9	
Si soy un mandarina es por q no quiero hacerte quedar en frente de todo y q digan q soy un novio rebelde y q no le hace caso a lo q dice su novia ni mucho menos q no te respeto  .	8	
Buenas noches amorcito mio quiero hacerle saber en este mensaje que te prometo que voy a luchar por ti mi vida , por nuestra relación Prometo hacerte feliz sin importar que Ojalá la vida me dure tanto como para poder estar contigo siempre , siendo felices , incluso después de esta vida porque de verdad quiero tenerlo todo contigo mi vida eres la mejor novia del mundo gracias por haberme aceptado como su novio yo todo feito	6	
Buenas noches amorcito mio quiero hacerle saber en este mensaje que te prometo que voy a luchar por ti mi vida , por nuestra relación Prometo hacerte feliz sin importar que Ojalá la vida me dure tanto como para poder estar contigo siempre , siendo felices , incluso después de esta vida porque de verdad quiero tenerlo todo contigo mi vida eres la mejor novia del mundo gracias por haberme aceptado como su novio yo todo feito algo que jamas a usted se le paso por la mente	6	
Encuentra a la novia M y al novio A	6	
Esto me hizo recordar cuando todo empezó , hablabamos todo el tiempo y cuando no hablabamos se notaba que nos hacíamos falta , todas esas noches que me llamabas y hablabamos horas hasta la madrugada , que le hablabas a los demás de mí , me presentabas como tu novia y yo toda orgullosa de mi novio  .	6	
Justo cuando ya termina con su novia yo ya tengo novio N	6	
Que de verdad estoy muy feliz y contento de ser tu novio , que me enorgullece que seas mi novia , onda alguien me pregunta sobre vos y yo saco pecho y les digo , ella , ella es mi novia , y es la mejor y la re amo  .	6	
Soy tu novia , tu mejor amiga y tu cajita de secretos Lindo día al mejor novio de todos  .	6	
Muchas gracias por aceptar ser mi novia y por concederme el gran honor de ser tu novio  .	5	
Se que no fui la mejor novia para el pero el tampoco fue el mejor novio pero aun así lo amo y se que cometi un error al a ver puesto algo que no le gusto pero hay cosas en las cuales el también me iso des confiar en y x eso	5	
Ser un Buen novio no se trata de lo q hagas Cuando estas con tu novia , SINO de lo q hagas Cuando no estas con ella  .	5	
Tengo un maravilloso novio y yo soy una pésima novia	5	
dejarías a tu novia o Por mi si porque no tengo novio 14  .	5	
Aiññ pues eso suena muy lindo ee que afortunada es tu novia de tener al mejor novio osea tu Hay provecho baby	4	
Amor yo se que siempre me demuestras lo mucho que me amas y por eso sabes muy bien que no eres un mal novio , al contrario eres un novio increíble y maravilloso me complementas , eres el mejor novio y tienes a la mejor novia y quizas si amor nos acordaremos mas de nuestras fallas pero estamos los dos para poder ya no volverlas a cometer	4	
Bebe hoy 14 / 02 / 18 se cumple tres años de ser la persona mas feliz ya que te hiciste mi novio así como yo tu novia soy tan feliz a tu lado que no pienso dejarte nunca siempre estaré aquí a tu lado apoyandote en todo momento no pienso dejarte soy mas que feliz estando contigo me siento tan afortunada de ser tu novia  .	4	
De verdad amo como eres bebé no entiendo si eres un chavo super lindo y eres el novio que toda chava quiere tener no tienes novia  .	4	
Jaja no hay no existe Pos ve guardando memoria en tu cel para tomarnos fotos jeje Quiero probar si sabes besar , io te digo jeje Q bien q quieres seguir estudiando , hechale mas ganas jeje Raios xk te gusta el calor jaja si el frio es para q te abraze alguien como io a ti jeje Jaja tan shica y te dejan tener novio , a mi pz creo q aun no me dejan tener novia pero las eh tendido a escondidas jeje v Oie jeje , q es mejoro  !	4	
Jazmín Yo seré tu novia por 30 días y tu serás mi novio  .	4	
Lo malo es que tiene novia , pero me pregunto tenés novio  ?	4	
Mi amor Te quiero tanto tanto Eres el mejor novio No me arrepiento de ser tu novia	4	
Mi novia como duerme ah pero como la ama su novio	4	
Noupe Tú crees que todo novio le mira el tracero a su novia  ?	4	
Para siempre solos tu y yo o al revés si quieres yo y tu yo tu novio y tu mi novia	4	
Se que no fui la mejor novia para el pero el tampoco fue el mejor novio pero aun así lo amo y se que cometi un error al a ver puesto algo que no le gusto pero hay cosas en las cuales el también me iso des confiar en el se	4	
Tu sabes que yo tengo novia y yo se que ti tienes novio  .	4	
Tu tienes novio , y yo tengo novia  .	4	
Usted no quiere novio yo ya no quiero novia pero quiero estar con usted	4	
Y mi sobrino es la única novia que ha tenido y ella el único novio este año tenían planeado casarse  .	4	
Y pues luego como que pensé las cosas y dije mejor no jaja por que tal vez va a parecer que estoy ardida por que ya no es mi novio Osea ese día llore , osea no llore por que tenia novia o tal vez si pero pues no fue como uff ya tiene novia voy a llorar no  !	4	
Ya se que tiene novio y creo que tu también novia pero hacerle eso  !	4	
Yo como novia jamas pelearía con una mujer porque me quiere quitar a mi novio  .	4	
Yo soy su novio y tu si novia sale  ?	4	
estés en chile o estemos lejos encerio me gustaría ser tu novio y la verdad me encantaría que seas mi novia  .	4	
Ademas tu tienes novio por eso te llamas novia de yael mp	3	
Aiññ pues eso suena muy lindo ee que afortunada es tu novia de tener al mejor novio osea tu	3	
Amor yo se que siempre me demuestras lo mucho que me amas y por eso sabes muy bien que no eres un mal novio , al contrario eres un novio increíble y maravilloso me complementas , eres el mejor novio y tienes a la mejor novia	3	
Awwwwwww amor si yo soy el mejor novio del mundo mi bebe necesito ala mejor novia del mundo a mi lado y gracias adios esa mamasita divina la tengo a mi lado mi reina divina	3	
Awwwwwww amor si yo soy el mejor novio del mundo mi bebe necesito ala mejor novia del mundo a mi lado y gracias adios esa mamasita divina la tengo a mi lado mi reina divina y yo siempre estare igual para lo que necesites mi peleona	3	
Awwwwwww amor si yo soy el mejor novio del mundo mi bebe necesito ala mejor novia del mundo a mi lado y gracias adios esa mamasita divina la tengo a mi lado mi reina divina y yo siempre estare igual para lo que necesites mi peleona y eso esta mas que claro en nuestras vidas mi peuche	3	
Ba yo igual cm el q estoy d novia a hora era mi novio de ante pero igual no m  .	3	
Bueno amor aquí va otro quiero que sepa que usted es una mujer maravillosa con unos excelentes valores que tiene sus metas claras como no amarla si eres todo lo que buscaba , eres lo mejor que me a pasado , la reina de mi vida , de mi corazón y de mi alma eres una mujer encantadora que todo hombre desearía tener pero le agradezco que me aya aceptado como su novio eres la mejor novia del mundo	3	
Bueno fui yo la que empezó Es que hay una chava que le gusta mi novio y a pesar de que sabe que soy su novia lo sigue pretendiendo	3	
Bueno mi historia empieza asi en 2012 conocí al hermano de una amiga actual inombrable , nos saludamos y quedo hay , el sábado de ese mismo año salimos a bailar con unas amigas y oh sorpresa estaba el , pero no estaba solo , estaba con la novia , a lo que mi mente dijo bueno esta de novio , ya fue  .	3	
Cada regalo , cada sorpresa , todo , todo , todo lo que te doy y todo lo que hago por vos lo hago por amor , ese amor único e incondicional que te tengo , se que no soy el mejor novio del mundo , pero por vos lo intento e intento ser cada día mejor novio solo por vos que sos la mejor novia y te mereces que te trate como una reina , como mi reina 3 , sos lo mejor que me paso en la vida ,	3	
#abuelo,	abuela
Quiero agradecer a todo aquel que lee este comectario medio largo , Y quiero agradecerle a todos , TODOS Al usuario que leyó todo , a su mamá , a su papá , a su abuela , a su abuelo , a su perro , a su gato y si tiene ardilla , también  .	17	
Esq mi mamá me dijo que paso algo con mi abuela así que iré a visitarla porq ya q es la única abuela q tengo y me preocupa mucho ya tuve suficiente con lo de mi abuelo quería encontrarme contigo pero ufff mañana podemos si quieres  .	9	
Hoy hace 12 años que te fuiste , me dejaste sola y desde ese día , cada día te necesito más y más te extraño tanto abuela , mi vida se acabó cuando te fuiste al cielo con mi abuelo  .	6	
Siii d vdd primero mi abuela y ahora mi abuelo	4	
suena el phone de mi nono nono abuelo en italiano v Mi abuela COMO SE ATIENDE ESTA COSA  ?	4	
Buenos dale abuelo chauvinismo besos mandarle saludos a la abuela chauvinismo	3	
Esq mi mamá me dijo que paso algo con mi abuela así que iré a visitarla porq ya q es la única abuela q tengo y me preocupa mucho ya tuve suficiente con lo de mi abuelo	3	
Estaba caminando por el centro con mis abuelos y cuando yo estaba hablando con mi abuelo escucho que mi abuela estaba cantando una canción de maluma y estuvo todo el camino cantando esa misma canción hasta que llegamos a pirulo alguien que me mate por favor	3	
Gracias a todos los que estuvieron con mi negra hermosa , en especial a la madrina x la torta y los regalitos , Carla Ozcoide a la abuela Alicia Neves , Noelia Caggiano , abuelo ale  .	3	
Hola tíagracias tía igualmente feliz año Dios me los bendiga siempre a ti , a mi abuela , a mi primito , a mi abuelo  .	3	
Jajaj pues si a lo mejor si mas que mi prometido llega en 3 días Jaja no quieres ser su abuelo pero si su abuela  ?	3	
Las personas que quiero que sean parte de mi 2018 son Mi mamá , mi abuela , mi hermano , mi hermana mi abuelo , mi mejor amiga Hsue , mi mejor amigo Jared , mis tías y tíos	3	
Las personas que quiero que sean parte de mi 2018 son Mi mamá , mi abuela , mi hermano , mi hermana mi abuelo , mi mejor amiga Hsue , mi mejor amigo Jared , mis tías y tíos Los amo gracias por todo	3	
No se q ess peor mi abuela roncando o mi abuelo escuchando musica del año del pedo	3	
Que mi abuela concha venia de un lugar llamado rancho azul yi abuelo de	3	
Volví a cocinar por que mis tíos salieron con mis primos y mi abuela , después llego mi abuelo y cociné para el	3	
Y se que es daño porque aunque las personas se hagan fuertes no todo el tiempo pueden estar asi , en algún momento las personas se tienen que doblar ante alguien como yo lo hice con mi abuela cuando recordamos a mi abuelo  !	3	
Asi q se me va a ir mi abuela y despues a mi abuelo	2	
Ayyyyy , ayer mi abuela me dijo a mi abuelo , que necesitas mi amooorrr	2	
Con mi abuela te amoo , lo mejor del mundo no sale mi abuelo pero esta también va para el tambien	2	
Cuando vas a ver a tus abuelos y estan a la gresca jajajaNunca vi a mi abuela llamar cabron a mi abuelo	2	
El nombre de mi abuelo y de mi abuela	2	
Jajaja bueno después hablamos iré con mi abuela a pagar unos resivos y averiguar cuando entregan las senisas de mi abuelo Cuídate y muchas gracias por la platica	2	
Jajajaja pues , verás , mi abuela pues se casó , mi abuelo de sangre por decirlo de algun modo , pues tuvo 2 hijos con mi abuela , mi papá y un tío , después se separaron , mi abuelo es demasiado volado Daniela , demasiado , él a tenido como 5 matrimonios , el que tuvo con mi abuela fue el primero , con decirte que mi papá tiene una media hermana de 10 años	2	
Kiuvo , casi se me olvida escribirle , mire para las 60 tarjetas ya sean como las de mi abuelo 7 14cms o como las de mi abuela 9 14cms en el papel nacarado le cuestan 60  .	2	
Le dije por ke y dijo que me voy a lo de mi abuela por que ya le dieron el alta mi abuelo	2	
Llama la andrea que si la puefen ir a buscar q esta re enferma pero se le escuchaba re bien la voz , mi abuelo que le estaba agarrando lo mismo q cuando se pone duroo , mi abuela q discutio con todos por que nadie podia ir a buscarla y tiene razpn mi vieja no todos pueden andar atras de la otras cuando se le ocurra , la loca q anda loca	2	
Lo se amor lo se pero bueno es mi abuela y no hay pedo pero mi abuelo es otra cosa	2	
Me cago en su abuelo filibustero , también en su abuela aborígen  .	2	
Me entere que mi abuelo me el único que estaba vivo maltrataba a mi abuela y abandono a mi mamá y abuela  .	2	
Me levante mal porque mi abuela es re rompe pelotas y escuche que le gritaba a mi abuelo por el perro y me desperté mal	2	
Me llegó tanto ver esto Si seguirías aca , ya hubieran cumplido 40 años con la abuela Pero ella & todos nosotros te llevamos siempre en nuestro corazón mi abuelo hermoso Te amamos nuestro hermoso angelito	2	
Mi abuela esta vivo y mi abuelo no me quiere	2	
Mi abuela tiene que cuidar a los nenes y mu abuelo se esta x ir a trabajar	2	
Mi abuelo ya le dijo a mi abuela que mañana vendré a ayudarle porque quiere acomodar no se en el fondo	2	
Mi mamá Mi papa Mi abuela Mi Tía Yo Mi hermano Mi abuelo Y Mi esposo we	2	
Nada acostado Mi abuelo esta afuera en el carro mi mamá se va ir con mi abuela	2	
Nena mi abuelo tambien es afiliado junto con mi abuela y sus hijos y yo puedo pasar y solo pago lo mínimo	2	
Perdon la fui a acompañar a mi abuela a q se tome el colectivo xq se peleo con mi abuelo	2	
Pero piensa que tu abuela junto con tu abuelo están allá arriba para protegerte , guiarte y cuidarte , y lo mas importante que siempre estarán en tu corazón  .	2	
Que después ella le cuando le compre al abuelo le devuelve ah a la abuela	2	
Que los 15 de karla y que aprobecharon el momento y mi abuela esta diciendo que el caracter de mi abuelo	2	
Quiero agradecer a todo aquel que lee este comentario medio largo , Y quiero agradecerle a todos , TODOSAl usuario que leyó todo , a su mamá , a su papá , a su abuela , a su abuelo , a su perro	2	
Regalo para bauti de parte de su abuelo cristian y su abuela Andrea  .	2	
Sale de si casa , con su hermoso perro , que como obediente dueño saca a su perro cada noche , nos miramos a los ojos profundamente , pero de nuestras bocas no salieron ninguna palabra , el aparto su vista de la mia y siguio su camino a donde siempre saca a su perro , sigo caminando a la casa de mi abuela con algo de indiferencia , pero me encuentro con mi abuelo saliendo de la casa de mi abuela con Mateo , mi perro , yo le pregunto  .	2	
Si mi crush es abuelo , eso significa que yo tambien soy abuela  ?	2	
Tía María que dice papi que dijo el que abuela no dejo ir abuelo a	2	
Una Red , yo y santi un AriZona Pregúntale al chico así tal cual el nombre , fer hershys bites , abuelo unos cacahuates mafer y abuela unos polvorones	2	
Vero le puede decir a mi tio Lenin que vaya donde mi abuela y busque la cédula de mi abuelo Saúl y	2	
Y al cementerio voy a visitarlo a mi papá , mi abuela q era cmo mi mamá , mi otro abuelo y mi hi	2	
#hermano,	hermana
El 99 , 99 falla Mi mamá me dice MUR Mi papá me dice Ci Mi hermano me dice EL Mi hermana me dice LA Y el bebe me dice GO Como me llamo yo  ?	65	
El 99 , 99 fallaMi mamá me dice MURMi papá me dice CIMi hermana me dice ELMi hermano me dice LAMi bebé me dice GOCómo me llamo yo  ?	38	
Marcos 3 35 Porque todo aquel que hace la voluntad de Dios , ése es mi hermano , y mi hermana , y mi madre  .	21	
Borre a mi mamá a mi hermana y a mi hermano esther Cuando subi Ese estado y tus iniciales  .	11	
El 99 , 99 fallaMi mamá me dice MURMi papá me dice CIMi hermano me dice ELMi hermana me dice LAY el bebé me dice GOComo me llamo yo  ?	11	
Queremos decirte que en la sección de felicitaciones de cumpleaños para un hermano también puedes encontrar bonitas frases y mensajes para felicitar a tu hermana , tan solo tienes que cambiar el género de la frase y sirven perfectamente también para tener un mayor listados de felicitaciones en donde elegir  .	11	
El 99 , 99 falla Mi mamá me dice MUR Mi papá me dice CIMi hermano me dice EL Mi hermana me dice LA Y el bebe me dice GO Como me llamo yo  ?	9	
El 99 , 99 falla Mi mama me dice MURMi papa me dice CIMi hermano me dice ELMi hermana me dice LAY el bebe me dice GOCual es mi nombre  ?	8	
El 99 , 99 fallaMi mamá me dice MUR Mi papá me dice CI Mi hermano me dice EL Mi hermana me dice LA Y el bebé me dice GO Cómo me llamo yo  ?	8	
El 99 , 99 fallaMi mamá me dice MURMi papá me dice CIMi hermano me dice ElMi hermana me dice LAY el bebé me dice GO como me llamo yo  ?	8	
Siii bueno es una hermana llamada Daysi y un hermano llamado David  .	7	
El 99 , 99 FallaMí mamá me dice murMí papá me dice ciMí hermano me dice elMí hermana me dice laY el bebé me dice Go Como me llamo yo  ?	6	
El 99 , 99 falla Mi mamá me dice MUR Mi papá me dice Ci Mi hermano me dice E Mi hermana me dice LA Y el bebe me dice GO Como me llamo yo  ?	6	
Hola aMor Buen día recién llegue con las cosas y mi hermano se fue directo para lo d mi hermana asi q ya debe estar llegando así me ayuda ahora tengo q ir a comprar cebollas y papas y después cocinarme y x ultimo limpiar y lavar los platos igual me dara una mano mi hermano	6	
Mi hermano de otra madre , mi niño lindo , mis papás , mi hermana  .	6	
Nunca anhele tener una hermana , nunca la necesite ni desee tampoco y mucho menos tener otro hermano , siempre fuiste más que suficiente , imagínate tener que aguantar a otro igual que tu Amo lo que eres aunque la mayoría de veces no la entiendo Feliz cumpleaños Santiago Montero felices casi 30 Te amo	6	
28- tengo un hermano 29-y una a hermana adoptiva por así decirlo 30- me gustaría tener el poder de volar 31-me encanta cantar pero no en público	5	
El 99 , 9 fallaMi mamá me dice murMi papá me dice ciMi hermano me dice elMi hermana me dice laEl bebé me dice goCómo me llamo  ?	5	
El 99 , 99 fallaMi mamá me dice MUR Mi papá me dice CIMi hermano me dice ELMi hermana me dice LAY el bebé me dice GOComo me llamo yo  ?	5	
Siii bueno es una hermana llamada Daysi , tiene 17 años y mi hermano llamado David que tiene 14  .	5	
bueno como sos el novio de mi hermana , sos como mi hermano  .	5	
Bueno para que veas que no soy mala hermana te consigo al hermano	4	
El 99 , 99 falla Mi mamá me dice MUR Mi papá me dice Ci Mi hermano me dice EL Mi hermana me dice LA Y el bebe me dice GO Cómo me llamo yo  ?	4	
El hermano vergas que se deja peinar por su hermana 3	4	
Ella se llama Jessy Elizabeth Galindo Miranda y será mi hermana por que se casara con el mejor hermano que puedo tener  .	4	
Es que osea si nos queremos los tres pero por ejemplo si mi hermana tiene algo que contar se lo cuenta a mi hermano o si mi hermana quiere ir a algún lado pues siempre se lleva a David y viceversa  .	4	
Lo se , cualquier hermano haría cualquier cosa por su hermana , pero entiendela  .	4	
Mira para k le enseñes a tu hermano x k asta donde yo se mi hermana a penas fue x cobijas a tu casa y Luis asta dinero le dio a mi hermana y eso no me parece xk mi hermana le esta biendo la cara a tu hermana	4	
Momentos con mi hermano y el cumple de mi hermana la quiero mucho Morita Romero	4	
Si hermano el detalle que en el mundo de gelito no habia familia nueva , hermana nueva y si	4	
Tengo 1 hermano mayor y una hermana menor  .	4	
Tengo algo que se llaman codigos es mi hermana asi que a vos te veo como un hermano no conocido ahr no te tengo ese cariño pero bueno me entendiste	4	
Un hermano mayor y una hermana menor	4	
al fin un hermano que va a las muestra de danza de la hermana y no se duerme en ellas	4	
mi hermana tambien se fue y mi hermano hoy trabaja hasta media noche y llega tipo 1 asi q me quedé solo mi amor  .	4	
28- tengo un hermano 29-y una a hermana adoptiva por así decirlo 30- me gustaría tener el poder de volar 31-me encanta cantar pero no en público 32-	3	
Ahí momentos en los que no te puedo sacar de mi cabeza y me hago la fuerte para no lloras y estar con una sonrisa de oreja ah oreja , si tengo 16 años y tengo todo pero me falta mi vida , mi amor , mi angelito , Mi mamá , mi abuelita linda que esta en el cielo y no la puedo bajar , mi hermana cuando yo era chiquita me apagaba los cigarros en las piernas , mi hermano lo vi ahorcado , metido mucho en la droga  .	3	
El 99 , 99 falla Mi mamá me dice MURMi papá me dice CIMi hermano me dice ELMi hermana me dice LAY el Bebe me dice GOComo me llamo yo  ?	3	
El 99 , 99 falla Mi mamá me dice mur Mi papá me dice ci Mi hermano me dice elMi hermana me dice laEl bebé me dice go como me llamo  ?	3	
El 99 , 99 fallaMi mamá me dice MUR Mi papá me dice CI Mi hermana me dice EL Mi hermano me dice LaMi bebé me dice GOComo me llamo yo  ?	3	
Eres cuñada de mi hermano porque yo no ando con tu hermana	3	
Gracias a las peleas discusiones q hemos tenido y fregasos q nos hemos dado he os podido fortaleser nuestra relación Le doy gracias a dios x mi existencai Xq sin mi no hubieras davido lo que es amar a tu hermana pequeña , tmb Xq din mi nunca hubieras sabido lo que es tener a la mejor hermana del mundo mundial Y aunk me cueste admitirlo tqm hermano da dueño eso  .	3	
Hola aMor Buen día recién llegue con las cosas y mi hermano se directo para lo d mi hermana asi q ya debe estar llegando	3	
Hola aMor Buen día recién llegue con las cosas y mi hermano se directo para lo d mi hermana asi q ya debe estar llegando así me ayuda ahora tengo q ir a comprar cebollas y papas y después cocinarme y x ultimo limpiar y lavar los platos Mi Vida	3	
Hola aMor Buen día recién llegue con las cosas y mi hermano se directo para lo d mi hermana asi q ya debe estar llegando así me ayuda ahora tengo q ir a comprar cebollas y papas y después cocinarme y x ultimo limpiar y lavar los platos Te aMo Mucho	3	
Hola aMor Buen día recién llegue con las cosas y mi hermano se fue directo para lo d mi hermana	3	
Jaja x suerte no me pasa osea , osea tengo un hermano de parte de mi mamá y una hermana de parte de mi papá , x suerte con ella me llevo de diez , tiene mi edad pero vive en Necochea y solo en las vacas nos vemos , pero eso si , tengo una prima de 15 que literalmente td lo mio , le va a ella , no importa si lo quería o no	3	
Mensajes de cumplaños para una hermanaQueremos decirte que en la sección de felicitaciones de cumpleaños para un hermano también puedes encontrar bonitas frases y mensajes para felicitar a tu hermana , tan solo tienes que cambiar el género de	3	
Mentirosa eres yo eatoy seguido k ellos y no los miro k ablen k tigo pues si mijito yegas tu y medise tu hermana tedejo ya viene mi hermano luego t ablo te dejo eata ki	3	
Mi amigo el hermano que le llevo las pastillas a ana me diji anoche que la hermana viene por unos días y se va  .	3	
#rey,	reina
Con tigo me olvido de todo lo que hay afuera por que vivimos muestra propia esfera todo rey se merece una reina y la mia eres túuu	8	
Todo rey se merece una reina y la mia eres tu	7	
Carolina Yo la invité Matteo y mientras tu no seas el rey no puedes meterte con mis invitados ya que yo soy la reina aún  .	6	
No tengo Trono ni reina Ni nadie Que Me comprenda Pero sigo siendo El rey	6	
Claro q somos la realeza yo el rey y tu la reina	5	
Luna Al momento de agarrar el libro me sorprende al ver la foto de la reina Lily y el rey Bernie con su pequeña hija Sol Benson  .	5	
Buenas noches mi rey sueñas con tú reina	4	
Ese respeto que se había forjado era el que le ayudaba a mantener su lugar y respeto como la reina , la esposa del rey  .	4	
Estas son las mañanitas que cantaba el rey alexis a su hermosa reina ponte  .	4	
Con tigo me olvido de todo lo que hay afuera por que vivimos muestra propia esfera todo rey se merece una reina y la mia eres tuuu	3	
No seas una reina a la espera de un rey	3	
Quién fuese príncipe para hacerte mi princesa y para cuando fuese rey tú serías mi reina  .	3	
Tratame como un rey y te trato como una reina  .	3	
Un rey no puede vivir sin su reina	3	
Y bueno a empezar a de a poco a hacer manualidades para cuando llegue el añito de mi rey y el cumple de mi reina	3	
Así sera nuestra historia no tendrá final La felicidad de verte sonreir es inimaginable Acuérdate que tu eres el único que con verte me haces la mujer mas feliz del mundo Tu eres esa personita con la cual no quisiera despedirme nunca Yo tu reina Y tu mi rey Yo te quiero mucho mas	2	
Atencion atencion el novio le desea un nindo día la reina q , conquisto su corazón osea tu sofía Ochoa Santamaria Jejeje mi reina espero q hayas dormido super Mien q hayas amanecido muy muy bien que hayas soñado super nindo q hayas pasado una bella noche q los angelitos te hayan acompañado todiiita la noche ytooo , ete rey le envia a su reina un besososote ashi bien rico muuuuuuuuuuuuuuuuuuuaaaaaaaaaaaaaaaaaaak acompañado de un abachotototote  !	2	
Bueno entonces tu mi reina y yo tu rey	2	
Con tigo me olvido de todo lo que hay afuera por que vivimos muestra propia esfera todo rey se merece una reina	2	
Contigo me olvido de todo lo que afuera por que vivimos en nuestra popria esfera todo rey se merece una reina y la mia eres tu	2	
Contigo me olvido de todo lo que hay afuera , por que vivimos en nuestra esfera , todo rey se merece una reina y la mia eres tu	2	
Dice todo rey se merece una reina y tu eres la mia	2	
El es mi rey y yo su reina Robert Estevez	2	
El rey Bernie quería que su hija fuera la reina y por lo menos hay que cumplir el deseo del fallecido rey  .	2	
Eso ya lo que quieras , sino ps tu queen , que es reina y yo king , que es rey	2	
Esq yo soy la reina y vos el rey	2	
Estas son las mañanitas que cantaba el rey alexis a su hermosa reina	2	
Hasta siento bonito leer que me escribas rey , te amo mi reina , heredera de mi corazón  .	2	
Jajaja es que la reina ama las al rey	2	
Maestra Niños sean todos bienvenidos a la clase de historia este año será un poco diferente porque para empezar el semestre el día de mañana estaremos saliendo a las ruinas de lo que antes era el palacio del rey Bernie y su esposa la reina Lily  .	2	
Si eres mi reina y yo tu rey	2	
Sos mi reina y yo tu rey	2	
Todo rey se merece una reina l	2	
Usted en la muñeca la corona del rey , LORE la corona de la reina y pipe llorando del dolor la corona del principe jjjjj	2	
Yo no soy mensa papi para mi tu eres mi rey porque yo soy para ti una reina	2	
-El no acepta la ayuda , Pero una reina vale por su fuerza ante el rey  .	1	
2 una hermoza reina de 5 añitos largos y un rey de 1 añito	1	
25 Soy su rey , y lo mismo poniendo soy su reina  ?	1	
A mi me falta la abeja reina , esqueletron y el rey slim	1	
Aaaa bueno mi rey saludos muchos besitos a la reina	1	
Ademas de que yo le digo la reina roja , ella empezo a decirme el rey rojo despues de mi cumpleaños	1	
Aja hagale asi que la reina sirve arto al igual que el rey porque id lo puede mandsr primero y aguanta resto	1	
Aja te puse así por que tu eres mi rey y yo tu reina cierto  ?	1	
Al igual fui su rey y usted mi reina conocí cada parte de su cuerpo muchos secretos muchas cosas	1	
Algun dia hasi como tu eres mi reina yo sere tu rey	1	
Amor buenos días como amanese mi reina hermosa y el rey de la casa amor	1	
Ante Chris podia parecer una niña estúpida y sin consciencia de nada , Pero a ojos de los demás era una reina fuerte y poderosa , casi Tanto como su rey  .	1	
Así sera nuestra historia no tendrá final La felicidad de verte sonreir es inimaginable Acuérdate que tu eres el único que con verte me haces la mujer mas feliz del mundo Tu eres esa personita con la cual no quisiera despedirme nunca Yo tu reina Y tu mi rey	1	
Aunque tu lo nieges cada despertar pienso en ti y si es a si es por mi rey y mi flakita y mi reina me lo dijo ahorita me dijo k para k me hacia pendeja si yo de ante mano sabia k mi rey era tuyo	1	
Ay hermoso amor te amo demasiado , aunque no lo creas me siento como una reina pq se q este rey q es mi mejor amigo siempre me va a cuidar de todo es todo	1	
#hijo,	hija
Relación cancion Favorita Por enamorarme Cantante favorito Romeo Santos Nombre planeado para tu hija Cristal Nombre planeado para tu hijo  .	22	
Creo Que Si Me llamo Gabriela Sarahi Moreno Ornelas Me dicen Sara , Gabriela , Flaca cancion Favorita Uuy Muchas Maquiavélico , Llovía , Mañana Sera Otro Dia , Ley Del Hielo , 23 , Vitamina , GPS , Bailando Con La Muerte Cantante favorito Canserbero Nombre planeado para tu hija Brianna Nicol Nombre planeado para tu hijo Ángel Matías Comida favorita Pozole Verde , Enchiladas , Gorditas Mayor secreto Animal favorito Pandas Caballos Eres celoso  ?	21	
Creo Que Si Me llamo Gabriela Sarahi Moreno Ornelas Me dicen Sara Gabriela Flaca cancion Favorita Uff Muchas Maquiavélico , Llovia , Mañana Sera Otro Dia , Ley Del Hielo , 23 , GPS , Vitamina , Bailando Con La Muerte Cantante favorito Cancerbero Nombre planeado para tu hija Brianna Nicol Nombre planeado para tu hijo Ángel Matías Comida favorita Enchiladas , Pozole Verde , Tacos Mayor secreto Animal favorito Pandas Caballos Eres celoso  ?	21	
De confirmación tengo 2 MIS HIJOS Y SUS MADRINAS Y PADRINOS Mi hijo de bautismo De confirmación Mi hija de bautismo De confirmación Mi hija de bautismo Y no se confirmo tenemos relacion ; hablamos pero no nos vemos  .	19	
Me llamo Me dicen cancion Favorita Cantante favorito Nombre planeado para tu hija Nombre planeado para tu hijo Comida favorita Mayor secreto Animal favorito Eres celoso  ?	19	
Me llamo Jesús Omar Cuenca Escalona Me dicen Omar cancion Favorita tu foto Cantante favorito bad bunny Nombre planeado para tu hija Luna Nombre planeado para tu hijo luisito Comida favorita arroz Mayor secreto ningún Animal favorito Lobo Eres celoso  ?	18	
Estas listo para 132 preguntasMe llamo Jocelyne Alejandra Gómez Martínez Me dicen Ale , Alejandra , Yos Soltera o relacion Solterita Cancion favortita Thinking Out Loud Cantante favorito Michael Jackson Obvi Nombre planeado para tu hija Mia Nombre planeado para tu hijo Damian Comida favorita Pizza Mayor secreto Secreto Animal favorito Perro y León Eres celosa Bastante si Lugar favorito No tengo Que materia odias Quimica Eres peresosa Un poquis Cantar o bailar Ambas Pelicula favorita No tengo Color favorito El Rosa bebe Persona que odias Yo soy una maquina de amor , cero odio Ah quien amas  ?	15	
Me llamo Me dicen cancio Favorita Cantante favorito Nombre planeado para tu hija Nombre planeado para tu hijo Comida favorita Mayor secreto Animal favorito Eres celosa  ?	10	
Me llamo Yenifer Katherina Acuña Me dicen tengo muchos apodos cancion Favorita hey dj Cantante favorito cnco y v-one Nombre planeado para tu hija no se Nombre planeado para tu hijo no se Comida favorita pizza Mayor secreto se supone que es secreto Animal favorito perro Eres celos  ?	10	
Estas listo para 132 preguntasMe llamo Me dicen Soltera o relacion Cancion favortita Cantante favorito Nombre planeado para tu hija Nombre planeado para tu hijo Comida favorita Mayor secreto Animal favorito Eres celosa Lugar favorito Que materia odias Eres peresosa Cantar o bailar Pelicula favorita Color favorito Persona que odias Ah quien amas  ?	9	
Me llamo Canción Favorita Cantante favorito Nombre planeado para tu hija Nombre planeado para tu hijo Comida favorita Mayor secreto Animal favorito Eres celosa  ?	9	
cancion Favorita Cantante favorito Nombre planeado para tu hija Nombre planeado para tu hijo Comida favorita Mayor secreto Animal favorito Eres celosa  ?	9	
Smn Me llamo Alonzo Ivana Martínez Me dicen Alonzo cancion Favorita Mi futuro y mi pasado , Recuerdemenme Así y muchas mas Cantante favorito Emm No tengo Nombre planeado para tu hija Emmm no se Nombre planeado para tu hijo Axel Martinez Comida favorita Emmm pss no tengo Mayor secreto Emmm no se dice Animal favorito Perro y Leo pardo Eres celoso  ?	7	
De confirmación tengo 2 MIS HIJOS Y SUS MADRINAS Y PADRINOS Mi hijo de bautismo De confirmación Mi hija de bautismo De confirmación	6	
De confirmación tengo 2 MIS HIJOS Y SUS MADRINAS Y PADRINOS Mi hijo de bautismo De confirmación Mi hija de bautismo De confirmación Mi hija de bautismo Y no se confirmo	6	
Mafer Canción fav la dama & un par de balas Cantante fav k can , bar bunny , cd 9 Nombre planeado para mi primer hija danna Monserrat Nombre planeado para mi primer hijo ozyris Alejandro Comida fav lasaña y pizza Mayor secreto es un secreto	6	
Me llamo Brenda Paola Martínez Garces Me dicen brindis , Chillona , ojona Cancion Favorita Call on me Nombre planeado para tu hija Elizabeth Nombre planeado para tu hijo Raúl	6	
Me llamo Brenda Torres Me dicen vane canción Favorita Mi razon de ser Cantante favorito ninguno Nombre planeado para tu hija vanessa Nombre planeado para tu hijo ni idea Comida favorita Pizza , espaguetti Mayor secreto si lo digo ya no seria secreto Animal favorito tigre Eres celosa  ?	6	
Me llamo Me dicen cancion Favorita Cantante favorito Nombre planeado para tu hija Nombre planeado para tu hijo Comida favorita Mayor secreto Animal favorito perro Eres celos si Lugar favorito Que materia odias matemática Eres perezoso  ?	6	
Creo Que Si Me llamo Gabriela Sarahi Moreno Ornelas Me dicen Sara , Gabriela , Flaca cancion Favorita Uuy Muchas Maquiavélico , Llovía , Mañana Sera Otro Dia , Ley Del Hielo , 23 , Vitamina , GPS , Bailando Con La Muerte Cantante favorito Canserbero Nombre planeado para tu hija Brianna Nicol Nombre planeado para tu hijo	5	
Me llamo Brenda Paola Martínez Garces Me dicen brindis , Chillona , ojona Cancion Favorita Call on me Nombre planeado para tu hija Elizabeth Nombre planeado para tu hijo Raúl Comida Favorita Pechugas rellenas Quien te gusta  ?	5	
Me llamo Karina Rubi González Rincón Me dicen Karinoski cancion Favorita Tenerte a ti Cantante favorito Maluma Nombre planeado para tu hija Madeleyn Ailyn Nombre planeado para tu hijo Gerardo Comida favorita Taquitos al pastor Mayor secreto No se dice jsjs Animal favorito Perros Eres celoso  ?	5	
Roberto tiene tres hijas , y cada hija tiene un hermano , cuantos hijo tiene Roberto  ?	5	
Simón w Me llamo Marisol Mex Me dicen Enana Stitch cancion Favorita El Coloso De Tus Ojos , Tacos Altos , Privado Cantante favorito Arcangel y Badana Bunny Nombre planeado para tu hija Aun No se Nombre planeado para tu hijo Eidan Comida favorita Pizza Mayor secreto Si Lo digo Ya no Seria Secreto Animal favorito Panda Eres celosa Muchísimo Lugar favorito Playa Que materia odias  ?	5	
Está bien hija no hay ningún problema ay muchas Gracias hija tu también te veías muy bonita eee hasta mi hijo juan me dijo esta ya viste a sara  ?	4	
Me llamo Brenda Paola Martínez Garces Me dicen brindis , Chillona , ojona Cancion Favorita Call on me Nombre planeado para tu hija Elizabeth Nombre planeado para tu hijo R	4	
Pq siempre tienes tus manos abiertas y tu corazón lleno de amor para nosotros gracias papá por compartir cada dia a nuestro lado , por el amor sincero y grande que nos das cada dia , un papa siempre sera el superhéroe de su hijo y el primer amor de su hija  !	4	
Soltera cancion Favorita todas las de Alemán Cantante favorito El Aleman obvio Nombre planeado para tu hija No quiero hijos Nombre planeado para tu hijo No quiero hijos Comida favorita Toda la que se come v Mayor secreto Ya no sería secreto si lo digo Animal favorito hay nose v Eres celosa  ?	4	
Yo te quiero y se que ise un re mal y se que eso nunca me lo va perdonar dios ni quizas usted pero Yo quiero salir adelante y tener mi hijo con usted que fue el que siempre me puso ah soñar en mi hija	4	
pues ojala me pase lo mismo de buen hijo porq yo soy buena hija con ella y usted sabe  .	4	
Creo Que Si Me llamo Gabriela Sarahi Moreno Ornelas Me dicen Sara Gabriela Flaca cancion Favorita Uff Muchas Maquiavélico , Llovia , Mañana Sera Otro Dia , Ley Del Hielo , 23 , GPS , Vitamina , Bailando Con La Muerte Cantante favorito Cancerbero Nombre planeado para tu hija Brianna Nicol Nombre planeado para tu hijo Ángel Matías Comida favorita Enchiladas , Pozole Verde ,	3	
De confirmación tengo 2 MIS HIJOS Y SUS MADRINAS Y PADRINOS Mi hijo de bautismo De confirmación Mi hija de bautismo	3	
De confirmación tengo 2 MIS HIJOS Y SUS MADRINAS Y PADRINOS Mi hijo de bautismo De confirmación Mi hija de bautismo De confirmación Mi hija de bautismo	3	
Donde mandaste a tu hijo a secuestrar a tu hija y lod mensajes de haydee	3	
Educa tu hijo para que respete a las mujeres , y a tu hija para que reviente de una cachetada al primer imbécil que le levante la voz  .	3	
Es un idiota la puta madre que te parió Repeto trosglodita de mierda , misogino hijo de puta tenés hija pelotudooooooo  .	3	
Estas listo para 120 preguntas Si Me llamo Jessica Rodríguez Tolentino Me dicen Jess jessi corchito cancion Favorita Mi niña traviesa , como mirarte , quien va ah amar de verdad , siempre te voy ah querer , Nombre planeado para tu hija Melanny Yamileth Nombre planeado para tu hijo Luis Angel Comida Favorita Tostadas de tinga Quien te gusta  ?	3	
Mafer Canción fav la dama & un par de balas Cantante fav k can , bar bunny , cd 9 Nombre planeado para mi primer hija danna Monserrat Nombre planeado para mi primer hijo ozyris Alejandro	3	
Mafer Canción fav la dama & un par de balas Cantante fav k can , bar bunny , cd 9 Nombre planeado para mi primer hija danna Monserrat Nombre planeado para mi primer hijo ozyris Alejandro Comida fav lasaña y pizza	3	
Mafer Canción fav la dama & un par de balas Cantante fav k can , bar bunny , cd 9 Nombre planeado para mi primer hija danna Monserrat Nombre planeado para mi primer hijo ozyris Alejandro Comida fav lasaña y pizza Mayor secreto es un secreto Animal fav koala y panda	3	
Mafer Canción fav la dama & un par de balas Cantante fav k can , bar bunny , cd 9 Nombre planeado para mi primer hija danna Monserrat Nombre planeado para mi primer hijo ozyris Alejandro Comida fav lasaña y pizza Mayor secreto es un secreto Animal fav koala y panda Eres celoso sólo un poco	3	
Mafer Canción fav la dama & un par de balas Cantante fav k can , bar bunny , cd 9 Nombre planeado para mi primer hija danna Monserrat Nombre planeado para mi primer hijo ozyris Alejandro Comida fav lasaña y pizza Mayor secreto es un secreto Animal fav koala y panda Eres celoso sólo un poco Lugar fav parque	3	
Mafer Canción fav la dama & un par de balas Cantante fav k can , bar bunny , cd 9 Nombre planeado para mi primer hija danna Monserrat Nombre planeado para mi primer hijo ozyris Alejandro Comida fav lasaña y pizza Mayor secreto es un secreto Animal fav koala y panda Eres celoso sólo un poco Lugar fav parque Que materia odias ninguna	3	
Mafer Canción fav la dama & un par de balas Cantante fav k can , bar bunny , cd 9 Nombre planeado para mi primer hija danna Monserrat Nombre planeado para mi primer hijo ozyris Alejandro Comida fav lasaña y pizza Mayor secreto es un secreto Animal fav koala y panda Eres celoso sólo un poco Lugar fav parque Que materia odias ninguna eres perezoso nop	3	
Mafer Canción fav la dama & un par de balas Cantante fav k can , bar bunny , cd 9 Nombre planeado para mi primer hija danna Monserrat Nombre planeado para mi primer hijo ozyris Alejandro Comida fav lasaña y pizza Mayor secreto es un secreto Animal fav koala y panda Eres celoso sólo un poco Lugar fav parque Que materia odias ninguna eres perezoso nop Cantar o bailar los 2	3	
Mafer Canción fav la dama & un par de balas Cantante fav k can , bar bunny , cd 9 Nombre planeado para mi primer hija danna Monserrat Nombre planeado para mi primer hijo ozyris Alejandro Comida fav lasaña y pizza Mayor secreto es un secreto Animal fav koala y panda Eres celoso sólo un poco Lugar fav parque Que materia odias ninguna eres perezoso nop Cantar o bailar los 2 Película fav bajo la misma estrella	3	
Mafer Canción fav la dama & un par de balas Cantante fav k can , bar bunny , cd 9 Nombre planeado para mi primer hija danna Monserrat Nombre planeado para mi primer hijo ozyris Alejandro Comida fav lasaña y pizza Mayor secreto es un secreto Animal fav koala y panda Eres celoso sólo un poco Lugar fav parque Que materia odias ninguna eres perezoso nop Cantar o bailar los 2 Película fav bajo la misma estrella Color fav negro & tinto	3	
Mafer Canción fav la dama & un par de balas Cantante fav k can , bar bunny , cd 9 Nombre planeado para mi primer hija danna Monserrat Nombre planeado para mi primer hijo ozyris Alejandro Comida fav lasaña y pizza Mayor secreto es un secreto Animal fav koala y panda Eres celoso sólo un poco Lugar fav parque Que materia odias ninguna eres perezoso nop Cantar o bailar los 2 Película fav bajo la misma estrella Color fav negro & tinto Persona k odias pz a muchas	3	
Mafer Canción fav la dama & un par de balas Cantante fav k can , bar bunny , cd 9 Nombre planeado para mi primer hija danna Monserrat Nombre planeado para mi primer hijo ozyris Alejandro Comida fav lasaña y pizza Mayor secreto es un secreto Animal fav koala y panda Eres celoso sólo un poco Lugar fav parque Que materia odias ninguna eres perezoso nop Cantar o bailar los 2 Película fav bajo la misma estrella Color fav negro & tinto Persona k odias pz a muchas A quien amas a mi crush	3	
Me llamo Maria Fernanda Arguello Mata Me dicen Motaca cancion Favorita Ay Varias Cantante favorito Alemán Y Guera MxM Nombre planeado para tu hija Nombre planeado para tu hijo Comida favorita Tacos y Pizza Mayor secreto No Ay Animal favorito Perro Eres celoso  ?	3	
#padre,	madre
No quiero volver con mi madre , pero mi abuela y padre me obligan  .	16	
Y un día , encontraré a quien mató a mi madre y conseguiré justicia para mi padre  .	15	
de vez en cuando Ahhh por cierto tengo una hermana y un hermano luego le dire sus nombres Bueno ahora si comienza mi historia Cuando yo era un niño de 9 , 10 mi madre trabajaba mucho mi padre se dedicaba era a solo tomar y a estar con una y con otra Y lo peor es que cuando llegaba ala casa el llegaba era tomado y cuando llegaba a si el le pegaba a mi madre sin motivo alguno  .	14	
que linda amor yo igual amo todo de ti ayñ es la verdad amor Ayñ y asi sera amor porque eso es lo que yo igual deseo ayñ shii amor asi sera yo sere el padre de tus hijos y tu seras la madre de mi hijos Se lo llevo mi tio porque le gusto mucho y coml es bien jugueton por eso se lo llevo amor jeje enserio bb le tenias celo  ?	14	
Parece madre con su hijo pequeño XD y el otro parece padre	12	
El padre bien encabronado culpa a la madre y la madre enputada a la hermana por no vigilarla  .	11	
Eso quiere decir que tu padre le pone los cuernos a tu madre	11	
Este día jamás lo olvidare , saber que seré padre me alegra y saber que tu serás la madre de mi primer hija me hace aún más feliz , siempre supe que mi felicidad estaba contigo  .	11	
Mi padre es mi angel mi madre y mis hijos son mi vida	11	
El padre culpa a la madre y a la hermana por no vigilarla  .	10	
Enamórate de quién será un buen padre , una buena madre , y un gran abuelo  .	9	
Mensaje mi madre trató de defenderme , mi padre amenazo con pegarle  .	8	
La vida de una madre soltera es difícil pero la de mi padre con nosotros fue a un mas , tan solo por el gran trabajo que ahora tenemos los dos , pero no fue imposible gracias padre te amo	7	
Por cierto se que tienes a Shesshomaru pero puedo utilizarlo también solo que en esta versión el tiene el pelo corto negro y la apariencia se la cambiare un poco mas , la luna de su frente no la tendría y las marcas seran como la madre ya que como utilizo a la madre y a el padre me gustaría utilizar el mismo personaje pero cambiando su apariencia Y te preguntaras por qué  ?	7	
STEFIDesearte que Dios te bendiga , en este nuevo año de vida , te deseo lo mejor de Dios , porque tu eres una mujer deseada x el padre desde el vientre de tu madre  .	7	
-llega a casa , pero no le envia ningun mensaje al menor , su padre le gritaba , su madre lloraba escuchando los gritos  .	6	
Ay mis viejos , mis viejos , mis viejos queridos Muy dentro del alma los llevo a los dos Ay yo quiero a mi madre y adoro a mi padre Que siempre los cuide le ruego a mi Dios Lo más lindo del mundo amor los	6	
Del cielo cayó una rosa Mi padre la recogió Un 19 como hoy nació mi madre Hermosa Que feliz me siento yoJejeje Feliz Cumpleaños a la Reina de la casa  .	6	
El hijo sabio alegra al padre , Pero el hijo necio es tristeza de su madre  .	6	
Ella no sabia quien era su padre y nunca entendió el amor de su madre Y un día partioooo en busca de algo mejor , ella sabía que volver seria mucho peooor nació en el dolooor , se fue detras de una canción  .	6	
La casa no era de mi padre , sino de mi madre , y ella dejó de herencia la casa a mis hermanos , pero en ese entonces nadie tenia ni los 16 , asi que mi abuela materna , reclamó la casa y , se escuchara muy raro pero , la reclamó y nos echó de la casa  .	6	
Porque soy padre soltero y quiero conocer a una madre soltera	6	
Del cielo cayó una rosaMi padre la recogió Un 19 como hoy nació mi madre HermosaQue feliz me siento yoJejejeFeliz Cumpleaños a la Reina de la casa  .	5	
Lo amo porque me reta como un padre , me pelea como un hermano , pero me mira como mira una madre  .	5	
Por que cuando yo era pequeño yo les daba de despedía a mi padre y a mi madre un pico en la boca y pues eso no tiene nada de malo eso para mi era normal entonces yo le enseñe a hacer eso Bueno pero yo ya no hago eso con mis padres yo hago algo muy hermoso y es dar un abrazo y decirles feliz tarde o que tengas una feliz tarde jejejeje  .	5	
Que atros es atentar contra la propia vida , comentan todos en tu funeral Tu madre no deja de hecharse la culpa Tu padre esta muy enojadoTus amigos lloran y el resto de tu familia reza por tu alma porque estaras perdido en el infierno  .	5	
Tengo el ejemplo de mi padre , el amor de mi madre , la compañia de hija y el respaldo de mis hermanos	5	
solo puedo pedirle a nuestro padre celestial que llene de salud y fortaleza a mi madre para que el próximo año su gesto sea igual o mas bello que la actual  .	5	
A ti que no dejas que la adversidad te haga caer y ante lo imposible haces lo posible , porque eres madre y muchas veces padre , porque eres abuela , tía , hermana e hija  .	4	
En eso , suena un grito desgarrador , la toma cambia a la discusión de los padres de Andy , se ve a su padre lanzando bruscamente a su madre de las escaleras , esta se golpeo en repetidas ocasiones y termina tirada en el piso , rodeada de un charco de sangre extremadamente real , comienzan a escucharse gritos de un bebe desesperado , estos gritos cada vez se hacían mas profundos y fuertes  .	4	
Eva mi madre , Gavi mi padre , y Yaiza mi hermana 3  .	4	
Hay personas q no tienen mm para el día de la madre o pp para el día del padre  .	4	
La historia gira en torno a Shinichi Kano , un otaku de pura sangre sin ningún talento especial que destaca por su vasto conocimiento y opiniones sobre el moe y por tener a un padre escritor de novelas ligeras y a una madre que realiza eroges  .	4	
Por eso tu madre no te quiere y por eso no tienes padre  !	4	
Por que su madre no se interesa mucho en ella y su abuelo tampoco y su padre tampoco  .	4	
Por tanto , dejará el hombre a su padre y a su madre , y se unirá a su mujer , y serán una sola carne  .	4	
Siempre antea de dormir , mientras duermo , cuando me despierto , sueño y pienso un futuro a tu lado , felices los dos juntos amor , sin nada ni nadie que ns moleste , solo tu y yo , vs madre de mi hij @s y yo padre de tus hij @s	4	
Tres días son necesarios , un par de lágrimas de mi madre y una mueca de mi padre  .	4	
Y no me extrañen mis jefes que su hija la rebelde por siempre vivirá Ya me voy a otro concierto voy a cantar con Adán un dueto tengo pendiente por allá con su papá Saúl Viera y Selena también me recibirán Que en mi lindo Playa Larga haya una ultima parranda que me canten mis hermanos mi madre Flores reparta mi padre fotografías y mi hermana lea mi carta  .	4	
A mi no cuando yo me fui el padre le dijo eso a la madre	3	
A vos lo único que deseo es tenerte quisas en el futuro volver a verteYo te perdono porque eres mi padre siempre me hiciste falta pero tengo a mi madre	3	
Ahora entiendo que como madre llevas mas responsabilidad que el padre  !	3	
Dulce madre no te alejes tu vista de mi no apartes ven con migo a todas partes solo nunca me dejes ya q me quieres como una verdadera madre bendice amis amigos y familiares en el nombre del padre del hijo y del espirito santo amen  .	3	
Déjame decirte que no lo hizo , tantos años siendo una a decepción para toda mi familia , desde pequeño supe lo que era no tener a una familia , mi madre trabajando todo el día y mi padre que ni estaba , supe lo que sentía estar solo desde muy pequeño y todo fue haci hasta que hace 4 o 5 año conocí a una persona por Facebook y esa persona me enseño que valia la pena vivir , me mostró	3	
Efesios 6 2 Honra a tu padre y a tu madre , que es el primer mandamiento con promesa ; 3 para que te vaya bien , y seas de larga vida sobre la tierra  .	3	
En la Biblia aparece a menudo el mandato Honra a tu padre y a tu madre Éxodo 20 12 ; Deuteronomio 5 16 ; Mateo 15 4 ; Efesios 6 2 , 3  .	3	
Escrito esta que el hombre dejara a su padre y a su madre y se unira a su mujer y seran una sola carne  .	3	
Feliz Día para la persona que no solamente hace el rol de madre , sino también por haber echo el rol de padre toda la vida  .	3	
Gabi cuando estaba apuntó que de llegar el carro escuche que alguien me hablabla , volteé hacia atras y vi a mi padre molesto acercandose hacia mi , por suerte se puso enfrente de mi el Uber , me subí y le dije que arrancara , me obedeció y se fue , me fije en el espejo la reacción de mi padre , me divertí de cierta manera , sabia que cuando llegara mi madre me regañaría Gracias , me salvaste de el regaño de mi padre  .	3	
Hay abuelita te fuistes sin decirnos un a dios aunque no estés presente siempre te boya recordar y nos vas hacer tanta falta a mi y a mi madre y a mi padre aunque estés haya en el cielo tu y mi abuelito nunca lo boya a olvidar lo boya tener siempre en mi mente y en mi corazón los quiero mucho tu nieta lina	3	
#príncipe,	princesa
Mis papás habian salido de viaje , mi casa estaba completamente sola , yo te marcaba y te decia que pasaras por mi para irnos , y asi fue , llegabas en una moto increíble , y me decías Subase a su corcel bella princesa Y yo te respondía Con el príncipe mas guapo de todo oaxaca , como no subirme  .	8	
No soy una princesa , ni vos un príncipe pero quiero que sigas en mi cuento , love	7	
Mi príncipe azul y mi princesa hermosa	6	
Me encanta que me beses , que me abraces , que me digas tonterías , que me hagas reír , que me cuides , que me hagas sentir como una princesa cuando esta con su príncipe , y sobretodo , me encanta que pases horas conmigo	5	
Eres tan lindaMuy rápidamente logras sonrojarme Y obvio lo notas Es increíble todo lo que me haces sentir Valoro mucho todo eso Es la relación más hermosa y eso que es el comienzo de nuestra bella historia Te voy a contar una historia Como sabrás es el príncipe Martín y la princesa Rebeca	4	
La princesa Charlotte Amelie Phantomehive Franshuii acompañada por su hermano , el juez y príncipe Kaito Sniezna Franshuii  .	4	
Eres mi príncipe azul , al igual que yo tu princesa , dejemos que esta bonita historia quede grabada para la posteridad  .	3	
Quién fuese príncipe para hacerte mi princesa y para cuando fuese rey tú serías mi reina  .	3	
Una princesa puede convertir a un sapo en príncipe  .	3	
pero hoy te prometo que sere la chava de tus sueños , sabre responderte para que sepas que yo aun te amo , incluso más que el día anterior , te voy a demostrar que una verdadera princesa no cruza los brazos y espera a que príncipe azul  .	3	
Fue así como se conocieron Algo complicada la princesa al inicio obvio como debe de ser A pesar de que el príncipe los primeros días perdía un poco la esperanza de que podía hacer su vida con la princesa Decidió no rendirse en ningún momento y fue cuando la princesa Se dio cuenta que el príncipe de verdad tiene buenas intenciones con ella Entonces decidió abrir su corazón tan bello con el Y el primer día de salir No se hicieron novios por ciertas cosas que habla en el momento Ah  !	2	
Hoy me toco cuidar a mi princesa esmeralda y a mi príncipe ISRAEL	2	
Me encanta si él es un príncipe , que me hace sentir como su princesa	2	
Yo soy la princesa y vos sos mi príncipe	2	
-sonríe y lo besa acostandolo en la cama- asumo que le princesa querrá hijos con su príncipe  .	1	
1- Aries- el hijo primogenito 2- Tauro-el torso 3- Géminis-la mujer atada 4- Cáncer-la amante marchita 5- Leo-el príncipe desgarrado 6- Virgo-la princesa enojada 7- Libra-la peregrina 8- Escorpión-el niño obeso 9- Sagitario-la madre nefasta 10- Capricornio-el martillo 11- Acuario-el chacal 12- Piscis-el aniquilador Con gusto	1	
1- Aries- el hijo primogenito 2- Tauro-el torso 3- Géminis-la mujer atada 4- Cáncer-la amante marchita 5- Leo-el príncipe desgarrado 6- Virgo-la princesa enojada 7- Libra-la peregrina 8- Escorpión-el niño obeso 9- Sagitario-la madre nefasta 10- Capricornio-el martillo 11- Acuario-el chacal 12- Piscis-el aniquilador La reyna nos pidió hacerlo	1	
1- Aries- el hijo primogenito libre fin 2- Tauro-el torso me falta lo demas no mamen asi hablan hoy no 3- Géminis-la mujer atada hola nena 4- Cáncer-la amante marchita esa niña me arto 5- Leo-el príncipe desgarrado hola de nuevo damisela 6- Virgo-la princesa enojada vaya fin libres 7- Libra-la peregrina vamo a apostar hola reyna 8- Escorpión-el niño obeso comer niña 9- Sagitario-la madre nefasta yo la mato y te la doy 10- Capricornio-el martillo lo clavamos vale 11- Acuario-el chacal aqui estan mi reyna 12- Piscis-el aniquilador vamo a aniquilarlos	1	
A partir de ese momento , el príncipe ya sabia quien iba a ser la futura princesa la joven que había perdido el zapato  !	1	
Ah muchas felicidades para tu princesa Michel y para tu príncipe Maxwell	1	
Así dice mi crz q tu eres la elegida q solo tu seras esa princesa q le falta a este príncipe para terminar como esos cuentos q dicen q vivieron felices x siempre	1	
Así dice mi crz q tu eres la elegida q solo tu seras esa princesa q le falta a este príncipe para terminar como esos cuentos q dicen q vivieron felices x siempre q todo sera también sera genial aunque no todo sera alegría pero hay estaremos para ayudarnos eso dice mi crz y creo y tengo fe q no se equivocara	1	
Bien bien la princesa con ligo ya sabes y el príncipe con su papa	1	
Bien mi príncipe levantandome xq mi princesa me comenzó a tocar la puerta jajaja sino todavia estuviese durmiendo	1	
Buenas noches bb ke tengas unos lindos sueños mi princesa sueña con tu príncipe saves ke yo te kiero mas amor y no te	1	
Buenas noches bb ke tengas unos lindos sueños mi princesa sueña con tu príncipe saves ke yo te kiero mas amor y no te cambio	1	
Como los amo mi príncipe hermoso matheus y mi princesa hermosa arianita	1	
De hecho la princesa le decía que era un patán , y dejaba al príncipe en una cueva y se iba volando en el dragón  .	1	
Del príncipe que lucha por su hermosa princesa contra el todos	1	
El príncipe tiene 5 y la princesa va para cuatro meses	1	
En aquel momento me di cuenta de que tu eras la bella princesa y yo el príncipe azul , inercia recuerdas , definir lo que siento por ti va mas allá de la ciencia	1	
En que cuanto viste que la princesa este atras del príncipe  ?	1	
Entonces las súplicas de la princesa se hicieron notar cuando dijo vete , no soporto más esta situación en la que tú ya no eres el mismo , el príncipe se enfureció , por la inconsciencia de la princesa , porque sonaba a puro capricho , sin embargo decidió partir , y aprendió que los caprichos encierran verdades que en la mayoría de las ocasiones están conectadas con los miedos , y por eso nunca más volvió a ver a su princesa  .	1	
Eres un príncipe y yo tu princesa	1	
Esa princesa siempre hara todo para cuidar a su príncipe	1	
Esa princesa siempre hará todo para cuidar a su príncipe , así tenga que regañarlo	1	
Estaba escuchando música y la canción que se puso cuando vi ese lugar me recordo a ti Quiero que mi cielo tenga tu nombre y solo cause fuego en mi interior Quiero que los dos perdamos el norte y hagamos de dos un solo corazón Unidos para siempre en un vinculo eterno donde rodamos películas de amor Quiero que mi cielo tenga la suerte de que tu le des de tu calor Y en aquel momento me di cuenta de que tu eres la bella princesa y yo el príncipe azul Inercia , recuerdas  ?	1	
Había una princesa llamada Rebeca que tenia a su príncipe Martín	1	
Había una princesa llamada Rebeca que tenia a su príncipe Martín alias babe	1	
Había una vez una princesa llamada Princesa , llego un príncipe azul llamada Príncipe , así que se enamoraron , y cocharon hasta que se vino adentro , se embarazo , y murió en el parto la princesa  .	1	
Hasta mañana zorra suerte a mi princesa y a mi príncipe fabri nos estamos hablando	1	
Hay esta 7 enanos pero como lo aras cambiado que sean 8 1 princesa 1 que se vista de sapo 1 príncipe 4 para dos caballos 3 amigos pajaros 2 para un venado Árboles , rocas , etc	1	
Hoy en día le doy gracias a la vida por haberte puesto en mi camino eres mi príncipe y yo tu princesa	1	
Hoy en día le doy gracias a la vida por haberte puesto en mi camino eres mi príncipe y yo tu princesa No se como le haces para gustarme tanto	1	
Hoy me criticaron por felicitarte todos esos hermosos años me han criticado sabes a mi no me importa sabes porque esos 4 años que has existido en mi vida me han echo la joven mas loca y feliz del mundo siempre dicen porque decirle príncipe a ti si nunca fui tu princesa a pesar de todo estoy aquí apoyándote	1	
Inmediatamente la llevaron a palacio y a los pocos días se casó con el príncipe , por lo que fue una princesa  !	1	
Jaja no se puede dormir un príncipe hasta q se duerma su princesa q mal jajaj	1	
Jmmmm ojalá la princesa estuvieras más cerca de él príncipe iría	1	
La princesa esta de fiesta Y el príncipe	1	
Lo seeeee príncipe y te agradezco por tratarme como una princesa cuando hacemos este tipo de cosas	1	
#chico,	chica
se que es duro no lo niego , se que te extraño y lo admito , aveces solo pienso en como un chico que esta bien puesto económicamente en lq sociedad puedq haberce jidado en una chica poca cosa cm yo se que aveces extraño sus msj , sus peleas o el  .	24	
Hola , que opinas de una chica de 17 que sale con un chico de 23 && que fue su maestro  ?	20	
Felicidades chica bella estos últimos 3 días un chico se declarada ante ti y demostrara todo el amorQue tiene hacia ti Y tendras 1 año de suerte Pero si rompes la cadenita  !	17	
Enviar por WhatsAppCadenas para WhatsApp de retos HOTEstos retos picantes para WhatsApp están orientados a esas parejas o esas personas que están conociendo a un chico o a una chica y que les encantan las situaciones picantes  .	16	
Ese chico desio terminar por algo q la chica sentía en ese momento o antes de ese momento con etro chico  .	12	
Días tristes q pasaron llubia dentro de mi q no paraba ni dejar entrar el sol , el chico decide darle una oportunidad a esa chica para poder recuperar el sol lejano del oriente  .	11	
Paso el tiempo se amaban mas pero siempre en una relación abia alguien q frenara todo en el momento de mi primera alejada de ti uvo un acontesimiento y era q la chica le avía mentido a ese chico el estando aya desde un principio supo lo q su corazón decía , pasaron semanas y el chico vuelve feliz pero aun así con dolor  .	9	
Pasa el tiempo y el chico decide ponerle el tema otra vez , la chica con el corazón en la mano latiendole a mil revoluciones decide apagar el motor y decide decir q era mentira , pasaron los minutos y la chica confiesa su pecado el chico triste destrozado por eso decide acompañarla a la casa y prender su viaje a la suya  .	8	
siempre quise algo asi tan lindo con alguien , sos la chica que soñe desde chico , tenes todo lo que quiero tener siempre , amo tu sonrrisa hermosa que tenes , amo hacerte reirr  .	8	
Euu gorda gracias x hacerme tan feliz , con vos me siento el chico mas afortunado del mundo , para mi sos la chica mas hermosa del universo tanto x fuera como x dentro x eso es que pienso que soy poca cosa para vos  !	7	
Todo empezó así El y yo empezamos hablar de la nada en ese momento el tenia a alguien y yo igual , pero bueno en realidad yo no estaba con nadie por que esa persona no me quería como yo a el y bueno en fin , me empezó a gustar este chico y wou era increíble como detallaba cada cosa de aquella chica que era su novia y como la presumía Dios la presumía tanto que llegue a admirarlo demasiado  .	6	
Una chica conoció a un chico y lo invitó a cenar a su casa  .	6	
Una chica llamada Laura y un chico llamado Ricardo  .	6	
5 la chica le hace recibir una patada en la cara la chico	5	
Un chico pues nimodo q una chica 20  .	5	
Un excelente chico 11 Ya te dijo Que eres un lindo chico , te mereces una chica que te valoré igual que yo lo hice V 5  .	5	
Cada chica tiene qué publicar esto para ver si algún chico le da los huevos para decirte sos mía  .	4	
Cambio c/u x una de las opciones 1 surtida diversion 1 detergente magistral chico 1yogurt de litro dia 1 yerba chica 1 aceite girasol chico 2pure de tomates 1azucar y 2 jugos rinde 2 2 fideos marolio 1cereal krachitos 1leches armonia sachet y 2 jugos 1 papel x 4 blanco y 2jugos1papel x 6 blanco	4	
Es una chica parecida a Barba palvin y un chico re lindo tiene todos unos tatuajes	4	
Eso tal vez pase de aquí a unos 3 años porque el chico creo que ni se anima a abrazar a una chica	4	
ella una chica triunfadora el un chico travieso ella una chica aventurera el un chico escuchador ella una chica de buenos y lindos sentimientos y el solo un admirador de ella  .	4	
tener un chico de amigo que una chica por que aunque lo diga yo habeces las chicas son de lo peor que existe en el mundo pero de lo peor por eso cuando oigo algo de machista o cosas así la verdad	4	
-Una chica con un hermoso cerebro , se enamoró de un chico amante de las mentes vacías  .	3	
1-sos mi chica y yo tu chico y  .	3	
A no es que no te gustaba la chica para el , es que a vos te gustaba el chico para vos	3	
El padre de la chica era muy avaro y al ver al chico le dio una manzana  .	3	
Entiendo , comencé a sacar conclusiones por que una vez me dijiste que cuando un chico te decía que cuando una chica decía groserías era malo , ya no te parecía agradable ése chico , lo que quiero decir es que tal vez malinterpretaste lo que dije y pensaste que yo me refería a eso , pero no , yo me refería a ser cómo Fanny sabés cómo  ?	3	
Eres una chica que arias feliz a cualquier chico pero con migo no creo q lo seas ya creo q ni entrare al cole me entere q estoy mal del	3	
Esa clase de chico ni vale la pena a una chica se la respeta sse la trata  .	3	
Esta el chico que me gusta y como que lo veo con otra chica , o sus actitudes no son las mismas como cuando esta esta chica	3	
Estaba en algo con el chico que me friendzono , pensé que la chica era mi amiga , se lo empezó a chamuyar al chico	3	
Estabas con un chico y con una chica y no se eque le estabad disiendo al chivo	3	
Habia una vez una chica se enamoro de un chico  .	3	
Hay que chico tan malo eres pobre chica	3	
Hoy estaba fuera de mi casa y me tope con una pareja que discutía horrible , el chico le rogaba como un perro a la chica , entonces me pregunté Por qué  ?	3	
JAjaja anda saber como seras ahora jajaja saber los chico que se abra comido esta chica	3	
La chica se encontraba realmente mal por la actitud y lo que el chico decía , su cabeza dio un giro a lo que dijo el doctor pido disculpas mentalmente no soportaría mas con eso  .	3	
Mi esposita bonita hermosa preciosa , mi cielo , mi chica perfecta , mi todo , me haces el chico más dichoso que puede existir , Lo sabias  ?	3	
Mire mi celular unos segundos y decidí escribirle aquel chico Mensaje a Jake Hola , soy la chica del metro	3	
Seol han na descubrio que goo jae hee es una chica que se hace pasar por chico y que kang tae joon volvio al salto de altura solo por goo jae hee ahora espero que han na cumpla su promesa y guarde el secreto	3	
Y la chica de la cual cualquier chico se enamoraría eso es triste  !	3	
A 42 pero no son grande ya que la bota es muy chica asique para alguien con el pie mas chico sirve	2	
Aaaa bb que mas quiere que te diga tu extrañas esa chica que era antes yo extraño el chico que me beso por primera vez y me hizo sentir lo mejor porque a pesar de todo esa chica estaba tragada de ty	2	
Ahy mi guss sabes que sos la persona que mas quiero y la verdad la primero que me iso llorar con tan solo agarrar su mano Sos la chica ideal que cualquier chico quisiera tener Quererte es poco Te amo mejora Y si tuvimos muchos obtaculos para estar juntos y continúar esta amistad Pero eh decidido a esta altura de mi vida donde todas las cosas que yo quiero ser y hacer estan en las manos de Dios Pero quiero llevarte en mi siempre pase lo que pase  .	2	
Aveces los chavos sufren mas por una chica que las chicas por un chico  .	2	
Buenas tardes don benjamin una pregunta en cuanto me haria una casa chica para un perrito chico  ?	2	
Bueno Pero con una chica es obvio es distinto Pero con un chico que tiene novia uno lo ve de otra manera Osea es incomodo nos Si me entendés  !	2	
Cambio c/u x una de las opciones 1 surtida diversion 1 detergente magistral chico 1yogurt de litro dia 1 yerba chica 1 aceite girasol chico 2pure de tomates 1azucar y 2 jugos rinde 2 2 fideos marolio 1cereal krachitos	2	
Cambio c/u x una de las opciones 1 surtida diversion 1 detergente magistral chico 1yogurt de litro dia 1 yerba chica 1 aceite girasol chico 2pure de tomates 1azucar y 2 jugos rinde 2 2 fideos marolio y 1 jugo	2	
Cambio c/u x una de las opciones 1 surtida diversion 1 detergente magistral chico 1yogurt de litro dia 1 yerba chica 1 aceite girasol chico 2pure de tomates 1azucar y 2 jugos rinde 2 2 fideos marolio y 1 jugo 1cereal krachitos 1leches armonia sachet y 2 jugos 1 papel x 4 blanco y 2jugos1papel x 6 blanco	2	
#sobrino,	sobrina
Llamo mi sobrina llorando q mi sobrino estaba discutiendo con la mama  .	3	
Que hermosas palabras sobrina maría por mi sobrino es verdad se lo que mi sobrino luchador Que siempre yebo su familia adelante que lindo muchas felicidades para los dos y van por mucho mucho más porque el amor está Dios me los vendiga	3	
Mi madre y mi sobrino hermosos recuerdos Dios los guarde y los bendiga y a ti sobrina para donde te fuistes David Correa	2	
Mi madre y mi sobrino hermosos recuerdos Dios los guarde y los bendiga y a ti sobrina para donde te fuistes David Correa que te	2	
Primero dejiste es mi sobrina despues la mujer de tu sobrino	2	
Y un sobrino tuyo o una niña una sobrina es ami	2	
A mi sobrino spiderman y a mi sobrina una muñeca	1	
A tu sobrina le presentaremos con migo sobrino	1	
A veces viene aquí pues aquí vive desde pequeño mi sobrino el hijo menor de ella mi otra sobrina esta acompañada y ya tiene un niño de 2 años	1	
Aca de niñera de tu sobrino mas grande y tu sobrina mas chicha	1	
Ahí compañerita Perdón si les quede mal pero me dejaron a mi sobrina y luego a mi sobrino y todavía no vienen por mi sobrino	1	
Aquí que voy a donde mi hermana a configurar el xbox de mi sobrino y la tablet de mi sobrina jaja	1	
Aunque no fuera la novia de tu sobrino era la mejor amiga de tu sobrina	1	
Avisele a jose que no voi a poder ir me tengo que quedar con mi sobrina lo llevaron al hospital a mi sobrino	1	
Ayer fue el cumple de mi sobrino , hoy el de mi sobrina y mañana el de mi tíoNo mmes	1	
Buenas noches mi nombre es ceneida macias tía de Alejandra de usa mi sobrina te comentó que tengo un sobrino que es super hincha del América y quiere que si le podrías hacer el favor de regalarle una camiseta firmada ami me gustaría si tu dices que si yo recogerla y darsela de sorpresa el 6 de enero	1	
Claramente siento una mezcla de enojo y tristeza por situaciones como el cumpleaños de tu sobrino y el próximo cumpleaños de mi sobrina pero te soy sincera a pesar de todo  .	1	
Clsro t digo para q sepas yo no estoi sola aquí vivo cn una sobrina su esposo tres niños i un sobrino	1	
Co el sobrino q tenes kiero ser tu sobrina 2 veses jajaj	1	
Como esta el sobrino , no mi sobrina que ayer me sentí un poco mal pero tranquila ya estoy bien mi sobrina	1	
Con el sobrino bien guapote enla fiesta de Fernanda la sobrina y besina ala bes	1	
Cuando fuy al df a trabajar estube una noche en una fiesta con la sobrina de mi patron y su sobrino pero me cogi ala sobrina no traia condones y la morra estaba chida asi que me valio madres el tiem	1	
Cuando le comente lo de mi sobrino ya no fue necesario salir y el dia q le dije de mi sobrina de traermela tampoco lo hice se quedo con mi hermano	1	
Cursando el sab de 9 a 18 hs no salí me quede en casa tranqui cuidando a mi sobrina un rato y el domingo me fui a rada con mi sobrino vos que hiciste	1	
Durmiendo a mi sobrina y viendo lluvia de hamburguesas 2 con mi sobrino y un primo	1	
El de chalco viene con su sobrina y su esposo , como trae coche su sobrino quiere traer los a conocer la casa y ya de paso va a traer la pintura x q se va a pintar la casa	1	
El jueves fue el cumple de mi sobrina y el martes de mi sobrino y hoy se los festejaron a los 2	1	
El se vino en moto con el sobrino y yo me vine con mi hijo y la sobrina de el en bus	1	
Ella salio y llego dijo sobrina dile a el sobrino que gracias a el	1	
En la klle poniéndole cuidado a mi sobrino y a mi sobrina y tu	1	
Enserio salude a unos i dijo calmate sobrina si n le boi a decir a mi sobrino jajja	1	
Es la promoción de mi sobrina tambien el viernes y sabado de mi otro sobrino no creo que pueda oye pony	1	
Es la sobrina de flor y el muchacho es el sobrino de flor	1	
Es muy hermosa tu sobrina , se vería muy bien con mi sobrino jajaj	1	
Este sabado sale la comparsa d mi hermano y baila mi sobrina la novia de mi sobrino y mi sobrino	1	
Estoy donde mi sobrina porque estaba ayudandole a mi sobrino con una tarea y hasta ahora quede libre	1	
Estoy llendo a ver a mi sobrino y a buscar a mi sobrina que quiere venir a casa	1	
Ey es mi sobrina ke no y el da la mensa aqellad mi sobrino	1	
Falta mi sobrina mi otra tía mi otra prima mi otra hermana y mi otro sobrino	1	
Felicidades al sobrino me toca el viernes a mi con mi sobrina estamos locos con lo del make up y peinado	1	
Feliz navidad sobrina felicitas , al sobrino y a la nena besos y abrazos	1	
Feliz navidad sobrina que dios derrame mucha bendición en su hogar y un saludo al sobrino	1	
Fotos mia y de mi sobrino , foto de ella y la sobrina familia perfecta esoo	1	
Frank Piña Sepa bien como habla y lo q habla ok mi sobrina ed muy niña oky si tanto le momesta mi sobrino x ser gay eliminelo y ya no lo ve o esq te gusta y como no te da pelotablo insultan creo q es mas hombre el q cualquiera	1	
Gracias por la info , mi sobrina se va a comunicar con vos , es para mi sobrino , Xavier Carrizo  .	1	
Gracias sobrino , pero que paso que no entiendo , porque se molesto mi sobrina	1	
Gracias sobrino y esa personita q n esta dond este un feliz día sobrina	1	
Haaaa es sobrino de Guille mi sobrina	1	
Hay gordo lo siento no puedo ir mi hermana esta va para una cita médica con mi sobrina y me toca cuidar a mi sobrino y la casa disculpame	1	
Hermosa Pareja Dios los bendiga sobrino guapo y mi sobrina no se diga y el Bebe saludos	1	
#hermanastro,	hermanastra
Mi hermanastro fallecio hace 4 años y mi hermanastra hace 2 años	1	
Pero tengo que ver si mi hermanastro estara o mi hermanastra o si no tendremos que hacer 2 xD	1	
Si , pq repeti dos veces tercero cuando fallecio mi hermanastro y al año fallecio mi hermanastra que era como mi mejor amiga	1	
#él,	ella
Su alma gemela será todo lo que ella busca en un hombre y lo querrá mucho , por él sentirá mil emociones y aunque ella creerá amarlo en realidad nunca va a sentir por él lo mismo que sintió por el amor de su vida , ella será feliz con él porque le dará todo  .	34	
Y cuando crea que está totalmente enamorada y se sienta plena vendrá el amor de su vida a desestabilizar sus emociones , él querrá volver pero ella ya tendrá a alguien en su vida que será su alma gemela  .	32	
Nada , gracias , simplemente estoy conversando con ella La persona que preguntó se retiró extrañada del lugar El acompañó hasta su casa a su ex novia , ella le pidió que por favor la esperara afuera y él accedió Ella nunca lo hacía esperar en el patio Se quedó 10 minutos esperando y no regresaba  .	19	
Ella se miró al espejo , luego lo miro a él que estaba sentado en la cama , ella le preguntó , aún te sigo gustando  ?	15	
Cuando ella le contó al hombre de Dios lo que había sucedido , él le dijo Ahora vende el aceite de oliva y paga tus deudas ; tú y tus hijos pueden vivir de lo que sobre  .	14	
Entonces ella se acercó a él y con lágrimas en los ojos le preguntó  .	12	
Le gustaba que él le dijera cosas , pero ella callaba  .	8	
Me enamoré de esta reflexión Ella se miró al espejo , luego lo miro a él que estaba sentado en la cama , ella le preguntó , aún te sigo gustando  ?	7	
Mientras terminaba de vendar la herida , le pregunté si ella se alarmaría en caso de que él llegara tarde esa mañana  .	7	
No hace falta recalcar lo amorosa y cariñosa que puede llegar a ser con ese hombre , pues siempre busca la manera de transmitirle su amor y devoción hacia él con detalles mínimos o incluso , muestras de afecto que solo ella se permite a costa de su cuello  .	7	
ella pudo haberlo vencido si no hubiera enamoradose de él  .	7	
A él le gustaba verla cuando estaba distraída , a ella le gustaba sentir su mirada y fingir que no se daba cuenta 500 días con ella	6	
Nicola que no te vengas a hacer la víctima ni vengas a salir aquí con tus caras yo tengo que preguntar Ese es mi deber preguntar y si él es consciente de que vos al menos una vez le has dicho algo sobre eso el mail y así mano ella me ha hecho pero igual yo le sigo diciendo Así es ella otra vos ya es cosa de él pero le preguntó y me dice que nunca lo has hecho según Ball porque se empeñaron decirme que nunca lo has hecho ni que te tuviera rabia O  .	6	
Ninguno de esos fue el caso , él murió por defender a ella de una vejación en una casa en Villa Copacabana  .	6	
porque según ella , yo estaba leyendo su conversación de WhatsappLa verdad a mí qué chingados me importa que ella y el tal Alejandro vayan a terminar , según porque él no valora lo que ella hace , que hagan lo que les de su chingada gana , total es su vida  !	6	
A pesar de todo , ella en algún momento tuvo que irse , él tenia planes y supo como actuar conmigo para yo poder defenderme y saber que hacer en la vida como la rata que soy , pero todo cambio en un pestañeo  .	5	
Ella era diferente , no necesitaba a nadie más , solo lo necesita a él , le daba igual cuanto durara el amor entre ellos , porque ella se agarro a que el significado de la palabra amor no llegaba a nada más de lo que ellos dos tenían  .	5	
Los jóvenes se abrazaron con ternura y luego partieron a cumplir la misión encomendada , ella hacia el norte y él hacia el sur  .	5	
Sabes que es tu mejor amiga cuando tres meses atras le dices que vayan al concierto de pero ella no es la fan del él , sin embargo le agradan algunas canciones y acepto , eso me demostró que es una gran amiga pero lo que me robo el corazón es saber que después de unos días comenzó a escuchar las canciones para aprenderse la letra de cada una	5	
A la chingada con esa vieja , que pendeja ella y que pendejo él  .	4	
Cuando ella le conoció a él ni se inmutó  .	4	
Cuando él se de cuenta de lo que siente por ella , ya ella habrá aprendido a quererse por cuenta propia y simplemente será muy tarde  .	4	
Ella sabia que él la quería , pero ese amor loco ella no lo soportaba  .	4	
Es un nuevo día , él se siente mejor y vuelve con su vida común , ella no deja de pensar en la noche anterior y sólo quiere volver a hablarle y ésta vez ella comienza la conversación pero  .	4	
La cosa seguía , pasaban los meses y entre ellos no cambiaba nada , él era de muchas , ella solo de uno  .	4	
Pero yo estoy con ella y tú estas con él	4	
Se maldijo mil veces por no haber sabido apreciar el amor que ella siempre había sentido hacia él durante años  .	4	
Yo quiero hacer todo bien con él y parece qué a ella le pagan por buscarme  .	4	
pero mi mamá me dijo que ya no tiene el dinero , que tuvo que pagar no sé qué y que se le viene una situación muy difícil económicamente , luego mi papá me dijo que ya no me iba apoyar , que el esperaba más de mi , dijo que su otra hija osea mi media hermana que ella no le a pedido nada y que está estudiando para abogada , él y mi mamá me dijo que estaban muy decepcionados de mi  .	4	
pero pues ayer le toco a él , hoy le toca a ella porque si necesito decirle unas cosas a ella  .	4	
Él le hizo daño a ella , y ella le hizo daño a él  .	4	
-Si-Pues es de ella Por ultimo sale él mas pequeño y regresa a los 45 segundos nada mas , con mas sangre que sus dos hermanos y su padre le pregunta-Hala hijo de donde has conseguido tanta sangre  ?	3	
A él le gustaba verla cuando estaba distraída , a ella le gustaba sentir su mirada y fingir que no se daba cuenta	3	
Blaz-La respuesta a eso le molestaba , la tipa era obvio no lo hizo con ninguna intención de que él lo usara sino para que Finn lo usase con ella seguramente  .	3	
El director Dumbledore camina por los pasillos de Hogwarts , se sentía inquieto , no había podido dormir , todo la noche había pensado en Hermione , ella tenía 22 años y está demasiado buena , más de una vez él había pensado en cómo sería tenerla en la cama  .	3	
El es más alto que ella la altura perfecta para que ella pueda escuchar cómo late su corazón la altura perfecta para que él pueda besar su frente	3	
El gusto no le duro mucho ya que puso obstaculos mayores a los clásicos , él no le importaba y ella si un poco ya que era su familia , al destino al ver la situación tan triste se deprimió  .	3	
Ella era diferente , no necesitaba a nadie más , solo lo necesita a él , le daba igual cuanto durara el amor entre ellos , porque ella se ag	3	
Ella se enamoró de él por el trato , lo que ella no sabía es que él trataba así a todas  .	3	
Entonces ella se acercó a él y con lágrimas en los los ojos le preguntó  .	3	
Es que ayer mi abue iba a ir al banco a hacer un depósito y le dije que en todo caso cuandoAnthony llegue a mi casa , bajemos las dos juntas y me dijo que normal , así que bajamos las dos y se saludaron y ella se fue por su lado y él y yo nos fuimos a la puntaNop , otra vez fue en ropa formalita	3	
Es que de hecho no iba a salir por lo mismo de la escuela , pero mi bff me dijo que urgía platicar y pues fuimos a cenar y de ahí se nos ocurrió ir a algún bar y ella sugirió ir al bar dónde trabaja él	3	
Es que el primo de Karen y yo anbamos en primero pero cortamos y luego conoció a Nicol y andubo con ella , pero desde ahí empecé a tener problemas con ella después nos renconciliamos tiempo después ya en tercero yo volví con él pero solo anduvo conmigo para hacercarce a nicol	3	
Es que el primo de Karen y yo anbamos en primero pero cortamos y luego conoció a Nicol y andubo con ella , pero desde ahí empecé a tener problemas con ella después nos renconciliamos tiempo después ya en tercero yo volví con él pero solo anduvo conmigo para hacercarce a nicol y después nos peliamos todos , pero yo seguía llendo a casa de karen	3	
Finalmente llegó el día en que él le propusó matrimonio , cosa que ella aceptó con ilusión  .	3	
La clase siguió , la compañera de banca de Hermione no dejaba de acariciarle las piernas , cuando sonó la campana , el maestro Snape dio la orden de salir , Hermione fue detenida por él , le dijo que ella no que tenía que hablar de su retraso a la hora de entrada  .	3	
La verdad que si , pero nose que haga lo que quiera yo también voy a hacer lo mismo , lo único que si me llega a engañar con él pajero ese cuando lo vea en la calle le rompo la nariz de una piña y a ella la mando a la mierda pero cuando él la deje o la engañe con alguien se va a acordar de que yo no iba a hacer eso nunca	3	
Los dos estaban caminando en el mismo sentido , y no hablo de la dirección errsntr de sus pasos , él la miro , ella contesto con un suspiro , y el universo conspiró , para abrazarlos , dos extraños bailando bajo la luna , se convierten en amantes al compás de esa extraña melodía , que algunos llaman destino y otros prefieren llamar , casualidad  .	3	
Monroe-FLASH BACK No importaba cuanto la chica se negara , no la dejaria sola , aunque ella no lo acepte con palabras él lo demostraria con acciones  .	3	
Pa mi que fue la Maira porq a mi vieja yo no le conte q él me había sacado a bailar y nose cómo ella se enteró de eso	3	
#papá,	mamá
El 99 , 99 falla Mi mamá me dice MUR Mi papá me dice Ci Mi hermano me dice EL Mi hermana me dice LA Y el bebe me dice GO Como me llamo yo  ?	65	
El 99 , 99 fallaMi mamá me dice MURMi papá me dice CIMi hermana me dice ELMi hermano me dice LAMi bebé me dice GOCómo me llamo yo  ?	38	
Al nacer me vio mi mamá y después mi papá Quien fue la primera persona que me vio  ?	25	
Al nacer me vio mi mamá , después mi papá  .	22	
Al nacer me vio mi mamá y después mi papá Quién fue la primera persona que me vio  ?	22	
Al nacer me vio mi mamá y después mi papá  .	21	
Quiero agradecer a todo aquel que lee este comectario medio largo , Y quiero agradecerle a todos , TODOS Al usuario que leyó todo , a su mamá , a su papá , a su abuela , a su abuelo , a su perro , a su gato y si tiene ardilla , también  .	17	
9 cosas de mi familia 1mi mamá se llama Silvia 2mi papá se llama Darío 3mi tío cantaba en la vieja ucina 4	11	
Al nacer me vio mi mamá y luego mi papá Quien me vio primero  ?	11	
El 99 , 99 fallaMi mamá me dice MURMi papá me dice CIMi hermano me dice ELMi hermana me dice LAY el bebé me dice GOComo me llamo yo  ?	11	
Al nacer me vio mí mamá , después mi papá Quién me vio primero  ?	10	
Yo jamás dije mi papá me llevo a la escuela , mi papá me compro esto para mi siempre fue mi mamá  .	10	
, solo necesito el num de tu mamá o de tu papá	9	
Al nacer me vio mi mamá y después mi papá Quien me vio primero  ?	9	
El 99 , 99 falla Mi mamá me dice MUR Mi papá me dice CIMi hermano me dice EL Mi hermana me dice LA Y el bebe me dice GO Como me llamo yo  ?	9	
Al nacer me vió mi mamá y después mi papá  .	8	
El 99 , 99 fallaMi mamá me dice MUR Mi papá me dice CI Mi hermano me dice EL Mi hermana me dice LA Y el bebé me dice GO Cómo me llamo yo  ?	8	
El 99 , 99 fallaMi mamá me dice MURMi papá me dice CIMi hermano me dice ElMi hermana me dice LAY el bebé me dice GO como me llamo yo  ?	8	
Mi mamá viendo la tv y mi papá lavando el carro	8	
Al nacer me vió mí mamá y después mí papá Quién me vió primero  ?	7	
Hola papá , no sabes que tiene mi mamá  ?	7	
Xq mi mamá me deja pero mi papá al parecer ya no me deja	7	
Asi que la proxima vez que salgamos tienes que hablar con mi papá jajaja , cuando me deje contigo porque mi mamá queria que vinieras a la casa es bien exagerada jajaja y mi papá le dijo que no , que el hablaba contigo cuando me llevara y asi  .	6	
Ayyyy trabajan en un droguería , mi papá es farmacéutico y mi mamá enfermera	6	
Bueno el chiste es que mi mamá quiere que hables con mi papá porque nose ella es asi quiere saber con quien salgo , nose si me entiendas se preocupa por mi pz y pz desde la otra vez que salimos mi papá me dijo y yo le dije que no que me esperara en lo que hablaba contigo y asi  .	6	
El 99 , 99 FallaMí mamá me dice murMí papá me dice ciMí hermano me dice elMí hermana me dice laY el bebé me dice Go Como me llamo yo  ?	6	
El 99 , 99 de las personas lo responde correcto Mi mamá me dice MurMi papá me dice Ci Mi hermano me dice EMi bebé me dice Lago Como me llamo  ?	6	
El 99 , 99 falla Mi mamá me dice MUR Mi papá me dice Ci Mi hermano me dice E Mi hermana me dice LA Y el bebe me dice GO Como me llamo yo  ?	6	
Es de con los veras de echo es un lado de con mi papá mundo y mi mamá Carmen coma Verónica	6	
Si tía no ese pobre no se esta dando cuenta de con quien se metió por Dios vea le mostré esa foto y mi mamá que susto que pego ella mi papá y mi hermana adijeron	6	
Y me dijo que ella no había dicho nada y que cuando quisiéramos lo aclarabamos , o sea y real quiza suena como pinche estupidez o no se , pero si me saca de onda Porque ahorita marco mi papá para hablar con mi hermana y mi mamá me dijo ha viste lo que ocasionaste y yo así de que  ?	6	
sólo de 12 años , el que dice ser papá de mi hermana me manoseaba cuando mi mamá se iba a estudiar por las noches  .	6	
Al nacer Me vio mi mamá y después mi papá  .	5	
Al nacer me vio mi mamá , después mi papá , Cuál me vio primero  ?	5	
Al nacer me vio mi mamá y después mi papá Quien fue la primer persona q me vio  ?	5	
Baby Einstein y mamá es que ya viene mi papá	5	
Bueno me alegro mucho pero mucho que ya estes mejor mi corazón Siempre me voy a preocupar por ti mi bebé Esque pues en si primero me dijeron que me lo iban a quitar , luego que no lo podía usar a partir de las 5 o 6 o hasta que llegue mi papá Y que primero tengo que terminar todo lo que me dice mi mamá y lo mismo para mi hermana Te amo mucho pero mucho mi corazón Si mi corazón estoy bien muchas gracias por preocuparte por mi mi niño	5	
D mamá me ve J mande lo veo por el retrovisor D papá me cambio dice triste J por que lo dices  ?	5	
El 99 , 9 fallaMi mamá me dice murMi papá me dice ciMi hermano me dice elMi hermana me dice laEl bebé me dice goCómo me llamo  ?	5	
El 99 , 99 fallaMi mamá me dice MUR Mi papá me dice CIMi hermano me dice ELMi hermana me dice LAY el bebé me dice GOComo me llamo yo  ?	5	
La familia de tu papá color azulLa familia de tu mamá color verdeE insisto yo con mis ojos cafés me siento mal	5	
Las separaron al nacerUna vive con la mamá y la otra vive con el papá  .	5	
Lo que mas detesto en esta vida es a una mala madre , porque papá es cualquier hp , pero mamá solo hay una , y como es que	5	
Mi bebé Yo también te extraño mucho pero mucho Si amor Pues si quieres le digo a mi papá que el miércoles también mi mamá descansa Muchas gracias mi amor Si mi cielo enserio Eso fue lo bueno Si amor  .	5	
Te quiero y te voy a querer siempre Y mientras tu y tu mamá me lo permitan Voy a ser tu papá Y gracias  .	5	
Vez que te conté de lo de mis primas que su mamá falleció también estuvieron un tiempo con sus tíos hermano de su mamá pero tuvieron problemas pero era por parte de su tío y se fueron con su madrina y ahí creo están todavía sólo que la mayor ya se independizó , y una vez mi mamá le dijo a mi papá que mejor las hubieran traído aquí a vivir pero pues ya se quedaron con su madrina  .	5	
Ahi esta mi papá tomando alcohol , ahi esta mi mamá teniendome rencor , ya no aguanto mas , expresare mi dolor , ya me quiero ir alla arriba con dios  .	4	
Dijo mi papá que mande un audio tu mamá	4	
El 99 , 99 falla Mi mamá me dice MUR Mi papá me dice Ci Mi hermano me dice EL Mi hermana me dice LA Y el bebe me dice GO Cómo me llamo yo  ?	4	
El 99 , 99 fallaMi mamá me dice MURmi papá me dice CIMi hermano me dice ELmi hermano me dice LAY el bebé me dice GOComo me llamo yo  ?	4	
#tío,	tía
El 12 fuimos a donde mi bisabuela amor y con ese tio osea jamas le he dicho tío desde que se caso con mi tía pero es el que se lleva conmigo Y fuimos a la tienda y me dice Vale dime la neta ya tienes novio verdad  ?	8	
Estas son las mañanitas que cantaba el Damihan , tu tío Martín y tu tía Alma  .	5	
Ah como mi tío juan y mi tía amor  .	4	
Gracias tía igualmente saluditos a mi tío y a los niños dlb	4	
Igualita esa princesa a su papa , elegante y bella como su tía e inteligente como su tío que esta en Bolivia  .	4	
Jueves de salida a posadas a visitar a la familia el tío pelado y norma , después la tía Teresa y la tía beba , de paso conocer la nueva costanera que lindo que esta todoo  !	4	
Dice que el tío se ha endeudado con el banco y la tía tiene que trabajar más porq No les está dando a sus hijos	3	
Entonces mi mama le decía que mi tío René valla para alla y se quede y el de venga en el auto de mi tío asi me lleve y mi papa no quiere Xq dice que mi tía Catalina no quiere que el se valla	3	
Gracias tío , saludos a mi tía y a quique	3	
Hola tía , bueno le podrías pasar este mensaje a mi tío Ivan  .	3	
Hola tía gracias a usted por lidiarnos jiii como no iba a ver a mi tío yo tambien lo mire contento  .	3	
Las tía lo van a saludar al tío Joel x su cumple  .	3	
Mi tío Homer Roche debería ser los comerciales si o no tía Esmeralda De Rocha	3	
Mi tío viene con mi tía y el bebé el sabado	3	
Si me dijo algo , q , yo vi , y me dijo q , si , se va mi tío primero , después mi tía y el  .	3	
Si mi tío tuviera tetas seria mi tía	3	
Sos lo mejor que me paso en la vidad tía mandarle saludos a el tío y a loli y rami	3	
Su hermana el tío pedro y la tía nery	3	
Y bueno el cuando estaba en la mesa en las fiestas a esa edad se arma una discusión entre los familiares si empiezan a agredir tirarse comida y un tío de el de parte de su padre la agarraba a latigazos a su tía y la dejaba invalida en el suelo  .	3	
Y como nosotros vivíamos llendo para la casa de ellos ellos le dicen tío a papi y tía a mami y con el Ema el hermano que canta	3	
apenas vino mi tío lolo y mi tía y vino el con ellos	3	
q hacen ahi el tío poly y la tía dimanita	3	
-Mi papá favorito Luis Arturo Garcés-Mi mama favorita Evelin Paramo-Mi hermanita favorita Marisol Perez y Mariana Ramirez-Mi hermanito favorito Ligth Akiyama-Mi tía favorita Jesi Montesinos Gonzálezb-Mi tío favorito Joshua Arias-Mi primo favorito Juan Almanza-Mi prima favorita Vanessa Ramirez-M	2	
-Mi papá favorito Luis Arturo Garcés-Mi mama favorita Evelin Paramo-Mi hermanita favorita Marisol Perez y Mariana Ramirez-Mi hermanito favorito Ligth Akiyama-Mi tía favorita Jesi Montesinos Gonzálezb-Mi tío favorito Joshua Arias-Mi primo favorito Juan Almanza-Mi prima favorita Vanessa Ramirez-Mi novio	2	
-Mi papá favorito Luis Arturo Garcés-Mi mama favorita Evelin Paramo-Mi hermanita favorita Marisol Perez y Mariana Ramirez-Mi hermanito favorito Ligth Akiyama-Mi tía favorita Jesi Montesinos Gonzálezb-Mi tío favorito Joshua Arias-Mi primo favorito Juan Almanza-Mi prima favorita Vanessa Ramirez-Mi novio guapísimo Milton Hernandez Ortega-Mi crush no tengo-El amante  ?	2	
A pero d ultima voy andar x lo d la tía le tengo q llevar el alcolchado al tío y paso por tu casa yo sino n llego ahir t aviso y venís vos como quieras	2	
Aaaa q lindo mandale saludo a la tía y a mi tío que lindo que estén en familia Me encanta	2	
Ahora mi tía le dirá a mi tío y mi tío le retará a mi papá y me van a retar ami Y Así se va a enterar toda la familia de mi papá	2	
Ahora mi tía le dirá a mi tío y mi tío le retará a mi papá y me van a retar ami Y Así se va a enterar toda la familia de mi papá voy a morir	2	
Al tío aron con la tía Marce los vinos que pava somos	2	
Asado con la tía mari , el tío Mario y gonza	2	
Buenas noches prima yo la llama para preguntarle lo siguiente , es que aprovechando que mi tío Don y mi tía Mónica estan aquí en la guajira ; y recordando que ustedes comentaron que tenian años de no verlos  .	2	
Bueno la voy a pasar con Diego tambien El va a ir con su familia Ya la tía mirta el tio los papas de el y mis papas ya arreglaron y dijieron qe vamos a pasar todos juntos en la casa de la tía Para que el tío julio no este mal pq este año al principio falleció la mama de el	2	
Con la triste noticia que falleció una tía de mi esposa Patricia Angelica Rodriguez Urbina y acompañar a su tío en estos tristes y duros momentos q  .	2	
Con los Hijos deo tío Juan Ariel y la tía	2	
Con mi tía liza y mi tío leo	2	
De fijo que es un tío pero tiene pero de tía  .	2	
Esta mi tío jorge su mujer sus prima d mi tía y niño estan en l , casa toditos	2	
Felicidadez tía que se la pase super bien con mis primos y mi tío	2	
Gracias tía , feliz año nuevo yo también la quiero mucho a usted y mi tío Jorge y mis primos	2	
Hasta que hora te podras quedar hasi le digo al tío tito que bengan mas tarde el o la tía benia a cuidar a la abu	2	
Hl tío mandale saludos a la tía yeni y muchas felicidades	2	
Hola abuelo , podrías pasarme el número de celular de la tía Rosi y del tío Julio  ?	2	
Hola mi amor buenas noches ya llegue estoy en la casa de mi tía ada falleció su mama de mi tío Miguel puedes creer eso	2	
Hola papi recién le avisa el Sergio a la mami , que se murió el hijo del tío arberto y la tía choli el gabriel , estaba trabajando y se callo y reventó la cabeza  .	2	
Hola tía como estas como sigue el tío	2	
Hola tía una preguntota el jefe de mi tío no le ha dicho	2	
Hola tío soy Ashley tío le puede preguntar a mi tía si esta mi celular en el	2	
Ingasu mi tío esta gritando el nombre de mi tía y me da miedo jajajaSi pero un poco de todo	2	
La tía ahí y el tío se dur	2	
#hijos,	hijas
Roberto tiene 3 hijas , y cada hija tiene un hermano Cuantos hijos tiene Roberto  ?	32	
Roberto tiene 3 hijas , y cada hija tiene un hermano cuantos hijos tiene Roberto  ?	11	
Robertox tiene 3 hijas , y cada hija tiene un hermano Cuantos hijos tiene Roberto  ?	7	
Y como mis hijas dios no me dio hijos pero me envio unos angelitos que cuidar , y cuando necesite de mi consuelo ylos brazos abiertos siempre tendré  .	7	
Roberto tiene 3 hijas , y cada hija tiene un hermano Cuántos hijos tiene Roberto  ?	6	
por que las tres hermanas tienen el mismo hermano si te has equivocado igual que yo tienes que subir esto a tu historia Roberto tiene 3 hijas , y cada hija tiene un hermano Cuantos hijos tiene Roberto  ?	5	
Si Roberto tiene 3 hijas , y cada hija tiene un hermano Cuantos hijos tiene Roberto  .	4	
Ellos traerán a tus hijos en sus brazos , y cargarán a tus hijas en sus hombros  .	3	
La respuesta es 4 porque las 3 hermanas tienen el mismo hermano , si respondiste mal tenes q poner Roberto tiene 3 hijas , cada hija tiene un hermano cuantos hijos tiene Roberto  ?	3	
Nose princesa me siento rara no me cae el 20 de tener DOS hijas ahora tres aiii Pero son ermozos los hijos bb No no le eh dicho tengo nervios de qeme va a decir	3	
Nose princesa me siento rara no me cae el 20 de tener DOS hijas ahora tres aiii Pero son ermozos los hijos bb No no le eh dicho tengo nervios de qeme va a decir Vale bb me parece perfecto	3	
Nose princesa me siento rara no me cae el 20 de tener DOS hijas ahora tres aiii Pero son ermozos los hijos bb No no le eh dicho tengo nervios de qeme va a decir Vale bb me parece perfecto Espero qe si sea un niño chinito	3	
Roberto tiene 3 hijas , cada hijas tiene un hermano Cuantos hijos tiene en total Roberto  ?	3	
Roberto tiene 3 hijas y cada hija tiene un hermano Cuantos hijos tiene Roberto  ?	3	
Roberto tiene 3 hijas y cada hija tiene un hermano cuantos hijos tiene Roberto  ?	3	
Roberto tiene 3 hijas y cada una tiene un herman entonces roberto tiene 4 hijos tres nenas y un nene	3	
Y como mis hijas dios no me dio hijos pero me envio unos angelitos que cuidar , y cuando necesite de mi consuelo ylos brazos abiertos siempre tendran en cualquier momentopara ustedes siempre estaré  .	3	
0 hijos por que son 3 hijas  ?	2	
Ah no en ese sentido yo no soy así , y ella sabe que con las unicas mujeres que mensajeo son mis hermanas y mis hijas , alla de ves en cuando con la mama de mis hijos y eso ppr cuestiones de salud o de apoyo	2	
Me meto porque no me parece justo como son con doña emma y que solo porque ale se la pasa unos días de vacaciones ya es la peor de las hijas y que valla que todos sus hijos son peor	2	
Roberto tiene 3 hijas , cada hija tiene un hermano Cuantos hijos tiene en total Roberto  ?	2	
Roberto tiene 3 hijas , y cada hija tiene 1 hermano cuantos hijos tiene Roberto  ?	2	
Si te has equivocado igual que yo tienes que subir esto a tu historia Roberto tiene 3 hijas , y cada hija tiene un hermano Cuantos hijos tiene Roberto  ?	2	
Siempre veo salir chicas de la casa a toda hora , pense que eran hijas , sobrinas o amigas de sus hijos  .	2	
Y ahora con ilusión y con mucha emoción tengo la responsabilidadde guiarlas en el camino del bieny ser para ustedes un ejemplo y ser como mis hijas dios no me dio hijos pero me envio unos angelitos que cuidar cuando necesite de mi consuelo y un	2	
Y como mis hijas dios no me dio hijos pero me envio unos angelitos que cuidar	2	
Y como mis hijas dios no me dio hijos pero me envio unos angelitos que cuidar , y cuando necesite de mi consuelo ylos brazos abiertos siempre tendran	2	
sencillo limpien uds mismos su mierdero y no sean estúpidos que todos no nacieron en cuna de oro para tener estudio muchas de ellas ni la primaria terminaron no porque no quisieran sino porque no tuvieron elección no creo que se aguanten tanto maltrato porque quieran es sencillamente porque les toca aparte las mujeres hijas de papi y mami ya ni quieren atender a sus propios hijos prefieren pagar para que ayuden o no mejor para que críen los hijos que parieron que aparte de todo muchas veces asta  .	2	
0 hijos por que son 3 hijas , no tiene hijos , puede ser  ?	1	
4 hijos en rotal tiene 3 hijas y 1 hijo	1	
4 hijos entre todos 3 hijas y 1 hijo	1	
@giraldo2865 Qué boleta una mujer hablando así de otra , ojalá y no tenga hijas mujeres porque en los hijos se pagan muchos errores  .	1	
A mis hijos full control y a mis hijas no tanto	1	
Aaaa que pena si los hijos son hetmosos yo soy felis con mis hijas y ñietas	1	
Aca esan la hijas te mi tía y niña y los hijos de Horacio	1	
Aca esan la hijas te mi tía y niña y los hijos de oracio	1	
Ada necesito un favor de ti pero chama a mi hermana se le metieron el primero a su casa x el patio y se le llevaton un poco de ropa de los hijos entonces quería saber si ustedes tienen ropita de sus hijas q no le pongan para q me la regalen y yo llevarsela q pena pedirle eso pero ustedes son de confianza	1	
Ademas tengo 2 hijas , quien quiere mujer con hijos ajenos jajaja	1	
Ah mi hijas bonitas y mi hijos bonitos te amooo más	1	
Ah mi hijas bonitas y mi hijos bonitos te amooo más dios mi familia abrazo	1	
Ahy lpm lloro blda , sos mas tierna amor , yo tambien te re amo blda , y ojala esta amista dure años y años y que estemos re viejas , y que nuestras futuras hijas sean haci de amigas como nosotras , y que tus hijos me digan tia , y los mios a vs	1	
Amor esq el dever es d el d cuidar d sus hijos no tu bb tu tienes mucho mas dever con tus hijas y nietos y familia	1	
Aplaudo a todas las que fueron a la marcha con ese motivo , por el de la igualdad , por el de hablar por nuestras compañeras asesinadas por hijos de puta , por que el día de mañana , mis hijas van a tener una voz propia y no sr van a dejar llevar por lo que la sociedad viva	1	
Asi que si ves alguna familia donde solo aiga solo hijos hombres o solo hijas mujeres	1	
Así que los que tenemos hijos enseñarles a respetar a una mujer y a las hijas a hacerce respetar	1	
Ay hubieras venido por que los niños me estuvieron molestando con vas a tenes hijos con ángel Uyyyy y luego alison le dijo somos sus hijas ay no	1	
Ayer me dije qe seguía con mi marido por mis hijas dijo estas mal pq un día los hijos de van y tu te vas a qedar sola	1	
Años y q tenia como 4 hijos pero vivía con dos hijas una gordaaaaaaaaaaa y otra como de 15 años y esta ebarazada  .	1	
Bueno es lo k m comento ella ya bueno ase día y ella sabes mis problema y ella m dice uno x los hijos hay k sacrificarse xk a mi m d pena son mis hijas	1	
Bueno mis hijas son aparte xq usted sabe que no es el mismo amor de sus hijos a una mujer o a un hombre	1	
#policía,	policía
#completo,	completamente
Ahora te siento mas mio q nunca y yo completamente tuya entregada a vs y a tu amor , completo	1	
Amigos pero muyyy completo todo lo que te vamos hacer te van a dejar completamente	1	
Amor ya me dio sueño que descanses te amo mucho que sueñes conmigo así como yo haré contigo eres mi todo , mi mundo completo santiago te amo demasiado estoy completamente enamorada de ti	1	
Asi le sacaría todo completamente el suéter y el pants completo	1	
Cree llevar la razón por completo , y que la que esta completamente errada soy yo  .	1	
Cuando me vas a enviar una foto completamente desnuda pero cuerpo completo	1	
Hola Pao , acabo de leer tu mensaje y realmente es mi mayor deseo apoyarte y ayudarte , sin embargo estamos en tiempo de vacas flacas , me encontró la maestría y se llevo mi sueldo completo , Jaime esta completamente con lo justo por el camión que esta haciendo arreglar  .	1	
Ni yo de echo hoy estuve a punto de decírtelo y es que mi amor te juro que me nace decírtelo por que es lo que siento completamente por ti mi corazón te pertenece por completo	1	
Nose pero ya no te amo como antes osea antes no pensava en cualquier otra chica antes las ignorava X completo me yegaron muxisimos rumores y los ignorava y Asia estava completamente enamorada de ti	1	
Nunca me diste la oportunidad de conocerte completamente Y tu tampoco tomaste el tiempo de conocerme por completo cariño	1	
Para meterlo lento y sacarlo lento completamente , así varias veces hasta que lo tendrás dentro y no saldrá por completo	1	
Porque te amo , y cuando estaba contigo no necesitaba nada más para ser feliz y me sentía completo y que no me faltaba nada , me enamore completamente de ti y superar nuestras metas juntos y apoyarnos al uno al otro y mucho más	1	
Pq no me mandas una tuya de cuerpo completo así como te la mande yo completamente desnuda	1	
Te amo , y me gusta conocerte y se que aun no lo hago completamente , peri quiero conocerte completo	1	
Todo lo que ahora conozco es parcial e incompleto , pero luego conoceré todo por completo , tal como Dios ya me conoce a mí completamente  .	1	
Tu castigo sera el desvestirte completamente , tomarte una foto de cuerpo completo y cuando nos veamos , que me muestres la foyo	1	
Y esas mesas que me mandaste en las fotos son de madera macizas completamente y se les da un color completo	1	
Ya no importa , estoy decidida a olvidarme por completo de ti , darle vuelta a la pagina y sacarte completamente de mi corazón	1	
ahí dio 3 solo tenia que esperar para encontrar a la chica ideal esa que me aga sentir de otro mundo alguien así de especial , a mi Copito a ti esa chica con la que me siento completo , sos la parte que me faltaba para ser yo completamente	1	
mejor dicho nunca te conocí y borrame por completo de wasa ahí una parte donde lo puedes hacer completamente	1	
tengo sentimientos q nunca habían despertado con vs soy demostrativa me brindo x completo y te dije q quiero ser completamente tuya , yo te lo propuse xq para mi es importante lo q quiero darte	1	
#afortunado,	afortunadamente
#rápido,	rápidamente
Wow nunca había recibido notas tan rápidamente , sé que son 2 solamente pero jolín me han llegado super rápido , si que está ardido el fandom	3	
Alexander Voy a meterlo mas rápido empieza a empujar mas fuerte haciendo que rápidamente entre 3 / 4 de su miembro Ahh cada vez mas apretado	1	
Caminé a paso rápido a la puerta , la abrí rápidamente Jimin  !	1	
Dejo pasar rápidamente dos dedos dentro de ti , moviendolos rápido y chupando aún fuerte tus pechos , bebiendo tu leche Hmmm , anda mi vida , correte  .	1	
Mamita eso debe de ser intolerancia a la lactosa o infección llévalo al médico para que le anden rápido con eso para que no se deshidrate y vaya a perder peso rápidamente  .	1	
Wow nunca había recibido notas tan rápidamente , sé que son 2 solamente pero jolín me han llegado super rápido	1	
al parecer te estas diviertiendo con otra de tus amantes-lo miro serio mientras lloraba y salgo rápidamente del lugar yendome lo más rápido posible-	1	
#raro,	raramente
Es que es lo que es , es raro todo entre nosotros lo es pero es raramente hermoso , eso lo hace auténtico , un amor 100 autentico y especial	1	
Sii jaja pues nose yo te quiero raramente porque mi amor es raro igual que yo v	1	
#increíble,	increíblemente
Espero q pases un día increíble , comas de manera increible , festejes increíblemente , te hagan regalos super copados , te saluden 1000000000 personas , te quieran mas miles de millones y vos cumplas trillones de años mas  !	3	
la verdad increíble la pasamos re bien increíblemente y la buena onda duro poquito un dia jaja es para reirse mucho bueno che pasala lindo con tu amigito cuidateeee no seas tontuela eh pense qe estavas con tu nenes con acompañada de amigito qe sosiable me	1	
la verdad increíble la pasamos re bien increíblemente y la buena onda duro poquito un dia jaja es para reirse mucho bueno che pasala lindo con tu amigito cuidateeee no seas tontuela eh pense qe estavas con tu nenes con acompañada de amigito qe sosiable sos che te admiro gordi	1	
no dejes que tu maquillaje luzca con cuarteaduras y reseca tengo para ti farsali volcánico primer que te ayudará acondicionar la piel seca y restaura el daño causado por el sol y el acné gracias a su altp contenido aceitoso con solo unas gotas dos veces por semana tu piel lucirá increíblemente hidratada y gracias a sus propiedades anti inflamatorias y antioxidantes tmbn es increíble para combatir las estrías pocas piezas chicas por solo 160	1	
no dejes que tu maquillaje luzca con cuarteaduras y reseca tengo para ti farsali volcánico primer que te ayudará acondicionar la piel seca y restaura el daño causado por el sol y el acné gracias a su altp contenido aceitoso con solo unas gotas dos veces por semana tu piel lucirá increíblemente hidratada y gracias a sus propiedades anti inflamatorias y antioxidantes tmbn es increíble para combatir las estrías pocas piezas chicas por solo 160 o 2x 280	1	
#posible,	posiblemente
Perdón si te estoy tratando mal , esq osea me embola q la otra sea haci , osea quiero estar contigo x lo menos un día oses hace una semana que no te veo y posiblemente mañana sea el único día posible en el que nos podremos ver	3	
Ahora ya se cual es el final de Dragon Ball Super es posible que ese titulo del capitulo 131 se real o posiblemente	1	
Ahora ya se cual es el final de Dragon Ball Super es posible que ese titulo del capitulo 131 se real o posiblemente no pero en verdad solo leerlo me dolió mucho  .	1	
Ahora ya se cual es el final de Dragon Ball Super es posible que ese titulo del capitulo 131 sea real o posiblemente no pero en verdad solo leerlo me dolió mucho  .	1	
Aré lo posible por ir el sábado , pero no es seguro porque posiblemente me darán una clase , si vas espero que te diviertas	1	
Buenas tardes , lamento molestar , pero quería saber si es posible que llegue mañana ya que este fin de semana no estaré en comitan posiblemente y me gustaría saber si podría llegar de sorpresa para Diana mañana	1	
Desoues tendre un horita hasta las 10 pero mañana posiblemente Yhamir miki y pamelita sten tambn primera pueda ser posible sip	1	
Estamos iniciando el mes , posiblemente pueda conseguirle algo pero lo antes posible	1	
Oh posiblemente en la mañana pero are lo posible para salir en la mañana	1	
Si te ven posiblemente me saqien la repita y la juana me quite la posible herencia y la maldita esta que ya mismo cobra	1	
Y le di un pequeño posible pedido veanlo si el posiblemente este mañana alla en palos	1	
Yo posiblemente llegue al segundo bueno mas bien hare tofo lo posible pero no creo la vdd	1	
Yá se ke avecina una meta nueva , posiblemente principios de año nuevo , hasta poder lograr el objetivo lo más pronto posible	1	
#desgraciado,	desfraciadamente
#alegre,	alegremente
Chica alegremente empieza a dar saltitos mientras canta una canción alegre v lara , lara , lara	1	
#general,	generalmente
Si , solo un pequeño comentario , no precisamente contra la chica , es un comentario general De las chicas que han pasado por tu vida generalmente hablando , No he podido crear un perfil de tus gustos , Me parece impresionante cómo puedes manejar tantas conversaciones parecidas con varias chicas y aún así ser discreto con cada una de ellas , tu capacidad de conquista y abrirte al sexo opuesto es fasinante , además de que las elecciones que haces no son para nada descabelladas , se acoplan a tu perfil , es interesante	1	
si lo c , me he dado cuenta de eso pero generalmente eso te pasa cuando tienes un dia horrible en general y no de la nada como en estos casos	1	
#afortunado,	afortunadamente
#libre,	libremente
me parece que libremente es un adverbio de modo derivado del adjetivo libre y tranquilidad es una categoría gramatical nombre  .	2	
Asi como tu eres libre de chulear y lucirte libremente con quiens e te plazaca	1	
Ay , mi amor , sería tan perfecto , estar desnudos y poder tocar tus piernas y tus pechos libremente y que nuestros cuerpos hagan contacto libre , yo se que eso nos pasará Anabel  .	1	
Dejare esto x aqui ya q estoy arta d ver tanta gente discutiendo sin razón ya q en la vida dios nos dio libre albedrío y podemos elegir libremente ya q somos un pais libre gracias al señor x el q les de la gana voten pr haganlo y dejen d hablar tanta paja	1	
Ni siquiera puedo enviarte notas de voz para explicarme bien xq es un lío a lo que yo este libre y tenga la oportunidad de hablar con ustedes libremente yo le digo claro y raspao como es que s maneja las cosas aqui	1	
No tengo vato pero ya no quiero que me busques nomas me haces sentir de una manera que la verdad no van así que cada quien por su lado tu anda con la que quieras y gustes y puedes hacer lo que quieras y lo que se antoje eres libre a si como yo puedo salir libremente	1	
Pero ya estas libre y puedes hablar libremente	1	
Quisiera quiero ser libre para poder andar libremente contigo	1	
Quisiera quiero ser libre para poder andar libremente contigo por eso me desanimo	1	
Sientete libre de decirme la verdad verdadera asi enserio libremente	1	
Yo opino k esa mejor sea libre osea k publinquen libremente lo k gusten	1	
#seguro,	seguramente
A ver seguramente evacuaran la zona y os pondrán en un lugar seguro hasta que vengan los bomberos	1	
Aaaaa claro seguramente konami haga eso pero nada es seguro te da señales falsa y te tienta con representantes bueno para q gastes todo y no tengas nada para las leyendas	1	
Ahh si pero ahí te enseñan una poronga por si no sabías seguramente sabes lo que es java , o seguro sabes lo que es una terminal , o cmd , o linux , o un codigo abierto , o un servidor , y como conectarte , debes saber lo que es una conexión de fibra óptica , o el código binario , o tipos de archivos , o comandos , de seguro sabes todo eso	1	
Alguno seguro lo va a entender que seguramente se haga el boludo	1	
Buee seguro ellos la tenian rre clara cuando entraron ahi seguramente	1	
Bueno pero seguro no lo hace mas onda cuando te enojas con el , entiende seguramente no lo va a hacer mas	1	
Claro seguramente ahora te haces el superado porqe estas sobrio y seguro ya l	1	
Con el que seguro jodo es con damian y seguramente que si	1	
Con fran seguramente vayamos a comer a casa y despues seguro salimos	1	
De seguro el tmb te extraña , pero desde donde sea que este , seguramente pide que seas fuerte , por el	1	
Difícil ella tiene que trabajar pero también necesita otra cirugía y seguramente le quitara el seguro	1	
Dijo la cami que seguramente la peli empieza a las 10 30 , 11 00 seguro por que viste que siempre tardan dijo que si querés que vallas	1	
Es q dijo q de una vez iba a comprar regalos para su hermana y su hermano y seguramente va a durar horas aunq es seguro q entre a la tienda con ella ps pero	1	
Es q dijo q de una vez iba a comprar regalos para su hermana y su hermano y seguramente va a durar horas aunq es seguro q entre a la tienda con ella ps pero va a durar horas seguramente	1	
Esta a me diste en 400 seguro t la dejaron en 340 a ti seguramente n le vas a ganar algo	1	
Esta x hacerse cargo Carlitos vallejos pero seguramente salga el pulí en esta semana y se va hacer cargo el seguro	1	
Estas haciendo que caiga en un pozo depresivo y seguramente si seguis asi me vas a hacer ir al psicologo y seguro intente suicidarme debido a tus acciones encontra de mi  .	1	
Exe , seguramente estas amanecido y peleando con tu amor , seguro que nadie mas te respondió y me hablaste a mi	1	
Felicidades chicos por otro torneo mas para ustedes se lo merecen y sigan así gracias gus por haber dejado ser parte de este equipo gracias por todo y seguro el año que viene nos veremos enfrentados seguramente y si no los veo antes de la fiesta que tengan una feliz navidad y buen año para todos para los que son mis amigos y para los que no un abrazo enorme tomen mucho	1	
Felicitaciones , hubo errores seguro como en todos lados , seguramente la próxima será distinto , y que quede claro para evitar comentarios que no vienen a mi publicación hablo de instalaciones instalaciones , no de otro tema  .	1	
Hay personas que seguramente lo dejarían todo x vs estoy seguro	1	
Iba a poner que seguro la estabas botiniando no puse nada por lo que dijiste pero seguramente si	1	
Imagino , seguramente te vea , porque lo mas seguro esque valla y siempre qur voy te veo jaja andas de un lado psra otro pero oye por lo menos tienes trabajo y eso esta bien quien me diera a mi	1	
Jajajaja seguro pedía uno mejor Y seguramente alguien pidió mi billetera	1	
Jajajajajajaja y seguramente eso es mas seguro que la seguridad	1	
La copia legalizada del seguro q solicitan , debe ser el seguro con el que cuenta la empresa para su personal interno , donde seguramente lo cubre de accidentes de trabajo , etc  .	1	
Las personas suelen esconder lo que realmente quieren por eso seguro te dijo que no quería ir solo , seguramente sabia que vos le negarías el hecho de que estas cansado de todo los que pasaron	1	
Le pase tu num asi que seguro te va a llamar el viernes porque le dije que los viernes seguramente podrias tener libre a la	1	
Lo loco es que seguramente hay canciones que te dedico y me olvido pero si ves mi lista seguro estan  .	1	
Mañana seguro voy a salir pero x Tierra seguramente	1	
Me parecio que eran ustedes , escuche una voz la de chiche seguro y vi una mano , la tuya seguramente	1	
Me termine de peliar con mi vieja mañana seguramente me valla a buscar las cosas seguro que discutamos y me venga a vivir de nuevo con mi papa  .	1	
Mira confundido aquí no roban Minho al parecer al señor Do le dieron una herencia millonaria , Key dice que los ladrones seguramente fueron sus mismos familiares T seguro  ?	1	
Nmms seguramente por la nada de seguro algo le dices que yo ni en cuenta	1	
No lo hará respondí llevando mi mirada a él el vendrá aquí , por ustedes , de eso estoy seguro suspiré solo le esta llevando un poco más de tiempo , seguramente su padre intenta detenerlo , tiene que perderlos antes de venir aquí , si viene directamente la manada no podrá ayudarlo	1	
No te preocupes igual seguramente me voy a quedar charlando con mía si va porque las chicas seguro que me dejan de lado	1	
Pasale mi Fb a tu amiga por que de seguro no lo apunto , si , seguramente es eso v	1	
Pero seguramente ya debe tener a quien hacer y para mi nada seguro	1	
Pero seguro voy a volver y en otro momento me vendré a vivir , seguramente	1	
Pero vos sos inteligente y seguro estudias cuando tenias que estudiar , seguramente sos asi	1	
Pero yo ya dije k no iba seguro d echo no voy ir seguramente	1	
Puedo hablarte lo mas tranca aca asi pero si no tengo nada seguro de como va a salir todo seguramente no haga nada	1	
Pues a mi me dijo en de recursos humanos que que de seguro mañana van a revisar los currículum y que seguramente el miércoles tenian	1	
Que cagada pero bueno ojala algun dia se de pero seguramente en un telo seguro ja	1	
Quiero decir que te voy q romper las pelotas seguramente y si no estas seguro de lo q querés cada uno por su lado	1	
Sabes que ay cosas peores , pero no ay de que llorar Natalia cAy algunos que de seguro van a ir , en mi caso yo si , pero seguramente capas te digan que si iran	1	
Se dejo llevar por el momento con la vieja esa , entre que ya estaba borracho y que seguro ya te estaba hechando el ojo , pues seguramente por eso se sintio mal	1	
Si , seguramente , pero de que es seguro es seguro	1	
Si , seguro ya todo va a pasar y seguramente todo va a salir bien  !	1	
Si no te gusta trabaja de otra cosa , uno no va a una guardia xq tiene ganas de pasear , seguramente q estara colapsada xq el trauma es un desastre es un desastre y seguro q ella carga con toda la angustia de la gente q llega y esta impotente ante un enfermo pero ellos tienen q tratarte con respeto y sin juzgarte	1	
#rápido,	rápidamente
Wow nunca había recibido notas tan rápidamente , sé que son 2 solamente pero jolín me han llegado super rápido , si que está ardido el fandom	3	
Alexander Voy a meterlo mas rápido empieza a empujar mas fuerte haciendo que rápidamente entre 3 / 4 de su miembro Ahh cada vez mas apretado	1	
Caminé a paso rápido a la puerta , la abrí rápidamente Jimin  !	1	
Dejo pasar rápidamente dos dedos dentro de ti , moviendolos rápido y chupando aún fuerte tus pechos , bebiendo tu leche Hmmm , anda mi vida , correte  .	1	
Mamita eso debe de ser intolerancia a la lactosa o infección llévalo al médico para que le anden rápido con eso para que no se deshidrate y vaya a perder peso rápidamente  .	1	
Wow nunca había recibido notas tan rápidamente , sé que son 2 solamente pero jolín me han llegado super rápido	1	
al parecer te estas diviertiendo con otra de tus amantes-lo miro serio mientras lloraba y salgo rápidamente del lugar yendome lo más rápido posible-	1	
#aparente,	aparentemente
#eficiente,	eficientemente
#rápido,	rápidamente
Wow nunca había recibido notas tan rápidamente , sé que son 2 solamente pero jolín me han llegado super rápido , si que está ardido el fandom	3	
Alexander Voy a meterlo mas rápido empieza a empujar mas fuerte haciendo que rápidamente entre 3 / 4 de su miembro Ahh cada vez mas apretado	1	
Caminé a paso rápido a la puerta , la abrí rápidamente Jimin  !	1	
Dejo pasar rápidamente dos dedos dentro de ti , moviendolos rápido y chupando aún fuerte tus pechos , bebiendo tu leche Hmmm , anda mi vida , correte  .	1	
Mamita eso debe de ser intolerancia a la lactosa o infección llévalo al médico para que le anden rápido con eso para que no se deshidrate y vaya a perder peso rápidamente  .	1	
Wow nunca había recibido notas tan rápidamente , sé que son 2 solamente pero jolín me han llegado super rápido	1	
al parecer te estas diviertiendo con otra de tus amantes-lo miro serio mientras lloraba y salgo rápidamente del lugar yendome lo más rápido posible-	1	
#preciso,	precisamente
Pero como los vamos a tomar si no nos alcanza para pagar lo que le debemos es mas don gustavo ni ella ni yo pudimos estrenar este año precisamente por todas esas deudas y pues la plata dd los 15 millones era preciso para eso para respirar un poquito mas	1	
Pero que preciso su bolsillo , tiene sabe precisamente donde tocar	1	
#reacio,	reaciamente
#serio,	seriamente
Shi ella ya cambio porq yo hable muy seriamente con ella poco creíble que yo sea serio pero es verdad	2	
Amor neta seriamente quiero wey te pongas en plan serio y me dihas que opinas	1	
Amor yo voy a ir a acompañar a un primo haya al coco entonces para que hablemos seriamente que ayer no le hable serio por que estaba su Prima y yo me siento muy incomodo hablandole serio a una mujer con otr @s hay pendiente de lo que uno habla con ella entonces ahora hablamos pero a solas si amor	1	
Bebé en serio ud tiene que coger y hablarler seriamente	1	
Bno portese serio que yo en los negocios soy Seria Estamos hablando seriamente	1	
Deberías considerar seriamente trabajar , no cuesta tanto en serio , yo trabajo todos los días y no ando ocultando mi cara o apoyando al gato , eso es muy denigrante , y vos	1	
Deberías considerar seriamente trabajar , no cuesta tanto en serio , yo trabajo todos los días y no ando ocultando mi cara o apoyando al gato , eso es muy denigrante , yo cobarde claro , si no lo fueras pondrías tu foto de perfil , sabias q solo los cobardes y los trolls no dan la cara  ?	1	
En serio por eso e pensado seriamente en ya no pintarme	1	
En serio que si lo estoy pensando seriamente Jaja	1	
Es que es enserio o lo que dijiste en el salón hoy cuando estabamos en ética todos estaban hablando muy seriamente no estaban hablando de una bobada era algo muy serio y tu sales con un flete mas osea eso dio rabia , es que las mujeres no somos cualquier cosa y lo pudiste decir jodiendo pero no era el momento	1	
Es que ese wee quiere algo muy serio pero tu también tienes que hablar con el seriamente para que queden mejor También dile que de mi parte no mame	1	
Escucho musica y pensando seriamente si ver otra serio y cual seria	1	
Estoy pensando seriamente en no ir en serio xD	1	
Hablemos seriamente amir ya en serio	1	
Igual si no se muchas cosas yo investigo Si quieres hablar de algo seriamente y sin payasadas me pongo serio y te escucho Si hay algun problema siempre estaré a tu lado  !	1	
Jaja ves nada tomas en serio , contigo no se puede platicar seriamente	1	
Lo se y lo estoy pensando seriamente , y en serio discúlpame por hacer ese tipo de cosas , solo me controlaré , tambien no quiero tener hijos ahorita obviamente , si si , como te digo , no solo hablo cosas de ese aspecto , sino que más alla de eso	1	
Mira los dos son tak para cualYo se q los dos quieren estar juntosPorq no hablas con el seriamente y yo se q el se pobdra serio contigo	1	
Parce estoy pensando seriamente que esa china no quiere algo serio	1	
Pero no parece pues vea como la peinaba jajaja pero bueno no serio tiene que hablar con ella seriamente para que arreglen las cosas	1	
Sabes una cosa , cuando te empece hablar era para que hablaramos seriamente o sea por si se daban las cosas tener algo serio , pero ya con lo que me dijiste pues ya  .	1	
Se que no les gustara conversar esto conmigo seriamente pero cuando yo me tomo algo serio es por que me lo tomo a enserii	1	
Si Bueno a menos que quieres verme enojado y celoso y que no te hable ni nada verdad Dije riendo Pero hablando seriamente y con mis ojos serio , cuando me dio el beso en mi frente cerré los ojos y lo abrazo Por la cintura recargando mi cabeza en su pecho	1	
Tengo Que hablar muy seriamente contigo así Que por favor ponte serio no empieces como siempre a tomarlo a juego	1	
Ven en serio me voy temprano el jueves para hablar muy seriamente	1	
en serio , ya estamos hablando seriamente  .	1	
no en serio , alguien deberia hablarlo con el seriamente xddd	1	
#sereno,	serenamente
#feliz,	felizmente
Muy buenos días y feliz sábado Espero hayan descansado muy felizmente 3Cu ídense y que Dios me las bendiga Las amo bastante mis muñequitas hermosas  !	4	
Muy buenos días y feliz sábado Espero hayan descansado muy felizmente 3Cu ídense y que Dios me las bendiga	3	
Ahora estoy feliz ya no me duele la pansita ya la tengo felizmente marcadita	1	
Amooooooooor buenos Diaaaas feliz aniversario mi amor no te pude escribir sali tarde y llegue felizmente 8 55	1	
Entonces al final tacha felizmente Sorprendentemente se siente feliz por lo descubierto todas las desventajas de sus listas y pone en letras grandes que cubre todas las listas	1	
Me imagino toda la cosa Yo ahí arrastrando a la personita con la cabeza en mi mano y al llegar contigo solo te la doy como si nada y estaría feliz por verte feliz , al final iría a vomitar pero felizmente	1	
Mi reina hermosa hoy te deseo lo mejor de tu vida , hoy son 18 años de vida no sabes lo feliz que me pone de ver que tiempo atras eras una persona a la que yo solo veía distinto sin darme cuenta que ibas a tener una amistad conmigo por eso hoy felizmente te deseo un feliz cumpleaños que Dios te bendiga y te de sabiduría en todo lo que emprendas tus metas , tus sueños , eres un ser maravilloso dayi bendiciones hoy y	1	
Yo ya pague todo lo q debia x lo mal q ice antes aora es el turno d q sea feliz a tu lado mi amr y vivamos juntos un dia felizmente	1	
#general,	generalmente
Si , solo un pequeño comentario , no precisamente contra la chica , es un comentario general De las chicas que han pasado por tu vida generalmente hablando , No he podido crear un perfil de tus gustos , Me parece impresionante cómo puedes manejar tantas conversaciones parecidas con varias chicas y aún así ser discreto con cada una de ellas , tu capacidad de conquista y abrirte al sexo opuesto es fasinante , además de que las elecciones que haces no son para nada descabelladas , se acoplan a tu perfil , es interesante	1	
si lo c , me he dado cuenta de eso pero generalmente eso te pasa cuando tienes un dia horrible en general y no de la nada como en estos casos	1	
#furioso,	furiosamente
#ocasional,	ocasionalmente
#inmediato,	inmediatamente
En cuanto Pegaso llegó a la adultez , fue de inmediato al Olimpo , lugar en donde inmediatamente se entrevistó con Zeus  .	1	
#profesional,	profesionalmente
Se que puedo aportar a que cada día seas mejor persona , a que crezcas profesionalmente , a que seas un gran padre , yo quiero crecer profesional y personalmente , hay muchas cosas que aún quiero lograr , quiero ayudar a mi familia y estar a tu lado , se que eres una gran persona , de eso no me cabe dudas , que me aterra que te fijes en otra persona , si , pero trato de confiar en lo que hago en esta relación para que si quieras continuar a mi lado  .	2	
Primero quiero q sepas q no m equivoque en saber lo comprometida que eres y x eso siempre seguiré apoyandote para que crezcas profesionalmente Segundo recuerda que dentro del papel profesional que estas ejerciendo la preparación de día c día será muy importante nunca abandonarla , pero sobre todo esa vocación no la pierdas nunca  .	1	
Pues en profesional yo tengo anotar los conocimientos ya manejados y el profesionalismo 10 acciones ya ya sabes hacer profesionalmente y pero el la de ser profesional solo puse perfil de egreso pero ya no acuerdo que era  !	1	
#obvio,	obviamente
Ay no china si obvio que rabia , pues obviamente a su papá le debe dar rabia saber que esta con la familia de camilo , pero pues igual eres decisión suya a quien invitaba y a quien no	3	
tnias con q desde tu casa obviamente pensastw un dia en usarlos y es bueno q t cuides obvio no seria conmigo ya q jamad nos cuidamos de esa mneraDisculpa	3	
Bebé te dare mi opinión yo siento que el pues obviamente todavía te quiere y asi y es obvio que quiere regresar contigo entonces te pone esos mensajes para que tu le dijas te extraño o algo asi pero mi niña siempre te voy a apoyar y cómo te lo dije vamos saliendo a adelante poco apoco	2	
Weeee FELIZ CASI AÑO NUEVOOOO te amo de a madres neta te amooo cañon GRACIAS X TODOOO eres le mejor BFFA y yo siempre te voy a amar wey aunque avaces prefieras a Pilar v , gracias x tus regaños , consejos , enojos , chismes , llantos , travesuras , aventuras , amor y sobre todo por tu amistad neta wey este 2017 fue super super increible y mas contigo obviamente jajajaja , espero que mi 2018 sea el mejor y obvio lo va a ser x que estaras tu ahi  .	2	
1 amikas 2 no 3 obvio 4 tu forma de ser 5 10 6 si 7 obviamente 8 una gran persona y alguien muy especial	1	
1 amikas 2 no 3 obvio 4 tu forma de ser 5 10 6 si 7 obviamente 8 una gran persona y alguien muy especial 9 si	1	
1 no 2 Nicolás arias 3 valentina 4 Leandro peralta 5 me caes bien cuando no estas cn tu hermanitaaa 6 107 no no lo extraño 8 Nicolás arias obviamente 9 no 10 Nicolás arias 11 obvio q hablaria cn vs 12	1	
1 no 2 Nicolás arias 3 valentina 4 Leandro peralta 5 me caes bien cuando no estas cn tu hermanitaaa 6 107 no no lo extraño 8 Nicolás arias obviamente 9 no 10 Nicolás arias 11 obvio q hablaria cn vs 12 nada	1	
1 no 2 Nicolás arias 3 valentina 4 Leandro peralta 5 me caes bien cuando no estas cn tu hermanitaaa 6 107 no no lo extraño 8 Nicolás arias obviamente 9 no 10 Nicolás arias 11 obvio q hablaria cn vs 12 nada mentira tu personalidad 13	1	
1- mejores amigas 2- mi beba 3- super bien 4- mi amiga de la primaria y como mi hermana 5- obvio 6- claro que si obviamente 7-creo que un beso en el cachete como amigas 8 no	1	
1-si 2-no 3-obvio 4-si 5-deira city centre- night lovell 6-cucarachas 7-que eres muy especial 8-Pamela Hernández 9-nadie es por momentos 10-Pamela hernández 11-awebo 12-es obvio y nunca te dejare de querer 13-que si obviamente 14-no por que no te quiero dejar nunca 15- la persona mas importante en mi	1	
Aaa obvio vamos por la A pero la B es mas competitiva obviamente y mas melo pero en cualquiera de las dos	1	
Ahhhh okz pues cabello suelto y lizo y obviamente cn lentes 3 y maquillada obvio cn ese bby doll uffffff 3	1	
Ahhhh y si no estudia obvio no va a pasar , obviamente  .	1	
Aparte obvio date cuenta no se vierno ni cinco veces obviamente no esperes que no se valla con otRo	1	
Aparte sabes pues si , Me afecto enterrarme que estabas aquí y yo no lo sabia estube muchos días sin verte y obvio si tu tenias tus compromisos obviamente yo no te los iba cambiar , Pero era eso y luego lo del chavo y como me decías las cosas por eso quiero saber	1	
Ay no china si obvio que rabia , pues obviamente a su papá le debe dar rabia saber que esta con la familia de camilo , pero pues igual eres decisión suya a quien invitaba y a quien no Y no pues arelis debió haber entendido y esperado	1	
Bueno si le preguntaré , yo digo que obviamente si quiere ser tu novia , bueno es super obvio jaja	1	
Cuando usted estaba en embarazo y nosotras dijimos que íbamos a ir a visitarla y ud dijo que no que porque andaba en pijama , a nosotros nos pareció una excusa porque obviamente en un embarazo riesgoso que toca estar en cama pues lo mas obvio es que ande en piajama	1	
De hecho hay dos animes , uno se llama full metal alchemist es del 2002 creo y no sigue nada del manga y eso , es como inventado , también el final , y el otro es igual pero quitan el alchemist y ponen brotherhood , que es del 2010 y ese sigue el manga , todos votan que obviamente es mejor el brotherhood que el alchemist pero es obvio porque v	1	
De nadie mas que mio obviamente y toda la vida c Enseriooo v tu eres oficial obvio uwu la primerita uwuHshshs te timaron con la publicación xdxd c Hshshs ya con eso vi que si tienes demasiado miedo sobre eso amor	1	
Era broma obviamente jaja pero es obvio que no me dejaran ir pero igual que te diviertas	1	
Era obvio que Vegeta iba a hacer poco y obviamente como no Goku tiene hacerlo todo	1	
Era obvio sospecha osea eres mi mejor amiga y obviamente me lo dirias	1	
Es obvio que no les hablo obviamente aparte ya saben que estoy con vos que mas queres  ?	1	
Esq yo no puedo preguntarle porque obviamente se va a ver muy obvio mis intenciones	1	
Esque no así como tal , primero empieza por decirle que eres Bi , obviamente si el quiere tamote va decir , y pues obvio es poco a poco y ya se va a dar  .	1	
Haber , aclaremos , obviamente intentaría crear algo lindo , porque pues si me gusta es obvio	1	
Haber yo no estoy hablando de vestir para nada estoy hablando de cosas esenciales es como si te dijiera de tus brakets están mal tus dientes estass haciendo algo para que se vean mejor ahora yo ya me han dicho de mi cabello mi mama y tu mama porque crees que me lo digan por nada más decir no obviamente quieren que me haga algo que mejore no para la sociedad obvio no pero si por bien simplemente ya se ve feo y lo que quiero evitar es cortarlo	1	
Hay vea Jordan obviamente no voy a saber las cosas porque usted no me cuenta obvio porque ahora son ellas para todo lado mientras yo si te cuento todo lo que me pasa pero tranquilo jordan al fin y al cabo yo soy una simple novia en cambio nina a estado con usted casi toda la vida y obvio su tia es su tia	1	
Hay vea Jordan obviamente no voy a saber las cosas porque usted no me cuenta obvio porque ahora son ellas para todo lado mientras yo si te cuento todo lo que me pasa pero tranquilo jordan al fin y al cabo yo soy una simple novia en cambio nina a estado con usted casi toda la vida y obvio su tia es su tia yo me esperaba eso	1	
Igual ya se que para cualquier cosa de pillos obvio deben elegir a uno de los dos por la situación y obviamente siempre lo eligen a el ntp amigo se que no es cosa tuya	1	
JAJAJAJA obviamente si jejejjee sii obvio sipobviamente nunca c Aun me  .	1	
Jajaja con 100 o 200 pe paso al frente obviamente ganando la entrada obvio jajajjaj	1	
Jajaja obviamente ya sabes que estaría chupando , es algo obvio Jajaja bueno  .	1	
Jajaja obvio pregúntale a cualquiera mi ego es enorme XDPorque obviamente soy la mejor v	1	
Jajajajja la chica no dijo que fuéramos fodongas , solo que obviamente no tenemos nada mas de que hablar xq obvio no convivimos como antes con otras personas , relajense xq es verdad aparte no dijo que todas , dijo que la mayoria , yo llevaba una vida de tener much @s amig @s , de fiestas , salidas , etc  .	1	
Javier afirma que uno es Alex , lo cual es obvio y pregunta por el otro y obviamente es usted  .	1	
Jsjsjs obvio Jsjsjs pos si obviamente v JAJAJAJA lose  .	1	
Le mande un audio obviamente diciéndole que si era necesario que le preginte si hacia algo porqir es obvio que pregunto pof eso	1	
Mariano se re quedo viendo yo obvio no mire para otro lado obviamente sienpre haciendo lo correcto	1	
Mi amiga con sándwiches y yo me pedi las papas con la hamburguesa obviamente no pedi las papas para sola obvio que no fue el sabado	1	
Nicolás no quiere que nadie se entere que este es mi último finde , obviamente eso no va a pasar porque obvio que me quiero despedir de todos ustedes pero eso sería el sabado por lo tanto demosle el gusto por eso te pido que no comentes nada con nadie  !	1	
No digas incoherencias , obviamente si estamos bien y me sales con tus cosas es obvio que me voy a enojar	1	
No obviamente no puedes , es obvio q esto te va a doler como nunca	1	
No pz me dijo marce ven me llego esto y ya me puse a leerlo y pz obviamente despues me pregunto y pz obvio le dije que no era cierto	1	
No tranqui el obvio dr sintió un poco incomodo pero estamos bien pero obviamente yo no iba a dejar eso asi  .	1	
Nonoo , tu más 7u7 , obviamente no c , bien 7w7 , jajaja obvio tevas a ver bien bonita  .	1	
O sea a mi tu amigo se me hace buena persona y no creo que sea pendejo es mi opinión obvio pero pues tu obviamente lo conoces mejor que yo obviooooo	1	
Obvio no las tome en vano jaja amor los hombres son perversos donde vaya son hombres jajaja obvio disfrutare mucho jaja utilizando mi cerebro obviamente jajaja y ya después veré si me merecen o no jajaja	1	
#repentino,	repentinamente
#típico,	típicamente
#tranquilo,	tranquilamente
Agoney Estoy en el hospital , tranquilo que estoy bien , ya te diré que ha pasado mas tranquilamente cuando vuelva amor  .	1	
El que hice yo es para adelantar y dejar libre para hacer hace mas tranquilo ademas de que deje espacio para desayunar tranquilamente	1	
Es que enoja vengo aca a la mrd tranquilamente me quedaba a ya me iba a la marcha de mi cole tranquilo	1	
Hay amor pero estas de a cuerdo que ya mañana esyaras mas tranquilo y ya podrías regresar pero igual ya mas tranquilo ya podras dormir tranquilamente	1	
Pensa que estas en un lugar tranquilo Donde puedas expresarte tranquilamente	1	
Pero no por ser mi amiga y que se yo hagamos cualquier cosa ella estudia tranquilamente comunicaciones salimos al cine por ahí charlamos y todo tranquilo es alguie	1	
Pero no por ser mi amiga y que se yo hagamos cualquier cosa ella estudia tranquilamente comunicaciones salimos al cine por ahí charlamos y todo tranquilo es alguien normal hace mas que vos xd	1	
Quieres que te diga eso asi estes tranquilo y puedas hacer tranquilamente la tuya  ?	1	
Quédate tranquilo que ella debe dormir tranquilamente  .	1	
#infrecuente,	raramente
#lento,	lentamente
Tocandote asi lento y besando tu cuello soplando lentamente tu oido	3	
Asintió lentamente y se levantó nuevamente , caminó a paso lento hacia el sofá y se inclinó sobre este , dejando que el mayor aprecie sus glúteos  .	2	
Me imagine a ti y a mi en calzones y bajo la cobija , bueno yo ya con la verga de fuera y cuando me pongo el condón te doy la vuelta y la meto poco y la empiezo que meter lentamente hasta que este toda y luego sacarla lento y meterla lento y asi hasta empezar a darte mas y mas y mas rapido	2	
Pero quiero sentarme ay luego moverme lento y después bajo lentamente te lo toco y luego con mi lengua sobarlo de arriba a abajo y luego te vengas en mi boca	2	
Cuando vi que se acercaba lentamente a mi me quede quieta esperando el beso que tanto a nelava pero después también me acerque a el para haci poder juntar nuestros labios en un tierno y lento beso , puse mis manos en sus mejillas acariciándolo y empecé a mover lentamente mis labios	1	
El día pasa lentamente cuando queres q pase rapido , pero cuando queres que pase lento pasa rapido	1	
Haré así como ganchito con mi dedo y te los meteré lentamente así en círculos y adentró y afuera rápido y lento	1	
Hoy lo aremos mas lento susurra en el oído del menor y lo penetra lentamente soltando un pequeño gemido	1	
Jejejej , abrazarte , besarte lento y tranquilo , acariciandote lentamente , bien a lo tierno	1	
Jungkook al escucharte tu respuesta suspiro , estaba apenado y muy rojo , me acerco a ti y después me acerco lentamente a tu rostro hasta darte un tierno y lento beso	1	
Mi amor tranquilo mi yuhito bonito entre lo mas lento , me moví lentamente , poniendo sus piernas en mis hombros duele aun mi amor  ?	1	
Mi tío esta muy lentamente mejorando pero muy muy lento , sigue entubado , con respirador artificial en cti	1	
Moverlos lentamente mientras me muevo también lento arriba de ti	1	
Pero baja el tono de la voz , de pone a mover el pie ansiosamente y a mirarlo , se pone las manos en los bolsillos o en el pantalón y habla lentamente , como si entre mas lento menos me enterara de lo que fuera a decir	1	
Primero t beso lento y cachondamente bb después te empiezo a desvestir lentamente te empiezo a besar el cuello el cuerpo todo t acaricio y lentamente lo empezamos a hacer	1	
Pues te acariciaría lento te besaría te tocaria lentamente y te pegaria hacia mi de tu cintura	1	
SUPER BIEN Y LO MEJOR QUE Bajas lentamente y no tan rapido osea que como se baja lento tardamos mas en aumentarlos	1	
Si te beso lento paso mi lengua lentamente y te hago sentir cosas que te gustaran y que no querras que pare	1	
Soña con vos acostada en nuestra cama , y yo besandote toda lentamente , subiendo , lento , hasta tus labios , luego sacandonos la ropa interior , Calentandonos , y luego cojiendo lento y suave en misionero	1	
Te bajo los bóxer y te voy besando muy lento y sensual mienttras Que con mis manos conciento tu pene luego lentamente beso tu pecho Hasta bajar y hacerte el sexo oral poco a poco lo voy metiendo a mi boca y ver tu cara de exitacion	1	
Te besaría , te tocaría muy lento , besaría tu cuello te quitaría tu playera y de ahí ir bajando lentamente hasta llegar a tu parte y hacerte un oral	1	
Te la chuparía , luego me encimaria en ti & agraria tu pene & lo metería lentamente en mi vagina y luego empezaría a moverme lento & luego cada vez mas fuerte	1	
Y me empezare a acercar lento mirar tus hermosos ojos y lentamente ir hacia tus labios	1	
bajar lentamente a tus pechos , luego ir mas lento por tu abdomen  .	1	
empujo lento y meto mi miembro en tu entrada lentamente	1	
por eso mi amor me desnudaré enfrente de ti lentamente con un regeton lento y aca bien bonito aca tipo striper	1	
#claro,	impreciso
