#honesto,	deshonesto
#convincente,	no convincente
#competitivo,	no competitivo
#conocido,	desconocido
fue y es hermoso el haberte conocido pasaste de ser un desconocido a ser la persona mas importante de mi vida te amoo amooor que sigan pasando los días los meses y los años  .	3	
No puedo conocer lo desconocido si me aferro a lo conocido	2	
A veces un desconocido te escucha mejor que alguien conocido	1	
Es mejor que te ayude un conocido a q un desconocido	1	
Es muy diferente a pegarle a alguien conocido que a un desconocido	1	
Foto con desconocido osea alguien que no conozca mucho igual re feliz de haberte conocido	1	
Giuka era un rapero desconocido que queria ser conocido  .	1	
Mejor que aprenda con un conocido a cagarla con un desconocido mas adelantw	1	
No puedo conocer lo desconocido si me aferro a lo conocido  .	1	
Normal como que no se como que si no me ubieras conocido antes , prácticamente como si fuera un completo desconocido	1	
Nunca escuchaste mejor con un conocido a q un desconocido jaja	1	
Osea referente a portarte mal con alguien conocido es mas factible a hacerlo con cualquiera pues alguien conocido respetara y no divulgara en cambio con un desconocido es como lanzar una moneda al aire	1	
Pero que mejor que un conocido a que un desconocido jajaj	1	
Pues no puedo conocer lo desconocido si me aferro a la conocido	1	
Quedarse en lo conocido por miedo a lo desconocido , equivale a	1	
Respeto y educación lo tenés que tener con un desconocido , con un conocido , Con un amigo/a , persona que te caiga mal , ex , etc etc	1	
Si el detalle es no ver a nadie conocido , en un sitio también desconocido	1	
Uno no le teme a lo desconocido , sino a la posibilidad de que lo conocido llegue a su fin	1	
Y para que sepas jamas me le desnudo así como si nada anadie ni conocido ni mucho menos desconocido	1	
Y q mejor q hacerlo con alguien conocido a q con un desconocido	1	
si es conocido supongo se lo Dara Xq no había nadie desconocido	1	
#impresionante,	no impresionante
#posiblemente,	imposiblemente
#decidido,	indeciso
Mi vida no es la misma , tengo un propósito mayor , hoy recibimos la noticia más grande y he estado pensando acerca de publicar esto porque estaba temeroso e indeciso , pero hoy he decidido publicarlo  .	2	
#consistente,	inconsistente
#ético,	inmoral
#informado,	desinformado
Un idiota es aquel que no aprende del pasado , un desinformado que no escucha al informado , un idiota por debajo del nivel , UN IDIOTA ES EL QUE CREE QUE TODOS SON IDIOTAS MENOS EL	2	
#còmodo,	incòmodo
#posible,	imposible
Y mirándolos Jesús , les dijo Para los hombres esto es imposible ; mas para Dios todo es posible  .	12	
Lucha x lo q quieres , no dejes q otros te digan q es imposible , td es posible con esfuerzo	5	
Chaparra hago lo mejor posible para mañana tener tiempo de verte pero no creo que acabe imposible	4	
Quieres seguir con las estupideses de el de sus amenazas dice un dicho en el mundo el valiente muere hasta que el cobarde quiere tu no eres una niña miedosa al contrario sabes salir adelante por que te dejas que te amenace a caso no tienes un Dios de poder o Dime a quien le pides a una imagen , no amor le estas pidiendo al rey de reyes y señor de señores el todo poderoso que lo imposible el lo hace posible por que caes en sus amenazas	4	
Amor , talvez este no se precisamente el mensaje que esperabas recibir A estas alturas del camino esta de mas mencionar tantos malos ratos que hemos pasado , el daño que nos hemos hecho , pero igual no esta todo olvidado o perdonado aún hay heridas que necesitamos sanar y esto sera posible solo con tiempo y paciencia , nada facil pero menos es imposible  !	3	
En éste resto que queda de semana iremos ud y yo a testificar de el , porq a el le gusta que lo hagamos en su nombre pprq como dice la biblia , lo que es imposible para el hombre , para Dios todo es posible  .	3	
Hace mas de 10 años cuando conocí a esta persona , que hoy es lo mas bonito que tengo en la vida , obviamente nada fue facil , 7 años fue mi mejor amigo , mi confidente , mi hermano , al mismo tiempo era mi Crush mi imposible , pero en ese tiempo nada de lo nuestro era posible ya que yo estaba muy chiquita para el segun  .	3	
Haré lo posible para que te fijes en mi así tenga que hacer lo imposible	3	
Llega un momento en el que sientes que ya no puedes más , que todo ah terminado , pero no cariño , aún no a terminado , es tan sólo el comienzo , porque nada es imposible para el que creé en sí mismo , todo es posible para el que ve más allá del horizonte , llegarán momentos mejores , los malos ratos pasan , todo viene & va , un día despertará & verás que lo malo se ha ido , porque llegarán tiempos mejores , con más abrazos & menos errores  .	3	
Nada es imposible si tú haces lo posible para lograrlo  .	3	
Que es imposible cuando nosotros mismos dictamos las reglas de lo posible  ?	3	
Rol Conquistando Mikvar Después de siglos pensando conocer la existencia de todos los continentes que se encontraban en la faz de la tierra , un pequeño grupo de exploradores , en busca de nuevos territorios por descubrir , encuentran un lugar más allá de lo conocido , donde lo que una vez se creyó imposible , se vuelve posible  .	3	
Se que lo imposible ustedes lo haran posible	3	
Si no sabes qué hacer , y estás desesperado , repite simplemente el Nombre poderoso de JESÚS tantas veces como te sea posible y verás milagros florecer en lugares que creías imposible Sigue tu lucha  !	3	
Siempre me han dicho has lo q tu corazon te pida y es la verdad es imposible pero todo es posible aun q no lo creas	3	
Sólo una vida para disfrutar Sólo una vida para destacar Sólo una vida para ser normal Pero ser normal no está en mi manual Hay mil lugares para visitar Hay mil lugares donde quiero estar Y uno de ellos es el espacio Y mirar mi planeta desde allá No quiero parar , no quiero mirar atrás , nunca frenar , Yo sé bien donde quiero estar , yo sé bien dónde voy a estar No haré lo posible yo haré lo imposible por hacer mis sueños realidad	3	
lo imposible para nosotros Dios lo hace posible  .	3	
Acuerdense de luchar por lo imposible , porq lo posible ya se agota	2	
Buenas lunas mi niño amado , descansa , TE AMO MUCHÍSIMO Eres tan perfecto , eres con el único que quiero estar y haré lo posible y hasta lo imposible para que estemos juntos TE AMO	2	
Comienza haciendo lo que es necesario , después lo que es posible y luego terminarás haciendo lo imposible  .	2	
Creer que todo es posible hace que logremos hacer hasta lo imposible	2	
El les dijo ; lo que es imposible para los hombres , es posible para Dios  .	2	
Lo imposible ; se vuelve posible si creemos en Dios	2	
Lucas 18 , 27 Él les dijo Lo que es imposible para los hombres , es posible para Dios  .	2	
Lucha por lo imposible por que lo posible se AGOTO  !	2	
Luchemos por imposible por que lo posible se agoto	2	
Me duele q hice todo lo posible porq no te fueras ayMe llene ingenie hasta de lo imposible porq te quedaras uhhSuplique hasta el cansancio para q entendieras tu mi vidaq el cielo la abriera bajado si así lo quisieras	2	
No dije que sea imposible , pero al menos no sera posible durante años	2	
Nunca te desanimes sigue adelante porque Dios hace que lo que sea imposible para el hombre , él lo hace posible en un abrir y cerrar de ojos  .	2	
Pero en la vida ay q arriesgar todo por esa persona porque tu no sabes que es lo que siente esa persona entonces as lo que sea posible para que no se vaya y éste con tigo porque nada es imposible solo dificil	2	
Por que lo posible no funciono hay que intentar lo imposible	2	
Puedes lograr lo imposible empezando por pensar que es posible	2	
Salmos 144 15 TLANo dejes de pedir a Dios por tus hijas , que un día de reconozcan como lo que eres , pero para que alcances tal bendición , tienes que acercarte a Dios , solo el hace posible , lo que para el hombre es imposible  .	2	
Santa Biblia Reina Valera 1960Lucas 1827 Él les dijo Lo que es imposible para los hombres , es posible para Dios  .	2	
Sólo una vida para disfrutar Sólo una vida para destacar Sólo una vida para ser normal Pero ser normal no está en mi manual Hay mil lugares para visitar Hay mil lugares donde quiero estar Y uno de ellos es el espacio Y mirar mi planeta desde allá No quiero parar , no quiero mirar atrás , nunca frenar , Yo sé bien donde quiero estar , yo sé bien dónde voy a estar No haré lo posible yo haré lo imposible por hacer mis sueños realidad  .	2	
Tengo que hacer lo posible y hasta lo imposible para verlos	2	
Tu mamá ests con tu abue y estan haciendo todo lo posible y casi lo imposible para que ella esté bien , ess muy feo que hayan las malditad enfermedades por el maldito Adán , pero bueno	2	
Ya 2 maravillosos años y 7 meses tu me has demostrado que crees imposible , puede ser posible , hemos pasado por grandes	2	
Él les dijo Lo que es imposible para los hombres , es posible para Dios  .	2	
, para que triunfe el amor que aun late en nuestros corazones ; en tus manos pongo mi corazón heridopara que tú permitas un milagro de amor en mi viday vuelva dulce y mansa la persona que tanto extraño , sé que tu puedes hacer posible lo que a mí me parece tan imposible  .	1	
-La única manera de encontrar los límites de lo posible es ir más allá de lo imposible  .	1	
A si es tía para dios nada es imposible Y si hay fe todo es posible  .	1	
Acuerdensen de luchar por lo imposible , porque lo posible se agotó-	1	
Ademas trataría de ir a verte mas seguido y pasar el mas tiempo posible contigo Tu sabes que nada es imposible  .	1	
Ah no pues disculpame en vdd no queria molestarte neta que ahora si intentare alejarme los mas posible aunq es algo imposible porque trabajamos wn la misma area	1	
Amen lo que para el hombre es imposible para Dios es posible	1	
Amiga es verdad no es fácil pero no Dios es de los imposible y todo en él es posible	1	
Amiga mañana por la tarde por que hoy nu fui ni siquiera atrabajar budcandole la plata y apenas llegue por que la averdad tengo pena con usted que me colaborado pero en tienda me q estoy haciendo lo posible un día mas un día menos yo estoy haciendo hasta lo imposible no es que no quiera es que cuando uno esta como yo en esta situación todo se le pone patas pariba a medio día tipo 1 30 llegue ala peluquería a ver que me resuelto	1	
Amor bbe yo lo q menos quiero es hacerla sufrir a ud y hacerle daños a uds amor tanto como a ud y tanto como a los niños bbe hermosa luchemos juntos amor lo q ud ve imposible para dios es posible amor	1	
Are todo lo posible y asta lo imposible para recuperarte Por solo vos me importas	1	
#lògico,	ilògico
#eficiente,	ineficiente
La gente cerrada de mente le teme a las facturas debido a la privatización , pero yo prefiero pagar por un servicio eficiente , que por un servicio ineficiente  .	1	
#productivo,	improductivo
#conveniente,	inconveniente
#responsable,	irresponsable
Dice que tengo que ser responsable que no me piensa dar no un centavo por irresponsable	1	
Le dije que me pareció muy irresponsable de su parte tener relaciones tan pronto pero ahora me parece muy muy responsable que lo cuide porque se ve que lo quiere	1	
Muchas veces juzgan sin saber la situación de las personas , y no por eso es una persona irresponsable , yo hago a veces eso con mis hijos y soy mas responsable que cualquiera , entonces a veces todas las personas no tienen los mismos recursos , por tanta desigualdad que hay en esta vida , Dios proteja a éstos angelitos y a todos los que les toca viajar en moto  .	1	
Por mas que sea pendeja no deja de ser irresponsable , una persona cuando es responsable es de chica  .	1	
Pues por que es un irresponsable que no es lo suficientemente grande para hacerse responsable	1	
Que responsable y a la Vez irresponsable xd	1	
Si tnes moto se responsable machoo donde aprendiste andar en moto , la moto no es para irresponsable	1	
Soy absolutamente responsable de lo que digo , pero total y absolutamente irresponsable de lo que ustedes entiendan  .	1	
Tu eres una mujer a la que admiro mucho , de verdad , has educado a un hijo amoroso , responsable , empático , a pesar de que te tocó un irresponsable e inmaduro como padre de tu hijo  .	1	
Voy a pedir que ne lo den eres una mama irresponsable yo si soy responsable	1	
Yo no entiendo ud X k tan inresponsable Camilo , ud esta tan tan mejor no hablo , pero estas demasiado irresponsable , póngase serio con eso , soy mas responsable yo k soy menos k ud , sinceramente tu no das es ni lastima	1	
Yo soy muy irresponsable para muchas cosas pero con la Play soy bastante responsable	1	
se que usted es muy responsable e imagino nada bonito ver que la gente sea tan irresponsable y no se presenten a algo que se les aviso  !	1	
si pero hay una lucha dentro de mi , esta por un lado la vicky responsable y por el otro la irresponsable y vicio quien ganara jaja	1	
#agradable,	desagradable
Alo mejor la chica es mas agradable porque el tío que esta es un desagradable	1	
En vez de ser algo agradable lo conviertes en desagradable  .	1	
Quien soy Como soyQue pienso de mi Que espero de mi Que opina la gente de mi Cuales son los sentimientos que tengi hacia mi persona Que es lo mas agradable & positivo de mi Que es lo mas desagradable & negativo de mi Que tan importante es para mi poder comunicarme con las demas personas Como respondo ante los conflictos que se me presentan en la vida diaria	1	
#sabroso,	desabrido
#afortunado,	desgraciado
y ya decidiste quien sera el desgraciado , digo el afortunado de salir contigo  ?	1	
#informativo,	desinformativo
#racional,	irracional
La primera pregunta te preguntara sobre si 12 / 4 OSEA doce cuartos , es racional , primo , irracional y mixto	1	
Pero igual , cuando eres irracional con la concepción que tienes sobre ti mismo , es difícil ser racional y pensar en el que te hizo bullying por tantos años  .	1	
#aceptable,	inaceptable
#consciente,	inconsciente
Complejo de edipo manifestaciones del inconsciente las dos teorías inconveniente , preconciente , consciente 1era teoria , y la 2da que es la de ello yo súper yo , y creo que síntomas psicoticos	2	
Hasta que lo inconsciente no se haga consciente , el subconsciente seguirá dirigiendo tu vida y tú lo llamarás destino  .	2	
A veces lo que no encuentra un sentido , a pesar del esfuerzo consciente se hace evidente , a partir de la aparición del inconsciente  !	1	
Carl Jung Hasta que lo inconsciente no se haga consciente , el subconsciente seguirá dirigiendo tu vida y tú le llamaras destino  .	1	
De hecho me ha pasado , de resolver automaticamente , esos conflictos del inconsciente cuando los traigo al consciente	1	
Hasta que lo inconsciente no se haga consciente , el subconsciente seguir a dirigiendo tu vida	1	
Hasta que lo inconsciente no se haga consciente , el subconsciente seguira	1	
#razonable,	irrazonable
#seguro,	inseguro
Mi amor , donde sea me sentía inseguro , Tu me construiste y me hiciste seguro , Me regresaste mi orgullo , Preciosa amiga , Contigo , eres alguien que puede contar conmigo , Para caminar por el sendero hasta el fin de los tiempos , Sin ti , La vida no tiene sentido , ni rima , Como una canción fuera de tiempo , Como lo puedo compensar , puedes tener fé en mi Amor , te amo	3	
Pierdes lo seguro por buscar lo inseguro	3	
Bueno seguro te iría a buscar con el xq lo conozco y es re inseguro	1	
Cuando tomes una decisión que nasca de ti que tu estés seguro de lo que haces y que no te sientas inseguro de tu desicion	1	
Cuando uno camina seguro mata a el inseguro  .	1	
Cuidaré muy bien de ti amor y esta bien si aun te sientes inseguro yo seguiré esperando , quiero que primero te sientas seguro y sin miedo	1	
Cuidaré muy bien de ti amor y esta bien si aun te sientes inseguro yo seguiré esperando , quiero que primero te sientas seguro y sin miedo amor	1	
Dale tiempo amor seguro que se siente como inseguro de que todos lo saben	1	
Mmm ser celoso no es por q te obliga es por q quiere estar seguro contigo o talves tu ases q el se vuelva inseguro y es por eso q debe estar así	1	
Nada amiga yo puedo dejar algo seguro q tengo x algo inseguro xq el ahorita no tiene nada x eso se va para alla y x mis hijos amiga tengo q pensar en elloa	1	
No es wso paola mira tu sabes y te diste cuenta que soy muy indeciso uo puedo tener algo seguro pero me llega un pensamiwto raro o algo y me vuelvo inseguro	1	
No sabia esta un 50 seguro y un 50 inseguro	1	
No sabia esta un 50 seguro y un 50 inseguro Ademas yo ya te quería decir en el tenis pero nunca estabamos solos	1	
Perdoname soy muy inseguro aveces pero a la vez seguro mis emociones se revuelven perdona plox	1	
Pero el de kate es el más seguro dentro de lo inseguro	1	
Prefiero mil veces despacito y seguro que rapido e inseguro	1	
Primero creo que a vos se te hiso facil , porque con mi primer novia salimos un año para conocernos , nos pusimos de novios y ahi recien la bese y bueno toda la historia , pero un año porque no estaba seguro , yo me sentia inseguro , sentia ansiedad o muchas cosas	1	
Pz siii xq enves de estar eaperando a alguien inseguro de si mismo pud estar kn alguien seguro de loq keria	1	
Soy muy inseguro pero trato de mostrarme seguro ante las personas 2  .	1	
Y cuando te manden a la chingada otra ves que estés solo te acuerdas que yo te había aceptado con todo y paqueta aunque no sea tuya pues porque por eso siempre estuviste inseguro conmigo porque de seguro era una piruja la mama tu niña y siempre te vio la cara de wuey pero conmigo te equivocaste porque yo cuando estoy alguien soy nada más de esa persona	1	
Yo estoy seguro de estar con vos , estoy inseguro en si vos quered estar conmigon , si sabes comportarte y todas esas cosas	1	
Yo no estoy seguro ee tener una relación porquenrstoy inseguro	1	
Yo te veo como un chico inteligente , buena persona , buen amigo , seguro no tenes porque ser inseguro ni desconfiado	1	
mi amor , donde sea me sentía inseguro tu me construiste y me hiciste seguro me regresaste mi orgullo preciosa amiga contigo eres alguien que puede contar conmigo	1	
#cierto,	incierto
Elige tu camino cuidadosamente por que el futuro es incierto , pero eso es lo que hace la vida emocionante , cierto  ?	13	
Quédate Con lo incierto , así sea que lo cierto es lo que más quieras  .	5	
Es tan cierto que todo en la vida es incierto , mas sin embargo el hecho de aceptar las cosas duelen y duele tremendamente  .	3	
Es cierto , todo es muy delicado e incierto , hay q votar el domingo , y tienen q dejarnos expresar en las urnas , q Dios acompañe a la flia de Santiago y a nosotros	1	
Leí mal lo del incierto jajaa leí es tan cierto jajajajaja	1	
No me gano un premio y sobran consiertos seamos sinceros estamos en lo cierto que soy soldado eso es incierto tu vende copias si estan en descuento mucho carro y mucho blin blin y del banco siempre suena el ring ring	1	
No me gano un premio y sobran consiertos seamos sinceros estamos en lo cierto que soy soldado eso es incierto tu vende copias si estan en descuento mucho carro y mucho blin blinda	1	
Pero te quiero sintiéndote cerca , inevitablemente , en lo cierto de mi almohada , y lo incierto de la mañana  .	1	
Si es cierto , total q la salud es algo tan incierto	1	
#probable,	improbable
Ummya ps la verdad hay un 95 improbable y un 5 porciento probable	1	
#(只列出阳性单数形式),	(只列出阳性单数形式)
#bajo,	más bajo
#viejo,	más viejo
Cuando te conosi pensé que eras normal jejé pero no y te quiero desear un feliz cumpleaños niño hoy eres un año más viejo y como dice algo tu eres como los vinos entre mas viejo mas bueno  .	1	
Jajajajaj eso es más viejo que el ron viejo de caldas	1	
#rápido,	más rápido
Porque lo metias rápido y todo y luego más rápido	2	
Bueno , al menos eso es lo que tú haces , yo trato de contestar los más rápido que puedo , pero entiendo que tú no contestas rápido porque tienes más ocupaciones que yo	1	
Condujo rápido , adelantando algunos coches , centrado en lo que hacía para llegar más rápido  .	1	
La vida es como un churro entre más rápido le jales mas rápido se acaba xdxd	1	
Lo hago más rápido , lo meto un poquito y sacó muchas veces y rápido	1	
No es que perdóname amor de verdad te pongo toda la atención del mundo horita estaba viendo la película esa que me dejaron de tarea y mientras te contestaba a ti y como te dije a mi no me importa lo que éste haciedo yo voy y contesto tu mensaje lo más rápido que puede después me lo contestas y yo te lo contesto rápido baby	1	
O matala lo más rápido que puedas para que acabe el dolor rápido 'v	1	
Ojalá encuentre rápido a otra así solo ocupamos menos días y empezar más rápido y con mas tiempo em buscar y seguir con nuestros planes	1	
Pero quisiera terminar rápido me quiero presentar al ejército lo más rápido	1	
Porque Nacho va rápido y lo quiero alcanzar por lo que voy más rápido , y él también y al final termino sin aire	1	
Pues si , es algo más rápido , me sorprendi al llegar aquí bien rápido , nunca me imagine que hubiera calpus ahi en la tapo	1	
Sip , así más rápido , en camión también es rápido pero el otro si se pasó de v  .	1	
Subaru llega a donde esta ella con un carro del cual se baja rápido y la toma para después meterla al auto y arrancar lo más rápido posible dejando la marca negra de las llantas Me la quedo Bv	1	
Te creo que me extrañas Y aunque los días se pasan rápido , y llega rápido sábado , el fin de semana se pasa aun más rápido y te extraño en cuanto te vas por que hemos estado todo el tiempo juntos y si pienso en eso , sería aun mas triste cada q te despides	1	
Y a veces no respondo los mensajes por hacer tarea o estar con música para terminar rápido y poder hablar contigo respondiendo lo más rápido que pueda v	1	
Ya veras mi niña que se pasara rápido el tiempo y que estaremos juntos más rápido	1	
y lgo soy labque más rápido escribe en la láp y me pusieron a hscer lgo que querían rápido y me regañan que ahora ando bien lenta y que si no lo quería hacer hubiera dichi que no	1	
Íbamos a cadorna y un pibe estaba en la esquina de camino y se hacia el de hablar cuando nosotras pasamos se puso para mi lado y empezó a caminar rápido hacia nosotras rápido nos dimos cuenta y caminamos más rápido y nos juntamos con otra gente pero ya estaba cerca	1	
Íbamos a cadorna y un pibe estaba en la esquina de camino y se hacia el de hablar cuando nosotras pasamos se puso para mi lado y empezó a caminar rápido hacia nosotras rápido nos dimos cuenta y caminamos más rápido y nos juntamos con otra gente pero ya estaba cerca se dio la vuelta y volvió donde estaba haciéndose el boludo y nos miraba	1	
#pesado,	más pesado
Si jajaja encima a mi me gusta levantar re pesado pero tengo que levantar más pesado todavia	1	
#tenso,	más tenso
#simple,	más simple
Lo haré más simple yo todo pero simple	1	
#grande,	más grande
Le queda grande la palabra padre y aún más grande la palabra HOMBRE	3	
Acabo de adoptar este gato con mi novio , el tiene un gato más grande que tiene 5 años , copito el gato grande esta acostumbrado a vivir solo ,	2	
La más grande 500 y la otra 300 vendo ya si son de Monte grande la llevo	2	
Acabo de adoptar este gato con mi novio , el tiene un gato más grande que tiene 5 años , copito el gato grande esta acostumbrado a vivir solo , y no le gusta que lo alcen , y a veces es arisco  .	1	
AjajajaSi mi pareja es más grande que tu Y No me es tan grande  !	1	
Claro amor yo confío en ti y en todo el amor nuestro amor es mas grande que nada es más grande que la autoridad de la directora quee no hicimos caso porque nos amamos si asi te aferras ala vida juntos se ara verdad amor	1	
De estas almas tan dulces y puras se aprende más que en cualquier facultad Ellos superaron lo que cualquier grande no podría , se merecen la felicidad más grande del mundo  .	1	
Detente y respira profundamente y recuerda que ningún problema es más grande que tú , tu eres mas grande que el  .	1	
El mas grande sigue siendo River plate y será más grande aun en el mañana	1	
El mas grande sigue siendo River plate y será más grande aun en el mañana por el juego por las ganas y el orgullo de tener una vanda r	1	
El mas grande sigue siendo River plate y será más grande aun en el mañana por el juego por las ganas y el orgullo de tener una vanda roja que nos cruza el alma	1	
El pez chico se come al más grande ósea Daniel es el grande y Juan es el chico	1	
Encima no es tan grande la oanza que tengo si hubiese sido más grande nose jajaj	1	
Es lo más grande que puede haber en el mundo más grande que el mar y mas grande que la vida	1	
Es que tengo dos suéteres y no es más grande que el otro y a veces me pongo la grande y por eso no se me notan  .	1	
Ese tarro no es ni grande jajaja a lo bien , yo lo imaginé más grande y nooojjj 80mil y eso no es nada , y tras de eso viene medio vacío es como las papás fritas	1	
Hay pues mi amor por ti es más grande qué tu amor por mi que es mas grande qué mi amor por ti que supera la face dios	1	
Hay si cuando estés más grande ya vengas mas buenote y tengas una cosota mas grande y rica	1	
Hay un oso En Pablo nogues No es muy grande pero mediano es más grande qe lo qe me diste	1	
Hoy en su primer día de clases mi princesa más grande 4to grado y mi princesa más chica 1er grado que grande estan  .	1	
K-bufa y va a jugar-Y mi ropa es más grande que tú , mi pequeño chico grande	1	
La mia es más grande , me ocupa todo el culo , ahre mentira pero posta es demasiado grande	1	
La más grande 500 y la otra 300 vendo ya si son de Monte grande la llevo o si	1	
M lo hizo un poquito más grande xq era muy grande lo q tenia	1	
No amenazaba estoy planeando algo muy grande ese va a ser el hecho más grande K puedes ver	1	
No había grande por eso no te compre más grande	1	
No sentí lo mismo Sentí algo mucho más grande sentí un amor inmenso algo grande te amo	1	
Obvio que Dios es grande , es lo más grande y lo más hermoso que existe en nuestras vidas y en las de cualquiera	1	
Ooowww si que ya esta grande y la chiquita Es hija de la más grande  ?	1	
Parece mas grande y no tiene mente de niña ls tiene de más grande	1	
Pero era jóven y me estaba entregando a algo mas grande , ahora eso más grande se a ido  .	1	
Podrias utilizar una vaporera grande , o por lo menos tres veces más grande que el pastel  .	1	
Por que me hacia grande y a la vez Lulú me hacia más grande xD	1	
Pues si Esperanza es lo más grande que tengo un beso grande guapa	1	
Pues tampoco la escuela que voy no está tan grande yo veo la secundaria más grande	1	
Que si el ángulo es mas pequeño era la medida pequeña y si el ángulo es grande es la medida más grande	1	
Sabes que mi amor por ti es muy grande y el que me digas estas cosas lo hacen aún más grande	1	
Se reía porque me dijo te llevaste el más grande que habia era obvio que te iba a grande jejje	1	
Si de hecho esta bonito el lugar un día te invitaré a la fiedta grande de mi pueblo jeje Por que igual es un pueblo pero aún más grande jeje y me encanta estar aquí	1	
Te amo demasiado Mi amor por ti es tan grande como el universo ya que no tiene fin y cada vez se hace más grande	1	
Te haces la mala sólo xq sos mas grande que yo Xq no te metes con una de tu edad o más grande  ?	1	
Todas Me hacen la misma pregunta y es complicado imagínate que al pedir un talle más grande de lo normal quizás les quedan muy grande	1	
Tu mi amor mas grande nuestro amor el más grande del Mundo Te Amo	1	
Uff Yali que HERMOSURA Ya se ne hizo grande Bueno ud es más grande que ello	1	
Un beso grande a todos y uno más grande a alumine	1	
Y así o más grande te as comido o este es el primero grande que bes	1	
Y de grande es como acá un poco más grande no mas	1	
Ya estas mas grande Primita kiara , de echo siempre has estado más grande , porque un primo chaparro	1	
el mío es mas grande , uff es que me equivoqué , el mío es muchisisimo más grande millones de millones de millones así es mi vida muchaaaaaa tuu eres el mejor cielo lindo te quieroooo y te quieroo y te quierooooo por y para siempre amor , te quiero con mi vida entera que todo siemore sea de tu mano	1	
#caliente,	más caliente
Ya te deje caliente , no hace falta que te deje más caliente	1	
#grande,	más grande
Le queda grande la palabra padre y aún más grande la palabra HOMBRE	3	
Acabo de adoptar este gato con mi novio , el tiene un gato más grande que tiene 5 años , copito el gato grande esta acostumbrado a vivir solo ,	2	
La más grande 500 y la otra 300 vendo ya si son de Monte grande la llevo	2	
Acabo de adoptar este gato con mi novio , el tiene un gato más grande que tiene 5 años , copito el gato grande esta acostumbrado a vivir solo , y no le gusta que lo alcen , y a veces es arisco  .	1	
AjajajaSi mi pareja es más grande que tu Y No me es tan grande  !	1	
Claro amor yo confío en ti y en todo el amor nuestro amor es mas grande que nada es más grande que la autoridad de la directora quee no hicimos caso porque nos amamos si asi te aferras ala vida juntos se ara verdad amor	1	
De estas almas tan dulces y puras se aprende más que en cualquier facultad Ellos superaron lo que cualquier grande no podría , se merecen la felicidad más grande del mundo  .	1	
Detente y respira profundamente y recuerda que ningún problema es más grande que tú , tu eres mas grande que el  .	1	
El mas grande sigue siendo River plate y será más grande aun en el mañana	1	
El mas grande sigue siendo River plate y será más grande aun en el mañana por el juego por las ganas y el orgullo de tener una vanda r	1	
El mas grande sigue siendo River plate y será más grande aun en el mañana por el juego por las ganas y el orgullo de tener una vanda roja que nos cruza el alma	1	
El pez chico se come al más grande ósea Daniel es el grande y Juan es el chico	1	
Encima no es tan grande la oanza que tengo si hubiese sido más grande nose jajaj	1	
Es lo más grande que puede haber en el mundo más grande que el mar y mas grande que la vida	1	
Es que tengo dos suéteres y no es más grande que el otro y a veces me pongo la grande y por eso no se me notan  .	1	
Ese tarro no es ni grande jajaja a lo bien , yo lo imaginé más grande y nooojjj 80mil y eso no es nada , y tras de eso viene medio vacío es como las papás fritas	1	
Hay pues mi amor por ti es más grande qué tu amor por mi que es mas grande qué mi amor por ti que supera la face dios	1	
Hay si cuando estés más grande ya vengas mas buenote y tengas una cosota mas grande y rica	1	
Hay un oso En Pablo nogues No es muy grande pero mediano es más grande qe lo qe me diste	1	
Hoy en su primer día de clases mi princesa más grande 4to grado y mi princesa más chica 1er grado que grande estan  .	1	
K-bufa y va a jugar-Y mi ropa es más grande que tú , mi pequeño chico grande	1	
La mia es más grande , me ocupa todo el culo , ahre mentira pero posta es demasiado grande	1	
La más grande 500 y la otra 300 vendo ya si son de Monte grande la llevo o si	1	
M lo hizo un poquito más grande xq era muy grande lo q tenia	1	
No amenazaba estoy planeando algo muy grande ese va a ser el hecho más grande K puedes ver	1	
No había grande por eso no te compre más grande	1	
No sentí lo mismo Sentí algo mucho más grande sentí un amor inmenso algo grande te amo	1	
Obvio que Dios es grande , es lo más grande y lo más hermoso que existe en nuestras vidas y en las de cualquiera	1	
Ooowww si que ya esta grande y la chiquita Es hija de la más grande  ?	1	
Parece mas grande y no tiene mente de niña ls tiene de más grande	1	
Pero era jóven y me estaba entregando a algo mas grande , ahora eso más grande se a ido  .	1	
Podrias utilizar una vaporera grande , o por lo menos tres veces más grande que el pastel  .	1	
Por que me hacia grande y a la vez Lulú me hacia más grande xD	1	
Pues si Esperanza es lo más grande que tengo un beso grande guapa	1	
Pues tampoco la escuela que voy no está tan grande yo veo la secundaria más grande	1	
Que si el ángulo es mas pequeño era la medida pequeña y si el ángulo es grande es la medida más grande	1	
Sabes que mi amor por ti es muy grande y el que me digas estas cosas lo hacen aún más grande	1	
Se reía porque me dijo te llevaste el más grande que habia era obvio que te iba a grande jejje	1	
Si de hecho esta bonito el lugar un día te invitaré a la fiedta grande de mi pueblo jeje Por que igual es un pueblo pero aún más grande jeje y me encanta estar aquí	1	
Te amo demasiado Mi amor por ti es tan grande como el universo ya que no tiene fin y cada vez se hace más grande	1	
Te haces la mala sólo xq sos mas grande que yo Xq no te metes con una de tu edad o más grande  ?	1	
Todas Me hacen la misma pregunta y es complicado imagínate que al pedir un talle más grande de lo normal quizás les quedan muy grande	1	
Tu mi amor mas grande nuestro amor el más grande del Mundo Te Amo	1	
Uff Yali que HERMOSURA Ya se ne hizo grande Bueno ud es más grande que ello	1	
Un beso grande a todos y uno más grande a alumine	1	
Y así o más grande te as comido o este es el primero grande que bes	1	
Y de grande es como acá un poco más grande no mas	1	
Ya estas mas grande Primita kiara , de echo siempre has estado más grande , porque un primo chaparro	1	
el mío es mas grande , uff es que me equivoqué , el mío es muchisisimo más grande millones de millones de millones así es mi vida muchaaaaaa tuu eres el mejor cielo lindo te quieroooo y te quieroo y te quierooooo por y para siempre amor , te quiero con mi vida entera que todo siemore sea de tu mano	1	
#duro,	más duro
Bueno tatis quiero decirte que eres buena amiga gracias por tus risas escandalosas por fuera de clase , me encanta tu forma de ser y pues que no te dejes de nadie Jajajaj me encanto a principios de año que le diera duro a la leidy vargas , Le hubiera dado más duro  .	1	
Es que a mi me da pesar morderal más duro , pero la voy a morder duro	1	
Esta duro y se va poner más duro	1	
y para adelante que el camino es duro , a mantener la relación que es más duro todavía y nunca se le olvide enamorarla todos los días	1	
#alto,	más alto
A mi tío lo que le a afectado es en la altura , el estaba alto , claro que aún no lo alcanzó pero era más alto	2	
Pero es que algunos somos así , cuando sentimos algo de verdad estamos dispuestos a perderlo todo y ni el más alto precipicio te parecerá alto , pero para los cobardes , la más corta altura parecerá una eternidad  .	2	
De repente en una fracción de segundo grité cuando Sonic se lanzó hacia la pantalla gritando como loco , con su boca tan ancha que no era natura , desvelando una espiral al abismo de pura oscuridad antes de que volviera el rojo eterno , esta vez mucho más alto y distorsionado , con un sonido tan alto que me hacía daño en los oídos  .	1	
Jajaja si Baby Ud es mas alta que ella , su hermana Linda poquito mas alta que ud , Javier es mas alto que Linda y Marlón más alto que todosSe alocaron con las medidas xD	1	
Si eras más alto que yo pregunta boluda , cualquiera es mas alto que yo	1	
Yo lo único que se es lo que te dije y que es alto Osea todo el mundo es más alto que yo	1	
#fuerte,	más fuerte
Puedes pensar que no lo soportaré , pero estás equivocado Porque ahora soy Más fuerte que ayer Soy más fuerte  .	2	
Si alguien ha sido fuerte para derrumbarte , demuéstrale que eres mucho más fuerte para levantarte	2	
A mi me gusta que las muerdan , un poco fuerte y cuando estoy más prendida , más fuerte	1	
Ay es que tampoco nmmes como voy a pedir que te alejes de mi si tu has echo que cambie en algunas cosas nunca pediría que te alejaras de mi , Pues si me has dicho cosas fuerte que me han dolido , pero con eso me eh echo más fuerte  .	1	
Contigo Contigo mi detector de metales se arruinó sonó día y noche más fuerte que la sirena de una ambulancia más fuerte que la sirena del camión de bomberos Esta sensación es tan fuerte y tan agradable que quisiera que tú también la sientas alguna vez en tu vida Buenas noches hermosa	1	
De lo rico que lo estés sintiendo y que te duela y que grites fuerte y me digas cosas sucias y más fuerte te doy bb	1	
De nada , Tu me has echo más fuerte denlo Que era , Sólo me fsltaba ser fuerte con las oalabras de la chica que amo pero ya me has echo alguien mas fuerte  .	1	
Después te subís arriba mio y te agarró fuerte otra vez de la cintura y te hago cada vez más fuerte	1	
Dije Q me regresa el golpe igual de fuerte , nunca dije que me lo regresa más fuerte	1	
Dio otro gruñido un poco más fuerte mientras con su pata derecha pisa fuerte el suelo tenía que ser fuerte  .	1	
El dolor están fuerte k nose aguanta asta el más fuerte llora	1	
Entonces hoy quise postear está foto porque no sólo la MUJER es fuerte para tener un hijo ni para aguantar y callar las lágrimas es mucho más fuerte que eso eso capaz de levantarse cada día con una sonrisa apesar de las dificultades y dar al mundo todo ese amor que la caracteriza sólo por el sentido de ser MUJER  .	1	
Ese Dios es fuerte y más si sabes usarlo , con uno de los especiales más fuerte y ni hablar Adele	1	
Ese Dios es fuerte y más si sabes usarlo , con uno de los especiales más fuerte y ni hablar Arele	1	
Jajajja entonces si yo te la doy fuerte tu me la regresas más fuerte  ?	1	
Le decía mas fuerte xq qria q le de más fuerte no q le pegue jaja	1	
Me cacheteas mas fuerte y te cojo más fuerte  .	1	
Me marca mi tío para felicitarme hasta hoy y para decirme q habrá un temblor más fuerte q por favor nos salgamos si esta muy fuerte quería q le pasara a mi tía pero pues ya se durmio	1	
Mike lo abraza fuerte es difícil escucharte cada vez me lo gritan más fuerte	1	
No te dejaré de lado mi amor , aún cuando hayamos tenido una fuerte pelea , hay algo mucho más fuerte	1	
Oye tranquilo , se qué eres fuerte no caigas ante los demás demuestrales qué eres más fuerte de lo qué ellos creen	1	
Pero así sea muy difícil y la corriente sea fuerte tú debes ser más fuerte y vencer todo	1	
Pero eso también demuestra que a pesar de todo , tú sigues de pie , eres fuerte y eso te hizo aún más fuerte	1	
Pero tu eres mas fuerte que eso , mucho más fuerte  !	1	
Pues si ella paso por esa situación fuerte la hizo mucho más fuerte es bien linda	1	
Si tu eres fuerte yo tengo que ser aún más fuerte , personas hay muchas pero como tu ninguna	1	
Tengo un óxido a la mitad , es como un quemador pero poco más fuerte , al chile no está tan fuerte , lo quieres  ?	1	
Tienes un corazón sp fuerte y tienes la responsabilidad y eso Te ase más fuerte	1	
Tú eres muy linda , y te mereces lo mejor del mundo , tienes que estar súper fuerte te demostrar que eres más fuerte que cualquier otra cosa	1	
Y si te bloquie xq quería olvidarte pero lo q siento es mas fuerte y kda día ea peor y más fuerte Mi Amor x vos	1	
cada oración , cada palabra y cada letra escrita por ti hacen que me sienta dichosa en toda la extensión de la palabra , ya no se como expresar lo que me haces sentir , es demasiado fuerte lo que siento , como alguna vez te dije es más fuerte que la palabra AMOR  !	1	
empiezo a gemir un poco más fuerte mientras me sigo aferrando fuerte a las sabanas y muevo mi cola un poco	1	
la abraza mas fuerte y le empieza a morder más fuerte el labio	1	
#brillante,	más brillante
#barato,	más barato
Ahorita ya estoy en mi casa , pero el lunes saco el montaje en la compu y ya te digo que es lo que te sale más barato , pero yo creo que lo mas barato son como tipo calcas	1	
Ella me dijo q con la membresía ya lo podía comprar más barato pero no me dijo q tan barato	1	
Esta barato Amor cuando quiera llegar julio está más barato digo yo amor	1	
Si es que así es esto , si el ocupa bordado le hago un paro y viceversa , yo le dejo las barato y el me deja más barato , esa es la ganancia de ambos , como quiera trabaja bien , y el tema del vector es qie trabajan programas diferentes , eso es todo , al igual ponte de acuerdo con el	1	
#caliente,	más caliente
Ya te deje caliente , no hace falta que te deje más caliente	1	
#joven,	más joven
#rápido,	más rápido
Porque lo metias rápido y todo y luego más rápido	2	
Bueno , al menos eso es lo que tú haces , yo trato de contestar los más rápido que puedo , pero entiendo que tú no contestas rápido porque tienes más ocupaciones que yo	1	
Condujo rápido , adelantando algunos coches , centrado en lo que hacía para llegar más rápido  .	1	
La vida es como un churro entre más rápido le jales mas rápido se acaba xdxd	1	
Lo hago más rápido , lo meto un poquito y sacó muchas veces y rápido	1	
No es que perdóname amor de verdad te pongo toda la atención del mundo horita estaba viendo la película esa que me dejaron de tarea y mientras te contestaba a ti y como te dije a mi no me importa lo que éste haciedo yo voy y contesto tu mensaje lo más rápido que puede después me lo contestas y yo te lo contesto rápido baby	1	
O matala lo más rápido que puedas para que acabe el dolor rápido 'v	1	
Ojalá encuentre rápido a otra así solo ocupamos menos días y empezar más rápido y con mas tiempo em buscar y seguir con nuestros planes	1	
Pero quisiera terminar rápido me quiero presentar al ejército lo más rápido	1	
Porque Nacho va rápido y lo quiero alcanzar por lo que voy más rápido , y él también y al final termino sin aire	1	
Pues si , es algo más rápido , me sorprendi al llegar aquí bien rápido , nunca me imagine que hubiera calpus ahi en la tapo	1	
Sip , así más rápido , en camión también es rápido pero el otro si se pasó de v  .	1	
Subaru llega a donde esta ella con un carro del cual se baja rápido y la toma para después meterla al auto y arrancar lo más rápido posible dejando la marca negra de las llantas Me la quedo Bv	1	
Te creo que me extrañas Y aunque los días se pasan rápido , y llega rápido sábado , el fin de semana se pasa aun más rápido y te extraño en cuanto te vas por que hemos estado todo el tiempo juntos y si pienso en eso , sería aun mas triste cada q te despides	1	
Y a veces no respondo los mensajes por hacer tarea o estar con música para terminar rápido y poder hablar contigo respondiendo lo más rápido que pueda v	1	
Ya veras mi niña que se pasara rápido el tiempo y que estaremos juntos más rápido	1	
y lgo soy labque más rápido escribe en la láp y me pusieron a hscer lgo que querían rápido y me regañan que ahora ando bien lenta y que si no lo quería hacer hubiera dichi que no	1	
Íbamos a cadorna y un pibe estaba en la esquina de camino y se hacia el de hablar cuando nosotras pasamos se puso para mi lado y empezó a caminar rápido hacia nosotras rápido nos dimos cuenta y caminamos más rápido y nos juntamos con otra gente pero ya estaba cerca	1	
Íbamos a cadorna y un pibe estaba en la esquina de camino y se hacia el de hablar cuando nosotras pasamos se puso para mi lado y empezó a caminar rápido hacia nosotras rápido nos dimos cuenta y caminamos más rápido y nos juntamos con otra gente pero ya estaba cerca se dio la vuelta y volvió donde estaba haciéndose el boludo y nos miraba	1	
#profundo,	más profundo
Jajajaja Ya veo pero creo que en lo muy profundo de tu ser en lo más profundo de tus instintos tuto yandere interior Aún no a despertado	1	
#ruidoso,	más ruidoso
#nuevo,	más nuevo
La intro del nuevo Xiumin es lo más nuevo	1	
#amplio,	más amplio
#mal,	peor
Dime lo que hice mal , te pusieron en contra de mi pero es peor pedir perdon que perdonar Se murio una flor y cambio de color , tu eras mi diabla y yo te daba calor  .	25	
Odio que estés así nena me rre aleje de vos me arrepiento una banda negra saber que estas mal y no te voy a ver me pone peor ami yase no te hablo ni nada pero me ases una rre falta amor  .	16	
Xfavor ya no puedo soportar seguir así me siento muy mal , estoy destrozado y cada día q pasa me siento peor y x lo mas sagrado yo ya no puedo soportarlo mas , no soy tan valiente , se que si hablamos nos sentiremos mejor x q aclararemos muchas dudas , ya q si no esto nos perseguira x siempre , lo peor es seguir viviendo en esta incertidumbre y con esta duda  .	12	
logro hacerte sentir mal logró a ser que tu mejor día se vuelva el peor de todos los dias no te culpo  .	10	
Esta es la peor de las tiendas para mandar hacer un vestido , quedan mal mandan hacer un vestido que uno no pide y lo pides con tiempo y nunca llega esperan que uno los considere , las empleadas son groseras y sangronas , el dueño es un cretino y grosero de lo peor  .	7	
Sos unas gran mujer y una gran señorita yo nose lo que te anda pasando capas vos ya no contas con migo y te SUPER ENTIENDO pero sabelo por mas que estamos en el peor momento vas hacer todo para mi y si vos estas mal yo me pongo mal tambien  .	7	
Contigo estoy mal pero sin ti estoy peor  .	6	
Si los que hablan mal de mí supieran exactamente lo que yo pienso de ellos , hablarían peor  .	6	
Contigo estoy mal pero sin ti estoy peor lo bueno y malo en mi vida  .	5	
La verdad me acostumbre muchísimo ah vos y te extraño un montón yo se que ise muchísimo daño de corazón te pido perdón desde ese último viernes tw juro que no puedo estar bien es muy difícil yo solo necesito poder Hablar con vos y estar un ratito bien te juro que nunca estuve tan mal asi todos los dias con una lágrima y cada ves peor  !	5	
Lo peor es que ni trato mal , pero así es la vida  .	5	
Me caes re mal puta gorda tonta y peor la taradita que se hace la putita de Mimi reinoso esa tonta con la que te estas juntaste que se la súper come  .	5	
Nada , solo me siento mal estoy enferma y poco a poco peor Sii Itsugo Jeje ay no se que decir Bueno eh bebé Es que fue de la nada que cuando lo leí me puse nerviosa	5	
Que es peor que un hombre hable mal de una mujer o que ella vuelva con el	5	
Y si lo haces cuando hasta mal me siento es peor yo creo que eres muy desconsiderado con migo , y si no quieres cambiar eso entonces que  .	5	
Bueno ayer se lo contaron a marcos y corte se pudrió todo x Alla salieron con q soy puta y eso y lo peor es que ya fue todo con Mi negrito y estoy rre mal negra marcos ayer me dijo x msj que hable con la mama de el para arreilar las cosss pero hoy le mande msj ala mama y me mando ala mierda todo junto  !	4	
Es que ah soy la peor persona y la peor novia te puse mal te puse mal y eso no estuvo bien ah perdón me siento de lo peor lastime a Itsugo y dije que no lo haría	4	
Jajajajajajajaja pues si entra una nueva que le cae mal ja , que miedo esas miradas , y lo peor es que dice que no mira feo , con si lo hace	4	
Me sucedieron cosas malas y estuve triste , en el recreo pensé que te quedarías y quería estar contigo pero no , te fuiste , también te se notar que no me sabias tomar mucha importancia y quería acercarme pero no pude , en el curso me fue mal terrible pesimo fue lo peor y estuve triste , te preocupaste , los demas me trataron de hacer sentir mejor y quería estarlo pero ser por ti  .	4	
Nada , solo me siento mal estoy enferma y poco a poco peor Sii Itsugo Jeje ay no se que decir Bueno eh bebé	4	
No como me va a caer bien osea todavía que le digo las cosas bien el morro meco no me contesta y yo aaah no ma si ahora me caes mal ahora me caes peor ya sabes que soy bien mamona Alch tu y punto No no tu tu y ya ahora si no se habla más del tema	4	
No puedo seguir asi , tuve la oportunidad de matar a Liora y no lo hice Me siento muy mal y sabes que es lo peor que ni siquiera me ha dicho terminamos y se me hace dificil todo bien lo siento	4	
Nose si estoy bien o mal solo que sigo igual o peor que ayer  !	4	
Nosotras las mujeres perdonamos siempre aun que nos mientan , nos fallen , nos traicionen nos engañen , pero si hacemos algo mal para ellos ya somos la peor persona del mundo  .	4	
O no se según los mensajes que lee eres su amor pero eso no me importa si solo te digo una cosa ami nadie me trata de cabrona sobre todo ningún mal marido me levanta la voz yo soy peor te puedo hacer la vida imposible	4	
Si yo tambien pienso que se enojo pero trato de no expresarlo Ja ja ja ja ya se Y lo peor que pagamos todos por alguien que hizo las cosas mal	4	
Trato de no ponerme mal pero no puedo cada vez es peor para mi  .	4	
Tu no quieres saber na de mi , dime que fue lo que yo hice mal te pusieron en contra de mi pero es peor pedir perdón que perdonar	4	
Y pues lo que si te dire esque vino Andres y pues tenia mucho dolor de cabeza y mal humor y pues me sentía débil nose algo tensa y pues con lo mal ke me fue aun con eso peor ya te imaginaras	4	
Y si crees qué en el olvido se anestesia un mal de amor , ni hay peor remedió qué la soledad  .	4	
Ya empecé mal el día Y se va a poner peor  .	4	
en estos momentos eres la peor persona que conozco y no lo digo de mal es de biem sabes nunca me había dolido tanto q me engañaran pero bueno ya que ojala nunca volverte a ver en mi vida todo mi enojo en una carita	4	
eso si me pone peor Cuando te trato mal  ?	4	
por queeeeee me queren joder la puta vidaaaaa mi corazón ya no agunta más basuraaaaaaaaaaaaaaaaaaaaaaaaaaaa dices que soy de lo , peor para ud OK gracias por hacer me sentir tan mal señor  .	4	
24- tratame mal y te trato peor	3	
Ay amor enserio me siento tan mal me siento lo peor amor	3	
Ay eso si es muy especial pero no te sientas mal por ello a mi igual me paso y peor una ocasio	3	
Ay eso si es muy especial pero no te sientas mal por ello a mi igual me paso y peor una ocasión se me pasaron unas manzanas desde puta un chingo	3	
Ay eso si es muy especial pero no te sientas mal por ello a mi igual me paso y peor una ocasión se me pasaron unas manzanas desde puta un chingo ya tenían mo las chingaderas	3	
Con tigo estoy mal pero sin ti estoy peor	3	
Cuando pregunten por mo decirles que estoy re mal , cada vez peor  .	3	
Es que ah soy la peor persona y la peor novia te puse mal te puse mal	3	
Es que ah soy la peor persona y la peor novia te puse mal te puse mal y eso no estuvo bien	3	
Es que ah soy la peor persona y la peor novia te puse mal te puse mal y eso no estuvo bien ah perdón me siento de lo peor	3	
Es que ah soy la peor persona y la peor novia te puse mal te puse mal y eso no estuvo bien ah perdón me siento de lo peor lastime a Itsugo	3	
Es que peor va ser que forcemos y nos salga mal	3	
Estaba mal Y no me iba a aser Nda pero ella me iso poner peor todavia las ganas de llorar no se aguantan	3	
Hice mil cosas bien y nadie me dijo nada , hice una cosa mal y soy la peor persona del mundo  .	3	
Lamento el mal día quería q mejor y siempre termina peor	3	
Lamento el mal día quería q mejor y siempre termina peor pero por lo menos lo intente	3	
#largo,	más largo
A ver que tal trate de no hacerlo tan largo en mi cabeza era algo más largo para explicar todo pero mejor así para no aburrir a los niños	1	
Es lo más normal del mundo sabes , es un largo proceso y lo harás más largo si no te propones salir de esto	1	
Pero hay uno más largo que me gusto más pero no lo puedo enviar dice que es muy largo	1	
Si podes el q tenga el cable más largo o sino de esos q van con usb y un cable largo	1	
Y ahorita de largo lo traigo como a media espalda o poquito más largo	1	
en las fotos se me ve el pelo largo , pero atrás lo tengo más largo	1	
lo he tenido más largo que ahora , pero lo tengo largo	1	
#lento,	más lento
Sé lento en la elección de un amigo , pero más lento en cambiarlo  .	3	
Es un proceso lento , no lo hagas más lento renunciando  .	1	
Quitó la última conexión y el visto , dijo que quería ir más lento , pero no se fue con mamadas cuando dijo lento	1	
#fácil,	más fácil
Es fácil la vida es más fácil de lo que la hacemos	1	
JAJAJAJA ande ya se ; Esque el aún tiene mucho para enseñar El merece una despedida digna Esque me caía mal el profe v Claro que no , todo será más fácil en el futuro y fácil de comprender vSi quieres llevarlos para que lo destruyan vPorque los odias  ?	1	
No se gaby a mi se me hace más fácil la de fomi que de tela No se como se haga fácil para ti gaby  .	1	
T I M I N G POEMA RÓMANTICO IMPUNTUAL Hola llegué tarde espero que me perdones el tráfico emocional está bien cabrón a estas horas no te dejan pasar y todos quieren meterse me gusta sumergirme en el amor a destiempo es fácil amar cuando sabes hacerlo cuando ya sanaste tus heridas cuando es más fácil ser feliz el amor es fácilnosotros somos los complicados	1	
gracias por llegar a mi vida , no te dejare ir tan fácil pero aquí yo te quiero mas eso que quede claro pero sinceramente es más fácil que llegue alguien a tu vida y me dejes a tras	1	
gracias por llegar a mi vida , no te dejare ir tan fácil pero aquí yo te quiero mas eso que quede claro pero sinceramente es más fácil que llegue alguien a tu vida y me dejes atras	1	
#corto,	más corto
#pequeño,	más pequeño
Comunitario No ma regresé ahi Hace una semana y me senti más pequeño , no le acordaba que las porterias fueran grandes y me senti pequeño	1	
Si por que esta estirado pero realmente es muy pequeño como el tamaño de un diente normal eso si un poco más pequeño pero esa es mas o menos la medida	1	
#agudo,	más agudo
#seguro,	más seguro
Ahhh si haber si te dan esque si era al seguro para que te dieran más seguro pero haber que te dice tu líder  .	1	
El sabado tal y Zaira hace fiesta en su casa , dijo que era lo más seguro pero no es seguro aún	1	
El sabado tal y Zaira hace fiesta en su casa , dijo que era lo más seguro pero no es seguro aún no preguntes así me dijo , esta bien si voy no te molesta  ?	1	
Es orgullo lo más seguro deja que se ablande un poco y seguro que te dice que sí	1	
Esq la temporada de los toty ya pasó aunque lo más seguro después los metan pero seguro falta mucho , porque los que faltan q salgan son los tots q son el equipo de cada liga de Europa , ósea sacan un equipo entero de los mejores jugadores de las mejores ligas de Europa , pero hay que esperar a que las temporadas terminen	1	
Lo haces , Lo puedes hacer de eso estoy seguro , es lo más seguro Lo mire fijamente	1	
Pero mi amigo el contador dice que lo más seguro es que mi aumento se fue en el isr , seguro social y el fondo	1	
pero en el seguro me advirtieron que lo más seguro nazca prematuro	1	
#frío,	más frío
Colada morada , es parecido a la tizana , con diferencia que es cocinada , piña , babaco como la lechoza , mora , fresas , harina morada y otrosSe toma tibio o frío , me gusta más frío , incluso he hecho helado de tets con eso jajaja	2	
No hay tanto frío , ya cuando callo la primera agua si empezo a hacer más frío	2	
Hoy hace más frío que otros días porque aún con mi cobijita y otra más gruesa tengo frío	1	
No pues está bien no te preocupes entonces éste vamos otro día cuando haga más frío porque ahorita ya está no está haciendo frío	1	
Si que hace demasiado frío , jaja me bañe con agua tibiesita y aún asi siento más frío	1	
#bueno,	mejor
Que bueno que ya estas mejor	119	
Que bueno que ya esta mejor	89	
Que bueno que ya estes mejor	88	
Mi Esposo , mi bebé , mi corazón , mi razón de ser , mi todo Si amor eso es lo bueno que ya vas a estar mejor y Cuantas inyecciónes te dieron amor  ?	84	
Que bueno que ya este mejor	65	
bueno amor de la mejor a pesar de las peleas , celos , llantos , risas , locuras , etc  .	63	
aunque no hablemos mucho x 2 siempre cuenta conmigo para todo Pendejito sigue así no cambies por nada ni por nadie Te quiero menso Te amo niño Te adoro indiota Bueno bueno niño Feliz Cumple te deseo todo lo mejor del mundo que todo lo que te propongas lo logres  .	43	
Que bueno que ya estés mejor	41	
Si mi bebé mucho pero mucho mas cariñosos Que bueno mi osito me alegro mucho pero mucho que estes mejor Hay mi cielo te amo mucho pero mucho mi bebé Esque es la verdad mi amor Porque si es mentira amor  .	36	
Lo bueno es que ya estas mejor	34	
Que bueno que ya te sientas mejor	32	
Que bueno que ya te sientes mejor	32	
Lo bueno que ya estas mejor	28	
Bueno cuina pero por una parte ps velo por el lado bueno ya staras tu qin tus hijos nadie mejor que tu para cuidalos	25	
bueno , en realidad , la q siempre sera la mejor para mi va a ser la de nuestro año esa junta estuvo hermosa y si asi estuvo en un año  .	25	
Lo bueno es que ya esta mejor	23	
Que bueno que te sientas mejor	23	
Que bueno yo igual , ten aun mejor día que yo  .	23	
Pero lo bueno es que ya estas mejor	22	
3 Estason las mañanitas que cantaba hoy para ti hoy por ser tu cumpleaños te las canto yo sai Eyyyy niña muchas felisidades que sigas cumpliendo muchos años mas que te la pases de lo mejor hoy en tu día sabes que te quiero mucho y pues eres la mejor la que siempre me acompaña en mis locuras bueno pues eso es todo y sabes que cuentas con migo en todo te quiero mucho cuídate niña y me guardas pastel	21	
Lo bueno que ya esta mejor	21	
Pero que bueno que ya estas mejor	21	
tu eres mi confidente , mi mejor amigo , mi fotógrafo , bueno eres mi TODO mi amor  .	21	
Q bueno q ya este mejor	18	
Q bueno q ya estas mejor	17	
Que bueno minreina que ya estes mucho mejor	16	
Hay mi amorcito lindo siento bien feo que tu estas enfermito y yo aca sin poderte ir a ver daría lo que fuera por aunque sea irte a cuidarte poco tiempo pero así no me gusta escucharte mal am si te pones las inyección te doy lo que tu quieras si amor hazlo para que te pongas mejor y te alivies mas rapido corazón pero bueno no te puedo obligar a algo que tu no quieres amor te amo mucho mi amorcito lindo eres el único con el que estoy muy bien enserio me tienes toda enamorada de a tu	15	
Q bueno q ya estés mejor	15	
Pero lo bueno que ya esta mejor	14	
Pero que bueno que ya esta mejor	14	
Barbiiii Se que me tarde lo siento Feliz cumple Jajajajajaja ojala te la estés pasando supeeer incre Te amo como no tienes idea bueno ya lo sabes siempre te lo digo eres la mejor persona que conozco eres super especial para mi Aaaah no tengo palabras Ya te eh dicho todoooo lo q creo de ti Sabes eso es vdd lo de LAS MEJORES AMISTADES COMIENZAN CON UN TU ME CAIAS MAL no crees  ?	13	
Jajaj , esta bien amor Ah , bueno , esta bien , mejor Si , esta bien y aquí desayunamos si quieres Dije que se me antojaron Jajajaja Ash , y yo por qué  ?	13	
Nacarando se que ya te felicite por persona pero bueno equis jaja Espero y te la hayas pasado hoy de lo mejor a lado de tus seres queridos Ya 4 años casi 5 de conocernos Aun tengo tantos recuerdos que me marcaron de una manera muy linda Cuando me enseñaste a jugar pares y tu y yo juntos ganábamos  .	13	
Pero lo bueno que ya estas mejor	13	
Q bueno q ya esta mejor	13	
Q bueno q ya estes mejor	13	
a lo mejor me e exacerbado un poco aquí pero sayori ya estaba enferma , Pero bueno  .	13	
Tuyo , tuyoo Es que ahhhhh eres tan linda , enserio ese mensajeee no manchess Y yo a la mejor novia del mundo entero Es bueno o malo  ?	12	
Ya con lo primero no me quiero ni imaginar Ah yaya bueno vendría a ser lo mejor para los dos creo	12	
Bueno solo quiero desearte un feliz cumpleaños , espero te la pases bien , con tu familia , pareja y amigos , tal vez es muy pronto pero bueno creo soy el primero en felicitarte jeje , bueno ps te deseo lo mejor , tal ves ya no somos nada pero tampoco soy tan hipócrita , bueno pasatela bien  .	11	
Cuando el día no es el mejor para ti , Sonríe , siempre hay un lado bueno	11	
Muchas gracias muñequita hermosa por entenderme Qué bueno que mis explicaciones te hacen entender mejor las cosas  .	11	
Pues bby sabes que hemos pasado por momentos super felices de muchas risass que pues son super especiales que has sido mi mejor amiga desde 1ro bueno tu ya sabes pues pero que aunque no nos vemos nos seguimos teniendo el mismo cariñooo  !	11	
Que bueno que te sientes mejor	11	
-P-P bueno mi amor espero que ya estes mucho mejor mmm  .	10	
No estas haciendo nd malo Que bueno que ya este mejor  .	10	
Pero bueno te deseo lo mejor	10	
Pero bueno yo si tengo q madrugar así q antes de caer mejor me despido  .	10	
Que bueno que ya estés mucho mejor  .	10	
Y si lo iso a lo mejor fue para no hacerte sentir mal , bueno mira habla con el bien y dejen las cosas bien claro  .	10	
#alto,	más alto
A mi tío lo que le a afectado es en la altura , el estaba alto , claro que aún no lo alcanzó pero era más alto	2	
Pero es que algunos somos así , cuando sentimos algo de verdad estamos dispuestos a perderlo todo y ni el más alto precipicio te parecerá alto , pero para los cobardes , la más corta altura parecerá una eternidad  .	2	
De repente en una fracción de segundo grité cuando Sonic se lanzó hacia la pantalla gritando como loco , con su boca tan ancha que no era natura , desvelando una espiral al abismo de pura oscuridad antes de que volviera el rojo eterno , esta vez mucho más alto y distorsionado , con un sonido tan alto que me hacía daño en los oídos  .	1	
Jajaja si Baby Ud es mas alta que ella , su hermana Linda poquito mas alta que ud , Javier es mas alto que Linda y Marlón más alto que todosSe alocaron con las medidas xD	1	
Si eras más alto que yo pregunta boluda , cualquiera es mas alto que yo	1	
Yo lo único que se es lo que te dije y que es alto Osea todo el mundo es más alto que yo	1	
#débil,	más débil
#inteligente,	más inteligente
#fresco,	más fresco
#excelente,	más excelente
Claro mi amor con sólo verte haces que mi día sea excelente y con la carta mucho más excelente	1	
#duro,	más duro
Bueno tatis quiero decirte que eres buena amiga gracias por tus risas escandalosas por fuera de clase , me encanta tu forma de ser y pues que no te dejes de nadie Jajajaj me encanto a principios de año que le diera duro a la leidy vargas , Le hubiera dado más duro  .	1	
Es que a mi me da pesar morderal más duro , pero la voy a morder duro	1	
Esta duro y se va poner más duro	1	
y para adelante que el camino es duro , a mantener la relación que es más duro todavía y nunca se le olvide enamorarla todos los días	1	
#fácil,	más fácil
Es fácil la vida es más fácil de lo que la hacemos	1	
JAJAJAJA ande ya se ; Esque el aún tiene mucho para enseñar El merece una despedida digna Esque me caía mal el profe v Claro que no , todo será más fácil en el futuro y fácil de comprender vSi quieres llevarlos para que lo destruyan vPorque los odias  ?	1	
No se gaby a mi se me hace más fácil la de fomi que de tela No se como se haga fácil para ti gaby  .	1	
T I M I N G POEMA RÓMANTICO IMPUNTUAL Hola llegué tarde espero que me perdones el tráfico emocional está bien cabrón a estas horas no te dejan pasar y todos quieren meterse me gusta sumergirme en el amor a destiempo es fácil amar cuando sabes hacerlo cuando ya sanaste tus heridas cuando es más fácil ser feliz el amor es fácilnosotros somos los complicados	1	
gracias por llegar a mi vida , no te dejare ir tan fácil pero aquí yo te quiero mas eso que quede claro pero sinceramente es más fácil que llegue alguien a tu vida y me dejes a tras	1	
gracias por llegar a mi vida , no te dejare ir tan fácil pero aquí yo te quiero mas eso que quede claro pero sinceramente es más fácil que llegue alguien a tu vida y me dejes atras	1	
#fácil,	facilísimo
#raro,	más raro
Bastante bien , no he tenido problemas con nadie Eso es raro les caigo bien eso es aún más raro jajaja	1	
Matías está raro desde que me contó sobre la chica está mucho más raro , ahora lee , escucha mucha música , se encierra en sus cosas  .	1	
Muy osea dormí poco así que es raro pero se me hace mucho más raro porque tengo sueños pervers con Agus	1	
No amor eso es lo más raro hoy tuve un día súper raro	1	
Que raro que te guste algo así y que lo uses sería más raro , son lindos los plateadoos	1	
#raro,	rarísimo
A que raro gorda vas a tener que ir al medico porque es rarísimo eso de bajar 2 kilos en un día	1	
Eso esta raro no lo siguiente rarísimo	1	
Que eso es rarísimo en mi muuyyy raro	1	
Si , yo me viene con él , pero el man estaba super raro y cuanfobse despidió yo lo sentí rarísimo todo seco	1	
Solo pude pensar en ti y nada mas fue raro pero nose se sintió como rarísimo porque me distrajiste una banda	1	
Tuve un día rarísimo , va mi cuerpo esta raro	1	
Y me sentí bien raro , me pareció rarísimo porque no era capaz de pedirle que me mande , me bloqueaba	1	
mira angelito q es raro xo no sep sep q sonara rarísimo xo cuando lei el msj angelito me paso un escalofrio x la espalda y me empezo esa duda aunq realmente angelito no podria decirte con exactitud xq senri el esclofrio y me hizo dudar	1	
#frío,	más frío
Colada morada , es parecido a la tizana , con diferencia que es cocinada , piña , babaco como la lechoza , mora , fresas , harina morada y otrosSe toma tibio o frío , me gusta más frío , incluso he hecho helado de tets con eso jajaja	2	
No hay tanto frío , ya cuando callo la primera agua si empezo a hacer más frío	2	
Hoy hace más frío que otros días porque aún con mi cobijita y otra más gruesa tengo frío	1	
No pues está bien no te preocupes entonces éste vamos otro día cuando haga más frío porque ahorita ya está no está haciendo frío	1	
Si que hace demasiado frío , jaja me bañe con agua tibiesita y aún asi siento más frío	1	
#frío,	agudísimo
#agudo,	más agudo
#agudo,	friísimo
#caliente,	más caliente
Ya te deje caliente , no hace falta que te deje más caliente	1	
#caliente,	calientísimo
#fuerte,	más fuerte
Puedes pensar que no lo soportaré , pero estás equivocado Porque ahora soy Más fuerte que ayer Soy más fuerte  .	2	
Si alguien ha sido fuerte para derrumbarte , demuéstrale que eres mucho más fuerte para levantarte	2	
A mi me gusta que las muerdan , un poco fuerte y cuando estoy más prendida , más fuerte	1	
Ay es que tampoco nmmes como voy a pedir que te alejes de mi si tu has echo que cambie en algunas cosas nunca pediría que te alejaras de mi , Pues si me has dicho cosas fuerte que me han dolido , pero con eso me eh echo más fuerte  .	1	
Contigo Contigo mi detector de metales se arruinó sonó día y noche más fuerte que la sirena de una ambulancia más fuerte que la sirena del camión de bomberos Esta sensación es tan fuerte y tan agradable que quisiera que tú también la sientas alguna vez en tu vida Buenas noches hermosa	1	
De lo rico que lo estés sintiendo y que te duela y que grites fuerte y me digas cosas sucias y más fuerte te doy bb	1	
De nada , Tu me has echo más fuerte denlo Que era , Sólo me fsltaba ser fuerte con las oalabras de la chica que amo pero ya me has echo alguien mas fuerte  .	1	
Después te subís arriba mio y te agarró fuerte otra vez de la cintura y te hago cada vez más fuerte	1	
Dije Q me regresa el golpe igual de fuerte , nunca dije que me lo regresa más fuerte	1	
Dio otro gruñido un poco más fuerte mientras con su pata derecha pisa fuerte el suelo tenía que ser fuerte  .	1	
El dolor están fuerte k nose aguanta asta el más fuerte llora	1	
Entonces hoy quise postear está foto porque no sólo la MUJER es fuerte para tener un hijo ni para aguantar y callar las lágrimas es mucho más fuerte que eso eso capaz de levantarse cada día con una sonrisa apesar de las dificultades y dar al mundo todo ese amor que la caracteriza sólo por el sentido de ser MUJER  .	1	
Ese Dios es fuerte y más si sabes usarlo , con uno de los especiales más fuerte y ni hablar Adele	1	
Ese Dios es fuerte y más si sabes usarlo , con uno de los especiales más fuerte y ni hablar Arele	1	
Jajajja entonces si yo te la doy fuerte tu me la regresas más fuerte  ?	1	
Le decía mas fuerte xq qria q le de más fuerte no q le pegue jaja	1	
Me cacheteas mas fuerte y te cojo más fuerte  .	1	
Me marca mi tío para felicitarme hasta hoy y para decirme q habrá un temblor más fuerte q por favor nos salgamos si esta muy fuerte quería q le pasara a mi tía pero pues ya se durmio	1	
Mike lo abraza fuerte es difícil escucharte cada vez me lo gritan más fuerte	1	
No te dejaré de lado mi amor , aún cuando hayamos tenido una fuerte pelea , hay algo mucho más fuerte	1	
Oye tranquilo , se qué eres fuerte no caigas ante los demás demuestrales qué eres más fuerte de lo qué ellos creen	1	
Pero así sea muy difícil y la corriente sea fuerte tú debes ser más fuerte y vencer todo	1	
Pero eso también demuestra que a pesar de todo , tú sigues de pie , eres fuerte y eso te hizo aún más fuerte	1	
Pero tu eres mas fuerte que eso , mucho más fuerte  !	1	
Pues si ella paso por esa situación fuerte la hizo mucho más fuerte es bien linda	1	
Si tu eres fuerte yo tengo que ser aún más fuerte , personas hay muchas pero como tu ninguna	1	
Tengo un óxido a la mitad , es como un quemador pero poco más fuerte , al chile no está tan fuerte , lo quieres  ?	1	
Tienes un corazón sp fuerte y tienes la responsabilidad y eso Te ase más fuerte	1	
Tú eres muy linda , y te mereces lo mejor del mundo , tienes que estar súper fuerte te demostrar que eres más fuerte que cualquier otra cosa	1	
Y si te bloquie xq quería olvidarte pero lo q siento es mas fuerte y kda día ea peor y más fuerte Mi Amor x vos	1	
cada oración , cada palabra y cada letra escrita por ti hacen que me sienta dichosa en toda la extensión de la palabra , ya no se como expresar lo que me haces sentir , es demasiado fuerte lo que siento , como alguna vez te dije es más fuerte que la palabra AMOR  !	1	
empiezo a gemir un poco más fuerte mientras me sigo aferrando fuerte a las sabanas y muevo mi cola un poco	1	
la abraza mas fuerte y le empieza a morder más fuerte el labio	1	
#fuerte,	fuertísimo
#extraño,	más extraño
-Sabes , hace un año me encantaba que llegara el fin de semana porque así ya todos alv , pero ahora , ya no me gusta que llegue , porque aunque sean solo dos días , te extraño bastante , eres a quien más extraño en el fin-	1	
Bueno lo que ahoritaa extraño son tus ojos tu boquita tu sonrisa y más extraño escuchar tu hermosa voz	1	
Feliz cumpleaños a mi personita importante que ya no esta ak yo se que el esta en un lugar mejor pero lo que nadie sabe es que yo lo extraño mucho y cada día más extraño cuando nos pelea	1	
Pero sin duda lo que más extraño de crm es a ustedes Las extraño cecom	1	
Te quiero muchísimo Sara , extraño rolear contigo , hablar seguido y todo , pero más extraño poder hacerte reír aunque sea poquito  .	1	
Yo te extraño en cuerpo y alma pero lo que más extraño es cuando me abrazas cuando estamos acostados o dormidos hechos bolita	1	
y yo tan extraño y ahí fue cuando dijiste todo y era más extraño aún  .	1	
#extraño,	extrañísimo
#bajo,	más bajo
#bajo,	bajísimo
Yo tengo un autoestima bajísimo pero no le bajo el autoestima a los demás para yo sentirme mejor como lo haces vos	1	
#amplio,	más amplio
#amplio,	amplísimo
#pequeño,	más pequeño
Comunitario No ma regresé ahi Hace una semana y me senti más pequeño , no le acordaba que las porterias fueran grandes y me senti pequeño	1	
Si por que esta estirado pero realmente es muy pequeño como el tamaño de un diente normal eso si un poco más pequeño pero esa es mas o menos la medida	1	
#pequeño,	frescísimo
#fresco,	más fresco
#fresco,	friísimo
#excelente,	más excelente
Claro mi amor con sólo verte haces que mi día sea excelente y con la carta mucho más excelente	1	
#excelente,	excelentísimo
#caliente,	más caliente
Ya te deje caliente , no hace falta que te deje más caliente	1	
#caliente,	calientísimo
#largo,	más largo
A ver que tal trate de no hacerlo tan largo en mi cabeza era algo más largo para explicar todo pero mejor así para no aburrir a los niños	1	
Es lo más normal del mundo sabes , es un largo proceso y lo harás más largo si no te propones salir de esto	1	
Pero hay uno más largo que me gusto más pero no lo puedo enviar dice que es muy largo	1	
Si podes el q tenga el cable más largo o sino de esos q van con usb y un cable largo	1	
Y ahorita de largo lo traigo como a media espalda o poquito más largo	1	
en las fotos se me ve el pelo largo , pero atrás lo tengo más largo	1	
lo he tenido más largo que ahora , pero lo tengo largo	1	
#largo,	larguísimo
Culiao es larguísimo ese parcial va Hacer , imaginate si el de ustdes fue largo imaginate el mio y con vos tengo la  .	1	
Culiao mira le hablo enserio , yo no se si ustdes me joder o no va de lio mucho no puedo decir por q recien nos conocemos pero el otro culiao se va al pingo sabe q me cuesta esta materia chota no es q no me animo a rendirla libre es al pedo por q la clavada q me van a pegar ya la conozco es larguísimo ese parcial libre me lo imagino y debe ser re largo	1	
Muy larguísimo Parte del 2018 , parte por un largo tiempo	1	
io pensé que estaría mas largo pero buenooo no se creo que no es necesario que te escriba algo larguísimo para que sepas que te amo	1	
#débil,	más débil
#débil,	debilísimo
#simple,	más simple
Lo haré más simple yo todo pero simple	1	
#simple,	simplísimo
#inteligente,	más inteligente
#inteligente,	inteligentísimo
#alto,	más alto
A mi tío lo que le a afectado es en la altura , el estaba alto , claro que aún no lo alcanzó pero era más alto	2	
Pero es que algunos somos así , cuando sentimos algo de verdad estamos dispuestos a perderlo todo y ni el más alto precipicio te parecerá alto , pero para los cobardes , la más corta altura parecerá una eternidad  .	2	
De repente en una fracción de segundo grité cuando Sonic se lanzó hacia la pantalla gritando como loco , con su boca tan ancha que no era natura , desvelando una espiral al abismo de pura oscuridad antes de que volviera el rojo eterno , esta vez mucho más alto y distorsionado , con un sonido tan alto que me hacía daño en los oídos  .	1	
Jajaja si Baby Ud es mas alta que ella , su hermana Linda poquito mas alta que ud , Javier es mas alto que Linda y Marlón más alto que todosSe alocaron con las medidas xD	1	
Si eras más alto que yo pregunta boluda , cualquiera es mas alto que yo	1	
Yo lo único que se es lo que te dije y que es alto Osea todo el mundo es más alto que yo	1	
#alto,	altísimo
Jajajajaja que yo soy el mas alto wey , tampoco digo que uuuu altísimo tampoco wey pero si wey soy el altillo del todos los weyes de qui	1	
Si bld tenés alto td , alta cara , muy divertida y altísimo cuerpo	1	
Sii altísimo todo mundo es mas alto que yo	1	
#alto,	más alto
A mi tío lo que le a afectado es en la altura , el estaba alto , claro que aún no lo alcanzó pero era más alto	2	
Pero es que algunos somos así , cuando sentimos algo de verdad estamos dispuestos a perderlo todo y ni el más alto precipicio te parecerá alto , pero para los cobardes , la más corta altura parecerá una eternidad  .	2	
De repente en una fracción de segundo grité cuando Sonic se lanzó hacia la pantalla gritando como loco , con su boca tan ancha que no era natura , desvelando una espiral al abismo de pura oscuridad antes de que volviera el rojo eterno , esta vez mucho más alto y distorsionado , con un sonido tan alto que me hacía daño en los oídos  .	1	
Jajaja si Baby Ud es mas alta que ella , su hermana Linda poquito mas alta que ud , Javier es mas alto que Linda y Marlón más alto que todosSe alocaron con las medidas xD	1	
Si eras más alto que yo pregunta boluda , cualquiera es mas alto que yo	1	
Yo lo único que se es lo que te dije y que es alto Osea todo el mundo es más alto que yo	1	
#alto,	altísimo
Jajajajaja que yo soy el mas alto wey , tampoco digo que uuuu altísimo tampoco wey pero si wey soy el altillo del todos los weyes de qui	1	
Si bld tenés alto td , alta cara , muy divertida y altísimo cuerpo	1	
Sii altísimo todo mundo es mas alto que yo	1	
#rico,	más rico
A de ser rico , para los dos , pero más rico sera terminar en tu boca	1	
Ay yo también amor , qué rico cuando me lo metes , se siente estrecho más rico	1	
Como la imagen muy rico y todo pero David me lo hace más rico	1	
Creo q quisiste decir que si es rico ASÍ Cuando estemos juntos será más rico	1	
Jajajajajaja después me dijiste me siento mal pero estaba tan rico jajaja y si lo dejas unos dias en la heladera más rico se pone xq se consentra jaja	1	
Me gusta rico X q uno siente más rico	1	
Mmm Que rico Que uviece sido más rico bañarnos juntos	1	
No mi amor créeme que no hay nada más rico en este mundo que probar tus jugosos labios mmmmm rico	1	
Pero rico , ahí se acumulan las ganitas y más rico verlo	1	
Pro ta rico amor , pro si lo harías vos sería más rico	1	
Pues la neta esta riquísima y me hace sentir super rico y bien dura más rico	1	
Pues sera lento para que sea más rico pero contigo como sea es rico Ya me prendiste mi amor	1	
Que dico cuando me nalgueas , y truena Se escucha bien rico & se siente aún más rico	1	
Sabes que si mi bebé hermoso Yo voy mi amor TE NECESITO MI AMOOOOOR Ay diooooos Que rico se ve me encanta es lo más rico del mundo	1	
Sabes que si mi bebé hermoso Yo voy mi amor TE NECESITO MI AMOOOOOR Ay diooooos Que rico se ve me encanta es lo más rico del mundo Ya esta me pusiste caliente mi amoooor	1	
Sabes que si mi bebé hermoso Yo voy mi amor TE NECESITO MI AMOOOOOR Ay diooooos Que rico se ve me encanta es lo más rico del mundo Ya esta me pusiste caliente mi amoooor Que ricooooooo	1	
Si bonita , si me gusta sabe muy rico aunque en algunos lugares esta más rico que en otros	1	
Si esta muy rico dormir pensando en ti y más rico dormir pensando en ti con musiquita	1	
Si te dolió pero rico amor Noma entonces la tenia mas grande y lo hice más rico que los putos esos flakaNena tengo algo en mente	1	
Sii qe no era muy rico es más el más rico que probe	1	
Ujule eso si amor a veces no esta rico el flanPues aca por mi casa he probado el pastel más rico del mundo pero quien sabe si aun lo vendan , aunque si investigaré cariño	1	
ay si baby para que se sienta más rico Ay bbe que rico sentir tu mano ahí & luego más si traigo vestido	1	
#rico,	riquísimo
Entera pa mi amor si amor van a pasar rápido , o eso espero jaja , si amor me encanta tocarla cuando esta así mojadita es muuuy rico igual que meterselo así si me imagino amor riquísimo y que lo hagas encima mío aún mad si hacelo amor y se graban ah , por lo que estabamos hablando anoche amor si amor súper dura se puso , si amor besense y todo ya que ella también quiere , di amor para el viernes lo pasas  ?	4	
Tomarte del cabello mientras me haces un oral besar todo tu cuerpo , hacer un oral agarrarte bien rico por atras tus pompis y de frente Lo haces delicioso bebe riquísimo	3	
Tomarte del cabello mientras me haces un oral besar todo tu cuerpo , hacer un oral agarrarte bien rico por atras tus pompis y de frente Lo haces delicioso bebe riquísimo Yo no se nada amor menos expertos pero vamos descubriendo juntos todo	3	
que bella que esta te felicito hermoso te quedo todo me imagino la comida mmm rico si uatedes cosinan riquísimo  .	3	
Entera pa mi amor si amor van a pasar rápido , o eso espero jaja , si amor me encanta tocarla cuando esta así mojadita es muuuy rico igual que meterselo así si me imagino amor riquísimo y que lo hagas encima mío aún mad si hacelo amor y se graban ah , por lo que estabamos hablando anoche amor si amor súper dura se puso	2	
Que rico amor , esta riquísimo , vos también me tenés re caliente , cuando viajas amor , TE AMO	2	
Se ve rico y de gusto esta riquísimo	2	
Amor acabe de almorzar y todo quedó riquísimo gracias a ti amor , muy rico todo , la carne quedó sabroso , besos	1	
Aparte me encanta oler rico y el que me compre es riquísimo me dura todo el día y dejo perfume por doquier	1	
Besas riquísimo ya se me había olvidado lo rico que era besarte	1	
Bueno amor sabes amor cuando me lo metes amor es algo rico amor un dolor riquísimo q me hace estremeser	1	
Bueno pintó ese rico chupin que siempre me sale riquísimo cuak	1	
Bueno si mi amor eres bn golosa eso me encanta si mi cielo por la gente no pudimos morbosearnos un ratito esas ricas piernas q tienes mi vida todo lo tienes muy bueno q para hacer el amor es riquísimo me lo haces muy bn rico	1	
Comiendo un rico arrollado q me trajo mi hija Paola riquísimo esta	1	
Cuando Román era bb yo compraba un endulzante q era tipo miel peroas rico , de Nestle , ahora no esta mas , era riquísimo  !	1	
Cuanto extrañaba que fueras así Pues si amor me haces dar ganas uffffff rico es poco lo haces riquísimo no se me encanta	1	
Dale aMor descansa algo y también q rico lo tuyo seguramente riquísimo estuvo x	1	
Dale aMor descansa algo y también q rico lo tuyo seguramente riquísimo x aca esta re pesado el día todo nublado y mucha humedad	1	
Dale ya las quiero escuchar y contestartelas si bebe mas que nunca ahora , yo tampoco voy a soltarte en todo el día bebe , su vamos a dormir amor bueno bien bebe yo había ido a comer , perdón , uhhh que rico bebe , yo comí churrasco y estaba riquísimo bebe , vos lo sos siempre mi hermosa	1	
Debes estar riquísimo si todo lo que cocinas es rico delishiam	1	
Dormi riquísimo en serio , cai rendida anoche y descanse rico rico  .	1	
Enserio mi vida que riquísimo tu muy bien mi vida rico que almorzaste amor	1	
Entera pa mi amor si amor van a pasar rápido , o eso espero jaja , si amor me encanta tocarla cuando esta así mojadita es muuuy rico igual que meterselo así si me imagino amor riquísimo y que lo hagas encima mío aún mad	1	
Entera pa mi amor si amor van a pasar rápido , o eso espero jaja , si amor me encanta tocarla cuando esta así mojadita es muuuy rico igual que meterselo así si me imagino amor riquísimo y que lo hagas encima mío aún mad si hacelo amor y se graban ah	1	
Entera pa mi amor si amor van a pasar rápido , o eso espero jaja , si amor me encanta tocarla cuando esta así mojadita es muuuy rico igual que meterselo así si me imagino amor riquísimo y que lo hagas encima mío aún mad si hacelo amor y se graban ah , por lo que estabamos hablando anoche amor	1	
Entera pa mi amor si amor van a pasar rápido , o eso espero jaja , si amor me encanta tocarla cuando esta así mojadita es muuuy rico igual que meterselo así si me imagino amor riquísimo y que lo hagas encima mío aún mad si hacelo amor y se graban ah , por lo que estabamos hablando anoche amor si amor súper dura se puso , si amor besense y todo ya que ella también qiere	1	
Entera pa mi amor si amor van a pasar rápido , o eso espero jaja , si amor me encanta tocarla cuando esta así mojadita es muuuy rico igual que meterselo así si me imagino amor riquísimo y que lo hagas encima mío aún mad si hacelo amor y se graban ah , por lo que estabamos hablando anoche amor si amor súper dura se puso , si amor besense y todo ya que ella también quiere	1	
Es que ayer compre un queso bien rico y cuando llegue mi suegra compro un chorizo riquísimo	1	
Esta rico el día y te me antojas , un mañanero estaría riquísimo	1	
Estaba riquísimo ja no comi mucho x que estaba llena pero estaba rico	1	
Feliz tarde amor , y buen provecho , todo estaba miu rico , gracias a ti , riquísimo todo amor besos y cuidate mucho	1	
Feliz tarde amor y buen provecho un besito , ah te diré que @cabe d almorzar ahora y gracias x wse almuerzo , estaba riquísimo x dios , muy rico besos	1	
Hace tan rico el amor , y besa riquísimo	1	
Hasta mañanita bb que descanses duerme riquísimo descansan y duerme rico te amo mucho	1	
K rico video amor estas riquísimo bb	1	
Me agarrabas de el pelo bien rico y asii pero netaaaaa perdoname pir rasguñarte porque neta se sentia riquísimo deli delii	1	
Menos rico que tu estas riquísimo	1	
Mm que rico , como me voy a reír si es riquísimo los fideos	1	
Mmm q rico yo ayer hize tambien hace rato q no hacia eataba riquísimo	1	
Oooo que rico Jeje mira que si te preparo algo riquísimo eeee	1	
Ooooooow si mi amor que rico mueves ese culito sigue sigue no pares siento riquísimo	1	
Que rico a mi me salio riquísimo el tallarín por que no tenia pure de tomate y el jugo de la carne mesclado con las verduras y apenitas condimento salio riquisimo	1	
Que rico amor y le pusiste vino a la carne asi sale riquísimo	1	
Que rico con pulpa de ananá y hielito picado queda riquísimo	1	
Que rico pues te saldra riquísimo  .	1	
Que rico seria coger con tigo lo has de hacer riquísimo un saludo cariño	1	
Que rico tenerlo metido en mi vagina seria riquísimo	1	
Si amor estaba bien riquísimo ami mama le quedo mas rico que ami	1	
Si el pescado es rico el primer día que vinimos Jaime hiso ala parrilla riquísimo le salio	1	
Si mi vida va hacer riquísimo besarte chuparte tocarte acariciarte comerte toda bien rico	1	
#joven,	más joven
#joven,	jovenísimo
#mal,	peor
Dime lo que hice mal , te pusieron en contra de mi pero es peor pedir perdon que perdonar Se murio una flor y cambio de color , tu eras mi diabla y yo te daba calor  .	25	
Odio que estés así nena me rre aleje de vos me arrepiento una banda negra saber que estas mal y no te voy a ver me pone peor ami yase no te hablo ni nada pero me ases una rre falta amor  .	16	
Xfavor ya no puedo soportar seguir así me siento muy mal , estoy destrozado y cada día q pasa me siento peor y x lo mas sagrado yo ya no puedo soportarlo mas , no soy tan valiente , se que si hablamos nos sentiremos mejor x q aclararemos muchas dudas , ya q si no esto nos perseguira x siempre , lo peor es seguir viviendo en esta incertidumbre y con esta duda  .	12	
logro hacerte sentir mal logró a ser que tu mejor día se vuelva el peor de todos los dias no te culpo  .	10	
Esta es la peor de las tiendas para mandar hacer un vestido , quedan mal mandan hacer un vestido que uno no pide y lo pides con tiempo y nunca llega esperan que uno los considere , las empleadas son groseras y sangronas , el dueño es un cretino y grosero de lo peor  .	7	
Sos unas gran mujer y una gran señorita yo nose lo que te anda pasando capas vos ya no contas con migo y te SUPER ENTIENDO pero sabelo por mas que estamos en el peor momento vas hacer todo para mi y si vos estas mal yo me pongo mal tambien  .	7	
Contigo estoy mal pero sin ti estoy peor  .	6	
Si los que hablan mal de mí supieran exactamente lo que yo pienso de ellos , hablarían peor  .	6	
Contigo estoy mal pero sin ti estoy peor lo bueno y malo en mi vida  .	5	
La verdad me acostumbre muchísimo ah vos y te extraño un montón yo se que ise muchísimo daño de corazón te pido perdón desde ese último viernes tw juro que no puedo estar bien es muy difícil yo solo necesito poder Hablar con vos y estar un ratito bien te juro que nunca estuve tan mal asi todos los dias con una lágrima y cada ves peor  !	5	
Lo peor es que ni trato mal , pero así es la vida  .	5	
Me caes re mal puta gorda tonta y peor la taradita que se hace la putita de Mimi reinoso esa tonta con la que te estas juntaste que se la súper come  .	5	
Nada , solo me siento mal estoy enferma y poco a poco peor Sii Itsugo Jeje ay no se que decir Bueno eh bebé Es que fue de la nada que cuando lo leí me puse nerviosa	5	
Que es peor que un hombre hable mal de una mujer o que ella vuelva con el	5	
Y si lo haces cuando hasta mal me siento es peor yo creo que eres muy desconsiderado con migo , y si no quieres cambiar eso entonces que  .	5	
Bueno ayer se lo contaron a marcos y corte se pudrió todo x Alla salieron con q soy puta y eso y lo peor es que ya fue todo con Mi negrito y estoy rre mal negra marcos ayer me dijo x msj que hable con la mama de el para arreilar las cosss pero hoy le mande msj ala mama y me mando ala mierda todo junto  !	4	
Es que ah soy la peor persona y la peor novia te puse mal te puse mal y eso no estuvo bien ah perdón me siento de lo peor lastime a Itsugo y dije que no lo haría	4	
Jajajajajajajaja pues si entra una nueva que le cae mal ja , que miedo esas miradas , y lo peor es que dice que no mira feo , con si lo hace	4	
Me sucedieron cosas malas y estuve triste , en el recreo pensé que te quedarías y quería estar contigo pero no , te fuiste , también te se notar que no me sabias tomar mucha importancia y quería acercarme pero no pude , en el curso me fue mal terrible pesimo fue lo peor y estuve triste , te preocupaste , los demas me trataron de hacer sentir mejor y quería estarlo pero ser por ti  .	4	
Nada , solo me siento mal estoy enferma y poco a poco peor Sii Itsugo Jeje ay no se que decir Bueno eh bebé	4	
No como me va a caer bien osea todavía que le digo las cosas bien el morro meco no me contesta y yo aaah no ma si ahora me caes mal ahora me caes peor ya sabes que soy bien mamona Alch tu y punto No no tu tu y ya ahora si no se habla más del tema	4	
No puedo seguir asi , tuve la oportunidad de matar a Liora y no lo hice Me siento muy mal y sabes que es lo peor que ni siquiera me ha dicho terminamos y se me hace dificil todo bien lo siento	4	
Nose si estoy bien o mal solo que sigo igual o peor que ayer  !	4	
Nosotras las mujeres perdonamos siempre aun que nos mientan , nos fallen , nos traicionen nos engañen , pero si hacemos algo mal para ellos ya somos la peor persona del mundo  .	4	
O no se según los mensajes que lee eres su amor pero eso no me importa si solo te digo una cosa ami nadie me trata de cabrona sobre todo ningún mal marido me levanta la voz yo soy peor te puedo hacer la vida imposible	4	
Si yo tambien pienso que se enojo pero trato de no expresarlo Ja ja ja ja ya se Y lo peor que pagamos todos por alguien que hizo las cosas mal	4	
Trato de no ponerme mal pero no puedo cada vez es peor para mi  .	4	
Tu no quieres saber na de mi , dime que fue lo que yo hice mal te pusieron en contra de mi pero es peor pedir perdón que perdonar	4	
Y pues lo que si te dire esque vino Andres y pues tenia mucho dolor de cabeza y mal humor y pues me sentía débil nose algo tensa y pues con lo mal ke me fue aun con eso peor ya te imaginaras	4	
Y si crees qué en el olvido se anestesia un mal de amor , ni hay peor remedió qué la soledad  .	4	
Ya empecé mal el día Y se va a poner peor  .	4	
en estos momentos eres la peor persona que conozco y no lo digo de mal es de biem sabes nunca me había dolido tanto q me engañaran pero bueno ya que ojala nunca volverte a ver en mi vida todo mi enojo en una carita	4	
eso si me pone peor Cuando te trato mal  ?	4	
por queeeeee me queren joder la puta vidaaaaa mi corazón ya no agunta más basuraaaaaaaaaaaaaaaaaaaaaaaaaaaa dices que soy de lo , peor para ud OK gracias por hacer me sentir tan mal señor  .	4	
24- tratame mal y te trato peor	3	
Ay amor enserio me siento tan mal me siento lo peor amor	3	
Ay eso si es muy especial pero no te sientas mal por ello a mi igual me paso y peor una ocasio	3	
Ay eso si es muy especial pero no te sientas mal por ello a mi igual me paso y peor una ocasión se me pasaron unas manzanas desde puta un chingo	3	
Ay eso si es muy especial pero no te sientas mal por ello a mi igual me paso y peor una ocasión se me pasaron unas manzanas desde puta un chingo ya tenían mo las chingaderas	3	
Con tigo estoy mal pero sin ti estoy peor	3	
Cuando pregunten por mo decirles que estoy re mal , cada vez peor  .	3	
Es que ah soy la peor persona y la peor novia te puse mal te puse mal	3	
Es que ah soy la peor persona y la peor novia te puse mal te puse mal y eso no estuvo bien	3	
Es que ah soy la peor persona y la peor novia te puse mal te puse mal y eso no estuvo bien ah perdón me siento de lo peor	3	
Es que ah soy la peor persona y la peor novia te puse mal te puse mal y eso no estuvo bien ah perdón me siento de lo peor lastime a Itsugo	3	
Es que peor va ser que forcemos y nos salga mal	3	
Estaba mal Y no me iba a aser Nda pero ella me iso poner peor todavia las ganas de llorar no se aguantan	3	
Hice mil cosas bien y nadie me dijo nada , hice una cosa mal y soy la peor persona del mundo  .	3	
Lamento el mal día quería q mejor y siempre termina peor	3	
Lamento el mal día quería q mejor y siempre termina peor pero por lo menos lo intente	3	
#mal,	malísimo/pésimo
#rápido,	más rápido
Porque lo metias rápido y todo y luego más rápido	2	
Bueno , al menos eso es lo que tú haces , yo trato de contestar los más rápido que puedo , pero entiendo que tú no contestas rápido porque tienes más ocupaciones que yo	1	
Condujo rápido , adelantando algunos coches , centrado en lo que hacía para llegar más rápido  .	1	
La vida es como un churro entre más rápido le jales mas rápido se acaba xdxd	1	
Lo hago más rápido , lo meto un poquito y sacó muchas veces y rápido	1	
No es que perdóname amor de verdad te pongo toda la atención del mundo horita estaba viendo la película esa que me dejaron de tarea y mientras te contestaba a ti y como te dije a mi no me importa lo que éste haciedo yo voy y contesto tu mensaje lo más rápido que puede después me lo contestas y yo te lo contesto rápido baby	1	
O matala lo más rápido que puedas para que acabe el dolor rápido 'v	1	
Ojalá encuentre rápido a otra así solo ocupamos menos días y empezar más rápido y con mas tiempo em buscar y seguir con nuestros planes	1	
Pero quisiera terminar rápido me quiero presentar al ejército lo más rápido	1	
Porque Nacho va rápido y lo quiero alcanzar por lo que voy más rápido , y él también y al final termino sin aire	1	
Pues si , es algo más rápido , me sorprendi al llegar aquí bien rápido , nunca me imagine que hubiera calpus ahi en la tapo	1	
Sip , así más rápido , en camión también es rápido pero el otro si se pasó de v  .	1	
Subaru llega a donde esta ella con un carro del cual se baja rápido y la toma para después meterla al auto y arrancar lo más rápido posible dejando la marca negra de las llantas Me la quedo Bv	1	
Te creo que me extrañas Y aunque los días se pasan rápido , y llega rápido sábado , el fin de semana se pasa aun más rápido y te extraño en cuanto te vas por que hemos estado todo el tiempo juntos y si pienso en eso , sería aun mas triste cada q te despides	1	
Y a veces no respondo los mensajes por hacer tarea o estar con música para terminar rápido y poder hablar contigo respondiendo lo más rápido que pueda v	1	
Ya veras mi niña que se pasara rápido el tiempo y que estaremos juntos más rápido	1	
y lgo soy labque más rápido escribe en la láp y me pusieron a hscer lgo que querían rápido y me regañan que ahora ando bien lenta y que si no lo quería hacer hubiera dichi que no	1	
Íbamos a cadorna y un pibe estaba en la esquina de camino y se hacia el de hablar cuando nosotras pasamos se puso para mi lado y empezó a caminar rápido hacia nosotras rápido nos dimos cuenta y caminamos más rápido y nos juntamos con otra gente pero ya estaba cerca	1	
Íbamos a cadorna y un pibe estaba en la esquina de camino y se hacia el de hablar cuando nosotras pasamos se puso para mi lado y empezó a caminar rápido hacia nosotras rápido nos dimos cuenta y caminamos más rápido y nos juntamos con otra gente pero ya estaba cerca se dio la vuelta y volvió donde estaba haciéndose el boludo y nos miraba	1	
#rápido,	rapidísimo
Gordita estoy super orgulloza de vos enserio quien se lo iba a imaginar vea súper rápido ya vas para décimo Por eso rapidísimo se me fue este año y según yo por estar en la casa me iba a rendir y no ve lo disfrute bastantico	1	
Jajajajajajajaj es que si , lpm Bueno me pasa siempre con mi vieja , mama compra terreno en todas partes me hace llorar de la risa , no sabes cuantas veces voy muy tranquila caminando , casi siempre adelante de ella porque mama camina rapidísimo , mira que yo camino rápido , pero ella me supera , entonces antes de andar corriendo y tras que no me dan las patas voy a delante y en eso iba yo hablando muy alegre , ahr , y cuando me di vuelta mama desapareció de mi vista	1	
Pues si te vienes rápido también te puedes poner caliente rapidísimo Jajajajajajaja no ;	1	
#viejo,	más viejo
Cuando te conosi pensé que eras normal jejé pero no y te quiero desear un feliz cumpleaños niño hoy eres un año más viejo y como dice algo tu eres como los vinos entre mas viejo mas bueno  .	1	
Jajajajaj eso es más viejo que el ron viejo de caldas	1	
#viejo,	viejísimo
#rápido,	más rápido
Porque lo metias rápido y todo y luego más rápido	2	
Bueno , al menos eso es lo que tú haces , yo trato de contestar los más rápido que puedo , pero entiendo que tú no contestas rápido porque tienes más ocupaciones que yo	1	
Condujo rápido , adelantando algunos coches , centrado en lo que hacía para llegar más rápido  .	1	
La vida es como un churro entre más rápido le jales mas rápido se acaba xdxd	1	
Lo hago más rápido , lo meto un poquito y sacó muchas veces y rápido	1	
No es que perdóname amor de verdad te pongo toda la atención del mundo horita estaba viendo la película esa que me dejaron de tarea y mientras te contestaba a ti y como te dije a mi no me importa lo que éste haciedo yo voy y contesto tu mensaje lo más rápido que puede después me lo contestas y yo te lo contesto rápido baby	1	
O matala lo más rápido que puedas para que acabe el dolor rápido 'v	1	
Ojalá encuentre rápido a otra así solo ocupamos menos días y empezar más rápido y con mas tiempo em buscar y seguir con nuestros planes	1	
Pero quisiera terminar rápido me quiero presentar al ejército lo más rápido	1	
Porque Nacho va rápido y lo quiero alcanzar por lo que voy más rápido , y él también y al final termino sin aire	1	
Pues si , es algo más rápido , me sorprendi al llegar aquí bien rápido , nunca me imagine que hubiera calpus ahi en la tapo	1	
Sip , así más rápido , en camión también es rápido pero el otro si se pasó de v  .	1	
Subaru llega a donde esta ella con un carro del cual se baja rápido y la toma para después meterla al auto y arrancar lo más rápido posible dejando la marca negra de las llantas Me la quedo Bv	1	
Te creo que me extrañas Y aunque los días se pasan rápido , y llega rápido sábado , el fin de semana se pasa aun más rápido y te extraño en cuanto te vas por que hemos estado todo el tiempo juntos y si pienso en eso , sería aun mas triste cada q te despides	1	
Y a veces no respondo los mensajes por hacer tarea o estar con música para terminar rápido y poder hablar contigo respondiendo lo más rápido que pueda v	1	
Ya veras mi niña que se pasara rápido el tiempo y que estaremos juntos más rápido	1	
y lgo soy labque más rápido escribe en la láp y me pusieron a hscer lgo que querían rápido y me regañan que ahora ando bien lenta y que si no lo quería hacer hubiera dichi que no	1	
Íbamos a cadorna y un pibe estaba en la esquina de camino y se hacia el de hablar cuando nosotras pasamos se puso para mi lado y empezó a caminar rápido hacia nosotras rápido nos dimos cuenta y caminamos más rápido y nos juntamos con otra gente pero ya estaba cerca	1	
Íbamos a cadorna y un pibe estaba en la esquina de camino y se hacia el de hablar cuando nosotras pasamos se puso para mi lado y empezó a caminar rápido hacia nosotras rápido nos dimos cuenta y caminamos más rápido y nos juntamos con otra gente pero ya estaba cerca se dio la vuelta y volvió donde estaba haciéndose el boludo y nos miraba	1	
#rápido,	rapidísimo
Gordita estoy super orgulloza de vos enserio quien se lo iba a imaginar vea súper rápido ya vas para décimo Por eso rapidísimo se me fue este año y según yo por estar en la casa me iba a rendir y no ve lo disfrute bastantico	1	
Jajajajajajajaj es que si , lpm Bueno me pasa siempre con mi vieja , mama compra terreno en todas partes me hace llorar de la risa , no sabes cuantas veces voy muy tranquila caminando , casi siempre adelante de ella porque mama camina rapidísimo , mira que yo camino rápido , pero ella me supera , entonces antes de andar corriendo y tras que no me dan las patas voy a delante y en eso iba yo hablando muy alegre , ahr , y cuando me di vuelta mama desapareció de mi vista	1	
Pues si te vienes rápido también te puedes poner caliente rapidísimo Jajajajajajaja no ;	1	
#brillante,	más brillante
#brillante,	brillantísimo
#grande,	más grande
Le queda grande la palabra padre y aún más grande la palabra HOMBRE	3	
Acabo de adoptar este gato con mi novio , el tiene un gato más grande que tiene 5 años , copito el gato grande esta acostumbrado a vivir solo ,	2	
La más grande 500 y la otra 300 vendo ya si son de Monte grande la llevo	2	
Acabo de adoptar este gato con mi novio , el tiene un gato más grande que tiene 5 años , copito el gato grande esta acostumbrado a vivir solo , y no le gusta que lo alcen , y a veces es arisco  .	1	
AjajajaSi mi pareja es más grande que tu Y No me es tan grande  !	1	
Claro amor yo confío en ti y en todo el amor nuestro amor es mas grande que nada es más grande que la autoridad de la directora quee no hicimos caso porque nos amamos si asi te aferras ala vida juntos se ara verdad amor	1	
De estas almas tan dulces y puras se aprende más que en cualquier facultad Ellos superaron lo que cualquier grande no podría , se merecen la felicidad más grande del mundo  .	1	
Detente y respira profundamente y recuerda que ningún problema es más grande que tú , tu eres mas grande que el  .	1	
El mas grande sigue siendo River plate y será más grande aun en el mañana	1	
El mas grande sigue siendo River plate y será más grande aun en el mañana por el juego por las ganas y el orgullo de tener una vanda r	1	
El mas grande sigue siendo River plate y será más grande aun en el mañana por el juego por las ganas y el orgullo de tener una vanda roja que nos cruza el alma	1	
El pez chico se come al más grande ósea Daniel es el grande y Juan es el chico	1	
Encima no es tan grande la oanza que tengo si hubiese sido más grande nose jajaj	1	
Es lo más grande que puede haber en el mundo más grande que el mar y mas grande que la vida	1	
Es que tengo dos suéteres y no es más grande que el otro y a veces me pongo la grande y por eso no se me notan  .	1	
Ese tarro no es ni grande jajaja a lo bien , yo lo imaginé más grande y nooojjj 80mil y eso no es nada , y tras de eso viene medio vacío es como las papás fritas	1	
Hay pues mi amor por ti es más grande qué tu amor por mi que es mas grande qué mi amor por ti que supera la face dios	1	
Hay si cuando estés más grande ya vengas mas buenote y tengas una cosota mas grande y rica	1	
Hay un oso En Pablo nogues No es muy grande pero mediano es más grande qe lo qe me diste	1	
Hoy en su primer día de clases mi princesa más grande 4to grado y mi princesa más chica 1er grado que grande estan  .	1	
K-bufa y va a jugar-Y mi ropa es más grande que tú , mi pequeño chico grande	1	
La mia es más grande , me ocupa todo el culo , ahre mentira pero posta es demasiado grande	1	
La más grande 500 y la otra 300 vendo ya si son de Monte grande la llevo o si	1	
M lo hizo un poquito más grande xq era muy grande lo q tenia	1	
No amenazaba estoy planeando algo muy grande ese va a ser el hecho más grande K puedes ver	1	
No había grande por eso no te compre más grande	1	
No sentí lo mismo Sentí algo mucho más grande sentí un amor inmenso algo grande te amo	1	
Obvio que Dios es grande , es lo más grande y lo más hermoso que existe en nuestras vidas y en las de cualquiera	1	
Ooowww si que ya esta grande y la chiquita Es hija de la más grande  ?	1	
Parece mas grande y no tiene mente de niña ls tiene de más grande	1	
Pero era jóven y me estaba entregando a algo mas grande , ahora eso más grande se a ido  .	1	
Podrias utilizar una vaporera grande , o por lo menos tres veces más grande que el pastel  .	1	
Por que me hacia grande y a la vez Lulú me hacia más grande xD	1	
Pues si Esperanza es lo más grande que tengo un beso grande guapa	1	
Pues tampoco la escuela que voy no está tan grande yo veo la secundaria más grande	1	
Que si el ángulo es mas pequeño era la medida pequeña y si el ángulo es grande es la medida más grande	1	
Sabes que mi amor por ti es muy grande y el que me digas estas cosas lo hacen aún más grande	1	
Se reía porque me dijo te llevaste el más grande que habia era obvio que te iba a grande jejje	1	
Si de hecho esta bonito el lugar un día te invitaré a la fiedta grande de mi pueblo jeje Por que igual es un pueblo pero aún más grande jeje y me encanta estar aquí	1	
Te amo demasiado Mi amor por ti es tan grande como el universo ya que no tiene fin y cada vez se hace más grande	1	
Te haces la mala sólo xq sos mas grande que yo Xq no te metes con una de tu edad o más grande  ?	1	
Todas Me hacen la misma pregunta y es complicado imagínate que al pedir un talle más grande de lo normal quizás les quedan muy grande	1	
Tu mi amor mas grande nuestro amor el más grande del Mundo Te Amo	1	
Uff Yali que HERMOSURA Ya se ne hizo grande Bueno ud es más grande que ello	1	
Un beso grande a todos y uno más grande a alumine	1	
Y así o más grande te as comido o este es el primero grande que bes	1	
Y de grande es como acá un poco más grande no mas	1	
Ya estas mas grande Primita kiara , de echo siempre has estado más grande , porque un primo chaparro	1	
el mío es mas grande , uff es que me equivoqué , el mío es muchisisimo más grande millones de millones de millones así es mi vida muchaaaaaa tuu eres el mejor cielo lindo te quieroooo y te quieroo y te quierooooo por y para siempre amor , te quiero con mi vida entera que todo siemore sea de tu mano	1	
#grande,	grandísimo
Les pido 1 grandísimo favor pero así grande del mundo  .	2	
Osea no grandísimo pero pues si estaba grande y ahorita como ya se	1	
Osea no grandísimo pero pues si estaba grande y ahorita como ya sercaron pues ya no ay tanto como antes	1	
Santísimo Príncipe de la Gloriay poderoso Arcángel San Rafael , grande en los bienes de la naturaleza , grande en los dones de la gracia , grande en el ardor de la caridad , grande en el resplandor de la sabiduría , grande en la piedad con los hombres , grande en el poder contra los demonios , grande en la dignidad , grandísimo en la humildad  .	1	
Tuvimos la iglesia un evento grandísimo en uno de los parques mas grande de la ciudad y predicamos el evangelio y entregamos 3  .	1	
Yo le dije que si , me le medi a ese grandísimo reto , pero grande  .	1	
#grande,	más grande
Le queda grande la palabra padre y aún más grande la palabra HOMBRE	3	
Acabo de adoptar este gato con mi novio , el tiene un gato más grande que tiene 5 años , copito el gato grande esta acostumbrado a vivir solo ,	2	
La más grande 500 y la otra 300 vendo ya si son de Monte grande la llevo	2	
Acabo de adoptar este gato con mi novio , el tiene un gato más grande que tiene 5 años , copito el gato grande esta acostumbrado a vivir solo , y no le gusta que lo alcen , y a veces es arisco  .	1	
AjajajaSi mi pareja es más grande que tu Y No me es tan grande  !	1	
Claro amor yo confío en ti y en todo el amor nuestro amor es mas grande que nada es más grande que la autoridad de la directora quee no hicimos caso porque nos amamos si asi te aferras ala vida juntos se ara verdad amor	1	
De estas almas tan dulces y puras se aprende más que en cualquier facultad Ellos superaron lo que cualquier grande no podría , se merecen la felicidad más grande del mundo  .	1	
Detente y respira profundamente y recuerda que ningún problema es más grande que tú , tu eres mas grande que el  .	1	
El mas grande sigue siendo River plate y será más grande aun en el mañana	1	
El mas grande sigue siendo River plate y será más grande aun en el mañana por el juego por las ganas y el orgullo de tener una vanda r	1	
El mas grande sigue siendo River plate y será más grande aun en el mañana por el juego por las ganas y el orgullo de tener una vanda roja que nos cruza el alma	1	
El pez chico se come al más grande ósea Daniel es el grande y Juan es el chico	1	
Encima no es tan grande la oanza que tengo si hubiese sido más grande nose jajaj	1	
Es lo más grande que puede haber en el mundo más grande que el mar y mas grande que la vida	1	
Es que tengo dos suéteres y no es más grande que el otro y a veces me pongo la grande y por eso no se me notan  .	1	
Ese tarro no es ni grande jajaja a lo bien , yo lo imaginé más grande y nooojjj 80mil y eso no es nada , y tras de eso viene medio vacío es como las papás fritas	1	
Hay pues mi amor por ti es más grande qué tu amor por mi que es mas grande qué mi amor por ti que supera la face dios	1	
Hay si cuando estés más grande ya vengas mas buenote y tengas una cosota mas grande y rica	1	
Hay un oso En Pablo nogues No es muy grande pero mediano es más grande qe lo qe me diste	1	
Hoy en su primer día de clases mi princesa más grande 4to grado y mi princesa más chica 1er grado que grande estan  .	1	
K-bufa y va a jugar-Y mi ropa es más grande que tú , mi pequeño chico grande	1	
La mia es más grande , me ocupa todo el culo , ahre mentira pero posta es demasiado grande	1	
La más grande 500 y la otra 300 vendo ya si son de Monte grande la llevo o si	1	
M lo hizo un poquito más grande xq era muy grande lo q tenia	1	
No amenazaba estoy planeando algo muy grande ese va a ser el hecho más grande K puedes ver	1	
No había grande por eso no te compre más grande	1	
No sentí lo mismo Sentí algo mucho más grande sentí un amor inmenso algo grande te amo	1	
Obvio que Dios es grande , es lo más grande y lo más hermoso que existe en nuestras vidas y en las de cualquiera	1	
Ooowww si que ya esta grande y la chiquita Es hija de la más grande  ?	1	
Parece mas grande y no tiene mente de niña ls tiene de más grande	1	
Pero era jóven y me estaba entregando a algo mas grande , ahora eso más grande se a ido  .	1	
Podrias utilizar una vaporera grande , o por lo menos tres veces más grande que el pastel  .	1	
Por que me hacia grande y a la vez Lulú me hacia más grande xD	1	
Pues si Esperanza es lo más grande que tengo un beso grande guapa	1	
Pues tampoco la escuela que voy no está tan grande yo veo la secundaria más grande	1	
Que si el ángulo es mas pequeño era la medida pequeña y si el ángulo es grande es la medida más grande	1	
Sabes que mi amor por ti es muy grande y el que me digas estas cosas lo hacen aún más grande	1	
Se reía porque me dijo te llevaste el más grande que habia era obvio que te iba a grande jejje	1	
Si de hecho esta bonito el lugar un día te invitaré a la fiedta grande de mi pueblo jeje Por que igual es un pueblo pero aún más grande jeje y me encanta estar aquí	1	
Te amo demasiado Mi amor por ti es tan grande como el universo ya que no tiene fin y cada vez se hace más grande	1	
Te haces la mala sólo xq sos mas grande que yo Xq no te metes con una de tu edad o más grande  ?	1	
Todas Me hacen la misma pregunta y es complicado imagínate que al pedir un talle más grande de lo normal quizás les quedan muy grande	1	
Tu mi amor mas grande nuestro amor el más grande del Mundo Te Amo	1	
Uff Yali que HERMOSURA Ya se ne hizo grande Bueno ud es más grande que ello	1	
Un beso grande a todos y uno más grande a alumine	1	
Y así o más grande te as comido o este es el primero grande que bes	1	
Y de grande es como acá un poco más grande no mas	1	
Ya estas mas grande Primita kiara , de echo siempre has estado más grande , porque un primo chaparro	1	
el mío es mas grande , uff es que me equivoqué , el mío es muchisisimo más grande millones de millones de millones así es mi vida muchaaaaaa tuu eres el mejor cielo lindo te quieroooo y te quieroo y te quierooooo por y para siempre amor , te quiero con mi vida entera que todo siemore sea de tu mano	1	
#grande,	grandísimo
Les pido 1 grandísimo favor pero así grande del mundo  .	2	
Osea no grandísimo pero pues si estaba grande y ahorita como ya se	1	
Osea no grandísimo pero pues si estaba grande y ahorita como ya sercaron pues ya no ay tanto como antes	1	
Santísimo Príncipe de la Gloriay poderoso Arcángel San Rafael , grande en los bienes de la naturaleza , grande en los dones de la gracia , grande en el ardor de la caridad , grande en el resplandor de la sabiduría , grande en la piedad con los hombres , grande en el poder contra los demonios , grande en la dignidad , grandísimo en la humildad  .	1	
Tuvimos la iglesia un evento grandísimo en uno de los parques mas grande de la ciudad y predicamos el evangelio y entregamos 3  .	1	
Yo le dije que si , me le medi a ese grandísimo reto , pero grande  .	1	
#lento,	más lento
Sé lento en la elección de un amigo , pero más lento en cambiarlo  .	3	
Es un proceso lento , no lo hagas más lento renunciando  .	1	
Quitó la última conexión y el visto , dijo que quería ir más lento , pero no se fue con mamadas cuando dijo lento	1	
#lento,	lentísimo
Mk el Internet esta lentísimo me toda hablar por messenger porque el wasap esta muy lento	1	
#corto,	más corto
#corto,	cortísimo
#bueno,	mejor
Que bueno que ya estas mejor	119	
Que bueno que ya esta mejor	89	
Que bueno que ya estes mejor	88	
Mi Esposo , mi bebé , mi corazón , mi razón de ser , mi todo Si amor eso es lo bueno que ya vas a estar mejor y Cuantas inyecciónes te dieron amor  ?	84	
Que bueno que ya este mejor	65	
bueno amor de la mejor a pesar de las peleas , celos , llantos , risas , locuras , etc  .	63	
aunque no hablemos mucho x 2 siempre cuenta conmigo para todo Pendejito sigue así no cambies por nada ni por nadie Te quiero menso Te amo niño Te adoro indiota Bueno bueno niño Feliz Cumple te deseo todo lo mejor del mundo que todo lo que te propongas lo logres  .	43	
Que bueno que ya estés mejor	41	
Si mi bebé mucho pero mucho mas cariñosos Que bueno mi osito me alegro mucho pero mucho que estes mejor Hay mi cielo te amo mucho pero mucho mi bebé Esque es la verdad mi amor Porque si es mentira amor  .	36	
Lo bueno es que ya estas mejor	34	
Que bueno que ya te sientas mejor	32	
Que bueno que ya te sientes mejor	32	
Lo bueno que ya estas mejor	28	
Bueno cuina pero por una parte ps velo por el lado bueno ya staras tu qin tus hijos nadie mejor que tu para cuidalos	25	
bueno , en realidad , la q siempre sera la mejor para mi va a ser la de nuestro año esa junta estuvo hermosa y si asi estuvo en un año  .	25	
Lo bueno es que ya esta mejor	23	
Que bueno que te sientas mejor	23	
Que bueno yo igual , ten aun mejor día que yo  .	23	
Pero lo bueno es que ya estas mejor	22	
3 Estason las mañanitas que cantaba hoy para ti hoy por ser tu cumpleaños te las canto yo sai Eyyyy niña muchas felisidades que sigas cumpliendo muchos años mas que te la pases de lo mejor hoy en tu día sabes que te quiero mucho y pues eres la mejor la que siempre me acompaña en mis locuras bueno pues eso es todo y sabes que cuentas con migo en todo te quiero mucho cuídate niña y me guardas pastel	21	
Lo bueno que ya esta mejor	21	
Pero que bueno que ya estas mejor	21	
tu eres mi confidente , mi mejor amigo , mi fotógrafo , bueno eres mi TODO mi amor  .	21	
Q bueno q ya este mejor	18	
Q bueno q ya estas mejor	17	
Que bueno minreina que ya estes mucho mejor	16	
Hay mi amorcito lindo siento bien feo que tu estas enfermito y yo aca sin poderte ir a ver daría lo que fuera por aunque sea irte a cuidarte poco tiempo pero así no me gusta escucharte mal am si te pones las inyección te doy lo que tu quieras si amor hazlo para que te pongas mejor y te alivies mas rapido corazón pero bueno no te puedo obligar a algo que tu no quieres amor te amo mucho mi amorcito lindo eres el único con el que estoy muy bien enserio me tienes toda enamorada de a tu	15	
Q bueno q ya estés mejor	15	
Pero lo bueno que ya esta mejor	14	
Pero que bueno que ya esta mejor	14	
Barbiiii Se que me tarde lo siento Feliz cumple Jajajajajaja ojala te la estés pasando supeeer incre Te amo como no tienes idea bueno ya lo sabes siempre te lo digo eres la mejor persona que conozco eres super especial para mi Aaaah no tengo palabras Ya te eh dicho todoooo lo q creo de ti Sabes eso es vdd lo de LAS MEJORES AMISTADES COMIENZAN CON UN TU ME CAIAS MAL no crees  ?	13	
Jajaj , esta bien amor Ah , bueno , esta bien , mejor Si , esta bien y aquí desayunamos si quieres Dije que se me antojaron Jajajaja Ash , y yo por qué  ?	13	
Nacarando se que ya te felicite por persona pero bueno equis jaja Espero y te la hayas pasado hoy de lo mejor a lado de tus seres queridos Ya 4 años casi 5 de conocernos Aun tengo tantos recuerdos que me marcaron de una manera muy linda Cuando me enseñaste a jugar pares y tu y yo juntos ganábamos  .	13	
Pero lo bueno que ya estas mejor	13	
Q bueno q ya esta mejor	13	
Q bueno q ya estes mejor	13	
a lo mejor me e exacerbado un poco aquí pero sayori ya estaba enferma , Pero bueno  .	13	
Tuyo , tuyoo Es que ahhhhh eres tan linda , enserio ese mensajeee no manchess Y yo a la mejor novia del mundo entero Es bueno o malo  ?	12	
Ya con lo primero no me quiero ni imaginar Ah yaya bueno vendría a ser lo mejor para los dos creo	12	
Bueno solo quiero desearte un feliz cumpleaños , espero te la pases bien , con tu familia , pareja y amigos , tal vez es muy pronto pero bueno creo soy el primero en felicitarte jeje , bueno ps te deseo lo mejor , tal ves ya no somos nada pero tampoco soy tan hipócrita , bueno pasatela bien  .	11	
Cuando el día no es el mejor para ti , Sonríe , siempre hay un lado bueno	11	
Muchas gracias muñequita hermosa por entenderme Qué bueno que mis explicaciones te hacen entender mejor las cosas  .	11	
Pues bby sabes que hemos pasado por momentos super felices de muchas risass que pues son super especiales que has sido mi mejor amiga desde 1ro bueno tu ya sabes pues pero que aunque no nos vemos nos seguimos teniendo el mismo cariñooo  !	11	
Que bueno que te sientes mejor	11	
-P-P bueno mi amor espero que ya estes mucho mejor mmm  .	10	
No estas haciendo nd malo Que bueno que ya este mejor  .	10	
Pero bueno te deseo lo mejor	10	
Pero bueno yo si tengo q madrugar así q antes de caer mejor me despido  .	10	
Que bueno que ya estés mucho mejor  .	10	
Y si lo iso a lo mejor fue para no hacerte sentir mal , bueno mira habla con el bien y dejen las cosas bien claro  .	10	
#bueno,	buenísimo/bonísimo
