#Estocolmo,	Suecia
#Manila,	Filipinas
#Bruselas,	Bélgica
#Uanda,	Angola
#Nicosia,	Chipre
#Santiago,	Chile
En Chile su familia esta en viña , en Salamanca , en Santiago , en los andes  .	1	
En Perú en la ciudad de Lima y Chile en la ciudad de Santiago	1	
Mm Pues Seria Cool Vover A Ir A Chile Por Lo Ordenada Que Es La Ciudad , En Especial En Santiago , Pero Ps La Idea Es Conocer , Asi Quee Gustaria Ir A Argentina O Mexico Ps Para No Ir Tan Lejos JajajaY Si Es Aca En Colombia Mm A Medellin xD O Alguna Isla	1	
Pa encontramos otro mas cerca en Matucana 763- Santiago , hay un wester union , queda justo en un Chile express	1	
Santiago del Estero 2571-2581 , Renca , Región Metropolitana , Chile	1	
#Caracas,	Venezuela
Aqui esta el gran Felix Perez @felixperez36 demostrandole a Venezuela y a todo el mundo que los Leones del Caracas @leonescbbc son los mejores	5	
Aqui esta el gran Felix Perez @felixperez36 demostrandole a Venezuela y a todo el mundo q los Leones del Caracas @leo	1	
Buenas noches Cuñada , Estaba hablando ahorita con Ffrank , y te manda a decir que ya esta en Madrid y que dame mañana a las 10 20 am , hora de Venezuela , viene llegando a las 8 00 pm al aeropuerto de Caracas y te manda a deecir	1	
Buenas noches Cuñada , Estaba hablando ahorita con Ffrank , y te manda a decir que ya esta en Madrid y que dame mañana a las 10 20 am , hora de Venezuela , viene llegando a las 8 00 pm al aeropuerto de Caracas y te manda a deecir que te ama y ya te esta extrañando  .	1	
Cuando estaba en Venezuela hacia que mi papá fuera hasta Caracas a comprarme la caja	1	
De Caracas pero horita estoy en Colombia claro este viernes me voy a Venezuela y tu tiene pareja o esta soltera	1	
Perdón hasta ahora despierto karen hagale yo la espero para irnos a Venezuela y me lleve a valencia y Caracas	1	
Q viene siendo en Venezuela como 4 millones en Caracas compa y a ya cuanto gana un albañil compa	1	
Tenía mi novio legal en Venezuela se llama richard , Pero siempre e hablado con mi ex Israel , después de mi viaje a Caracas decidí venirme Sin ninguna necesidad , Pero yo queria salir de Venezuela , hable con mi novio y con Israel y Israel se vino por mi según el , Y que aquí podríamos tener una relación estable , termine con richard el mismo día en que me vine en incluso durmió conmigo esa noche y aquí llegué y vi a Israel como 3 veces y ya	1	
#Minsk,	Bielorrusia
#Tiflis,	Georgia
#Libreville,	Gabòn
#Tegucigalpa,	Honduras
Yo soy de Tegucigalpa la capital de Honduras	1	
#Londres,	Inglaterra
#Viena,	Austria
#Varsovia,	Polonia
#Berlín,	Alemania
Alemania derrotada en todos los frentes comienza a retirarse hacia la capital Berlín , la superioridad numérica y de recursos de los Aliados hacen imposible cualquier reacción alemana  .	1	
Hitler se encierra en el Führerbunker de Berlín y finalmente se suicida el 30 de Abril de 1945 , Alemania cesa los ataques el 8 de Mayo de ese mismo año  .	1	
Se supone que debe ir La caída del bloque socialista , la caída del muro de Berlín y la reunificación de Alemania	1	
#Islamabad,	Pakistán
#Berna,	Suiza
#Lima,	Perú
Cuando esté allá en Perú , le voy a decir a Nani , que vayamos hasta Lima a visitarte  .	2	
En Perú en la ciudad de Lima y Chile en la ciudad de Santiago	1	
En Perú es bueno ami me esta invitando un amigo que esta trabajando en Lima y el me dijo que hay buen trabajo y el trabaja en una panadería y le	1	
En Perú es bueno ami me esta invitando un amigo que esta trabajando en Lima y el me dijo que hay buen trabajo y el trabaja en una panadería y le toca aser dos turnos	1	
Entonces eres de Perú jajaja te envidio mi sueño es conocer Lima	1	
Es un Frances máster que vino a Visitarnos a Perú y Grabo un Video aquí en Lima  .	1	
Hermana Ya nathali llego a tumbes en Perú y va agarrar el bus a Lima , dice yomalis que llega en la madrugada por que son 19 horas para llegar alla	1	
Hermana Ya nathali llego a tumbes en Perú y va agarrar el bus a Lima , dice yomalis que llega en la madrugada por que son 19 horas para llegar alla , pero anda bien xq anda en grupo	1	
Lima es una de las pocas ciudades del Perú que esta muy bien en todo solo se preocupan por lima y no por lo de mas	1	
#Acra,	Ghana
#Trípoli,	Libia
#Gaborone,	Botsuana
#Manama,	Baréin
#Bratislava,	Eslovaquia
#Canberra,	Australia
#Kampala,	Uganda
#Katmandú,	Nepal
#Lisboa,	Portugal
Bueno ma aquí te paso algunas fotos , estas son de Lisboa , capital de Portugal	1	
Este fin de semana habra otro puente , desde el viernes al domingo , iremos a otro viaje a Portugal , pero esta vez a la capital , Lisboa y otra comunidad o ciudad , llamada Fatima , a ver que tal	1	
Hasta ahora solo he conocido de España , mi ciudad y otra ciudad a la orilla de España llamada Finisterre , ademas he ido a Portugal , donde conocí las dos ciudades mas grandes , Oporto y Lisboa , ademas de unos 8 pueblos de alla	1	
Volvimos a Portugal , pero ahora a la capital en Lisboa , estuvo super cool porque hicieron una fiesta el sabado y conocí a los chicos que vienen de intercambio a Madrid , Granada , Lisboa y no se que mas lugares , estaba llenisimo  !	1	
#Apia,	Samoa
#Belgrado,	Serbia
#Yakarta,	Indonesia
#Lilongüe,	Malaui
#Liubliana,	Eslovenia
#Moscú,	Rusia
#Tirana,	Tirana
#Ottawa,	Canadá
#Nairobi,	Kenia
#Copenhague,	Dinamarca
#Niamey,	Níger
#Abuya,	Nigeria
#Windhoek,	Namibia
#Podgorica,	Montenegro
#Polania,	esloti
#Brasil,	real
#Vietnam,	dong
#Suecia,	corona sueca
#Angola,	kwanza
#Japòn,	yen
#México,	peso
No la hemos podido pesar pero mañana en la mañana la va a pesar abel y te aviso cuanto peso por que hoy tenia un servicio abel a México y ya no pudo pesarla	1	
Ojalá México progrese pronto y la semana que viene el pinche peso ya cueste 1 euro alv	1	
Y el peso de Guatemala es el mismo que el de México	1	
porque aca en México se maneja el peso mexicano	1	
#Letonia,	lats
#Lituania,	litas
#Hungría,	forinto
#Estados Unidos,	dòlar
#Dinamarca,	corona danesa
#Aremenia,	dram
#Tailandia,	baht
#Nigeria,	naira
#Romania,	leu
#Argentina,	peso
Diría que él venga a Argentina pero no tengo un peso , así que mejor no	1	
Hija por esta época debido a que ha comido desbordadamente de todo es normal de que suba de peso pero eso lo contrarresta cuando llegue a Argentina cuidandose un poco más y haciendo algo de ejercicio	1	
No soy Argentina pero soy fan de messi , y no me gusta que todo el peso de los malos partidos de la seleccion caigan sobre él	1	
Soy de Buenos Aires Argentina y aquí se considera normal en gemelos un peso de 2500 en adelante  .	1	
#Rusia,	rublo
#Argelia,	dinar
#Ucrania,	grivna
#Croacia,	kuna
#Camboya,	riel
#Canadá,	dòlar
#Corea,	won
#Europa,	euro
Es que el euro esta en 24 pesos , por eso es tan caro venir a Europa	1	
#Malasia,	ringgit
#Irán,	rial
#India,	rupia
#Macedonia,	denar
#Bulgaria,	lev
#Wichita,	Kansas
#Akron,	Ohio
#Irvine,	California
#Toledo,	Ohio
#Indianápolis,	Indiana
#Denver,	Colorado
#Milwaukee,	Wisconsin
#Reno,	Nevada
#Boston,	Massachusetts
#Mineápolis,	Minnesota
#Bakersfield,	California
#Henderson,	Nevada
#Seattle,	Washington
#Atlanta,	Georgia
#Chandler,	Arizona
#Dallas,	Texas
#Madison,	Wisconsin
#Tampa,	Florida
#Tallahassee,	Florida
#Irving,	Texas
#Fontana,	California
#Anaheim,	California
#Fresno,	California
#Amarillo,	Texas
#Hialeah,	Florida
#Pittsburgh,	Pensilvania
#Austin,	Texas
