#Sacramento,	Calif
#Portland,	Oregon
#Glandale,	California
#Jacksonville,	Florida 
#Shreveport,	Louisiana
#Lexington,	Kentucky
#Tulsa,	Oklahoma 
#Glendale ,	Arizona
#Tucson,	Arizona
#Mesa,	Arizona
#Spokane,	Washington
#Memphis,	Tennessee
#Oxnard,	California 
#Tacoma,	Washington
#Lubbock,	Texas
#Worcester,	Massachusetts 
#Miami,	Florida
#Cleveland,	Ohio
#Scottsdale,	Arizona
#Louisville,	Kentucky
#Stockton,	California
#Detroit,	Michigan 
#Phoenix,	Arizona
#Philadelphia ,	Pennsylvania 
#Huntsville,	Alabama
#Cincinnati,	Ohio
#Honolulu,	Hawaii
#Nashville ,	Tennessee
#Oakland,	California 
#Houston,	Texas
#Fremont,	California 
#Orlando,	Florida 
#Arlington,	Texas
#Omaha,	Nebraska
#Laredo,	Texas
#Chicago,	Illinois
#Baltimore,	Maryland
#Anchorage,	Alaska
#Plano,	Texas
#Modesto,	California 
#Garland,	Texas
#Fratelli,	Sorelle
#Patrigno,	Matrigna
#Suo,	Suo
#Nipote,	Nipote 
#Uomo,	Donna
#Figliastro,	Figliastra
#Marito,	Moglie
#Nonno,	Nonna
#Sposo,	Sposa
#Nonno,	Nonna
#Fraello,	Sorella
#Re,	Regina
#Figlio ,	Figlia
#Padre ,	Madre
#Principe,	Principessa
#Ragazzo,	Ragazza 
#Nipote,	Nipote
#Fratellastro,	Sorellastra 
#Lui,	Lei
#Pap¨¤ ,	Mamma
#Zio,	Zia
#Figli,	Figlie
#Poliziotto,	Poliziotta
#Completo,	Completamente
#Fortunato,	Fortunatamente
#Veloce,	Velocemente
#Raro,	Raramente
#Stupendo ,	Stupendamente
#Possibile,	Possibilmente
#Sfortunato,	Sfortunatamente
#Allegro,	Allegramente
#Fortunato,	Fortunatamente
#Libero,	Liberamente
#Sicuro,	Sicuramente
#Repentino,	Repentinamente
#Apparente,	Apparentemente
#Efficiente,	Efficientemente 
#Rapido,	Rapidamente
#Preciso,	Prcsamente
#Riluttante,	Riluttantemente
#Serio,	Seriamente
#Calmo,	Con calma 
#Felice,	Felicemente
#Solito,	Solitamente
#Furioso,	Furiosamente
#Occasionale,	Occasionalmente
#Immediato,	Immediatamente
#Professionale,	Professionalmente
#Ovvio,	Ovviamente
#Improvviso,	Improvvisamente
#Tipico,	Tipicamente
#Tranquillo,	Tnquillamente
#Infrequente,	Infrequentemente
#Lento,	Lentamente
