#Tailandia,	Tailandese
Adesso sono in Tailandia mi sono trasferito e sposato con una Tailandese	1	
Il primo ministro Tailandese ha annunciato che si impegner√† a porre fine al commercio dell avorio in Tailandia , cogliendo un opportunit√† cruciale per stroncare il commercio globale di specie selvatiche  .	1	
#India,	Indiano
20 gradi 15 minuti N LONGITUDE- 90 gradi 15 minuti E Questo- North Oceano Indiano , il Golfo del Bengala India orientale  .	1	
Appello all'Ambasciatore Indiano in Italia I mar√≤ pugliesi Massimiliano Latorre e Salvatore Girone prigionieri in India vorrebbero rientrare in Italia per le feste di Natale  .	1	
Carter ha continuato in un discorso dopo il viaggio a New Delhi , I nostri interessi di sicurezza convergono sulla sicurezza marittima , in tutta la regione dell Oceano Indiano , in Afghanistan , dove l India ha fatto tanto per lo sviluppo economico e delle forze di sicurezza afgane , e sulle pi√π generali questioni regionali , in cui condividiamo interessi a lungo termine  .	1	
Chiederemo a gran voce che venga applicata adeguatamente la normativa approvata dal Governo Indiano per il divieto di trasporto di animali dall India al Nepal , durante la celebrazione del sacrificio di la pi√π grande macellazione rituale al mondo  .	1	
Cos√¨ la crociera si destagionalizza Dagli Emirati Arabi a Cuba , fino all'Oceano Indiano con tappe in India e  .	1	
Francy aiutami ad accumulare 20 milioni di Euro se vuoi che ti porti in India per il mio matrimonio Indiano Franziska Rennt	1	
Marea Nera in India , allarme nell oceano Indiano  !	1	
Nel contempo disporre la chiusura della nostra ambasciata in India ed espellere il console Indiano dall'Italia  !	1	
Per pi√π di 2000 anni il Mar Mediterraneo √® stato uno dei mari pi√π strategici del mondo , collegando petrolio e gas del Medio Oriente a i mercati dell Unione europea ; collegando Oceano Indiano , Cina , India , Corea del Sud e resto dell Asia ai mercati europei e all Oceano Atlantico attraverso il Canale di Suez , e collegando la base navale russa in Crimea della Flotta del Mar Nero agli oceani Atlantico ed Indiano  .	1	
Propongo una spedizione di Para e di Maro notturna per liberare i Nostri soldati in India , visto che i nostri politici aspettano i comodi del governo Indiano  .	1	
Va immediato cacciato ambasciatore Indiano stop permessi di soggiorno Invito nel lasciare India  .	1	
ed il Cinese e l'Hurudu del Subcontinente Indiano rispettivamente ciascuna , sia Cina che India con oltre 1 miliardo e 200 milioni di persone  .	1	
richiamare in Italia il ns ambasciatore in India e rispedire al mittente l'ambasciatore Indiano in Italia sarebbe un buon passo  .	1	
#Portogallo,	Portoghese
Il Podengo Portoghese √® la razza nazionale del Portogallo ed ha origini antichissime , tanto che √® raffigurato accanto all uomo in scene di caccia nei disegni rupestri delle caverne ph  .	2	
Il Portogallo avverte la Troika marcia indietro sulle richieste di austerit√† Dal Telegraph il Presidente Portoghese rinvia alla Corte Costituzionale i provvedimenti di austerit√†  .	1	
questo non c'entra niente con il Portogallo forse un suo trisavolo era Portoghese ma mi √® appena venuto in mente	1	
#Bielorussia,	Bielorusso
#Svezia,	Svedese
Svezia 1930 1 di 1 Saldatore in ottone di origini Svedese degli anni 30 , restaurato e ripensato per ricreare l effetto originale	3	
Chiss√† come fa la Svezia ad essere ancora intera con la Corona Svedese e senza l'Euro  ?	2	
- La parlamentare Svedese ha ammesso che vengono effettuali Scie Chimiche in Svezia e che sono molto nocive per l ambiente e per la salute umana  .	1	
Adoro la Svezia e Norvegia , ma senza sapere un H dello Svedese o Norvegese non credo siano mete possibili  .	1	
La croce nera da cui deriva la svastica tedesca e guardacaso la Svezia non √® stata coinvolta nelle guerre mondiali e la Corona Svedese √® una delle valute pi√π stabili del pianeta  .	1	
Sono stato a lavorare in Svezia e la tv Svedese c'era un canale che si vedevano tutti i suoi lavori  .	1	
#Spagna,	Spagnolo 
Anni fa sono andato in Spagna per lavoro e mi sono premurato di imparare lo Spagnolo  .	1	
Buonasera , √® un nuovo prodotto Spagnolo , attualmente presente in Francia , Inghilterra e ovviamente in Spagna  .	1	
Dall 8 al 18 maggio , la Spagna torna nel capoluogo lombardo con la manifestazione La Spagna a Milano , evento organizzato dall Ente Spagnolo del Turismo in collaborazione con l Instituto Cervantes e con il patrocinio del Comune di Milano  .	1	
Gli alunni beneficiari che verranno selezionati avranno l opportunit√† di recarsi presso una scuola partner con la quale di stipuleranno dei protocolli di intesa all estero e di seguire un corso di lingua Inglese per le mobilit√† di Malta e Cipro , mentre Spagnolo per la mobilit√† in Spagna con docenti madrelingua specializzati della durata di 80 ore  .	1	
Grandissima soddisfazione oggi alla Fiera di Valladolid Spagna dove abbiamo ricevuto dal Ministro dell'agricoltura Spagnolo il PREMIO INNOVAZIONE per la nostra Gamma di Carri miscelatori Elettrici  .	1	
La crisi spopola la Spagna La popolazione dello Stato Spagnolo continua a calare , e si √® ridotta nel 2014 per il terzo anno consecutivo , con una diminuzione di ben 170  .	1	
Ma perche non fai un concerto in Spagna , a Madrid , io , sono un tuo fan Spagnolo e conosco altra gente spagnola k tia mmira  !	1	
Nazionale Spagnolo Sub 17 Internazionale Under 17 per la Spagna Spagna  .	1	
No no non parla Italiano come non parla Spagnolo lingua in cui recita a Teatro in Spagna  .	1	
Ragazzi io sono Spagnolo e vivo in Spagna e neanche sul Yomvi posso vedere la serie A come sempre in questi anni  .	1	
Sul finire del secolo venne acquistato da un nobile di Spagna , il cui soprannome lo Spagnolo √® il motivo cui il palazzo deve il proprio nome  .	1	
questo √® l'ultimo anno di AMICI , Luca √® andato in Spagna per organizzare Amici Spagnolo  !	1	
si ha dato vita ad un appassionante duello in pista che poi √® stato risolto in suo favore dalla DORNA cos√¨ l'ultima gara in Spagna sar√† una comoda passerella per lo Spagnolo  .	1	
#Messico,	Messicano
30 incontro sul viaggio Papa Francesco in Messico con Armando Flores , Rettore Collegio Messicano di Roma	1	
A fine anno mi trasferir√≥ in Messico con la mia futura moglie , il tempo burocratico per diventare cittadino Messicano e giuro che rinuncio alla mia cittadinanza italiana  .	1	
Fiammetta , uno √® il figlio dell'ex-segretario del Partito Comunista Messicano che vive in Australia , ma che ci ha fatto scoprire che in Messico e in Cile hanno una venerazione per Berlinguer , l'altra √® una nonna che ha chiesto di rimanere anonima che ci ha ringraziato perch√© con enricoberlinguer  .	1	
Geronimo nacque nei pressi del fiume Gila , all'epoca territorio Messicano oggi √® parte del Nuovo Messico , che  .	1	
Il padiglione del Kuwait √® stato pagato per intero dal Kuwait , quello del Messico per intero dal governo Messicano e via dicendo  .	1	
Un mio amico Messicano mi ha scritto che in Messico √® scoppiato un caso dopo l'uscita di questo video , perch√® hanno provato che c'√® stata manipolazione dei risultati per far emergere quello che volevano  .	1	
#Brasile,	Brasiliano
Tutti nostri articoli vengono prodotti in Brasile , dove viene usato il migliore Supplex Lycra Brasiliano sul mercato  .	10	
Tutti i prodotti vengono prodotti in Brasile , dove viene usato il migliore Supplex Lycra Brasiliano sul mercato  .	2	
Chi √® Brasiliano come me o conosce davvero il Brasile sa che non √® cosi  .	1	
Ciao , Viola piacere soy Brasiliano fan di viola , per favore mandare un portachiavi , pra min en Brasile , per favore grazie  .	1	
E quello dev'essere un cucciolo di Fila Brasiliano una razza del Brasile , altissimo , come il Mastino Napolitano  !	1	
Fluminense √® una squadra , que in ultimo campionato qui in Brasile , √® stato in B , ma il Tosel Brasiliano , mantenutto in A  .	1	
Io sono Brasiliano e qui in Brasile non ho mai conosciuto una persona che si chiame MIGUEL  !	1	
Io sonoCittadino Brasiliano e lui Italiano , ci siamo sposati regolarmente in Brasile , oltre ad avere una relazione stabile da 23 anni  .	1	
Sono Brasiliano , sei mai venuto in Brasile  ?	1	
Un grande esempio √® il Brasile , che ha mollato il dollaro e ha creato il Real Brasiliano , se non erro , e non a caso √® una nuovissima potenza  .	1	
#Cina,	Cinese
Cina manovre militari in mar Cinese	2	
Come pensate che reagir√† la Cina quando Washington dichiarer√† che il Mar Cinese Meridionale √® una zona di interesse nazionale degli Stati Uniti , e invier√† il 60 della sua flotta nel Pacifico e costruir√† nuove basi aeree e navali americane dalle Filippine al Vietnam  ?	2	
Il nuovo numero di Limes si intitola Usa contro Cina ed √® dedicato al confronto tra Stati Uniti e Repubblica Popolare Cinese  .	2	
11 Il rapporto interno del Pentagono sostiene che la Cina sta costruendo relazioni strategiche lungo le rotte marittime dal Medio Oriente al Mar Cinese Meridionale , in modo da suggerire il posizionamento difensivo e offensivo per la protezione degli interessi energetici della Cina , ma anche per servire gli obiettivi di sicurezza generali  .	1	
2013 L escalation delle tensioni militari tra Washington e Pechino sul Mar Cinese Orientale √® solo superficialmente dovuta alla dichiarazione unilaterale della Cina di una zona di difesa aerea  .	1	
@ArtizzuFederico @alessandracatsi quindi solo la Cina che in questo momento ha il Mar Cinese Meridionale come priorita	1	
AL FORUM DI SINGAPORE IL SEGRETARIO ALLA DIFESA USA MINACCIA LA CINA Peter Symonds- In un discorso minaccioso e provocatorio pronunciato a Singapore sabato , il segretario alla difesa statunitense Chuck Hagel ha accusato direttamente la Cina di azioni unilaterali e destabilizzanti per imporre le sue rivendicazioni nel Mar Cinese Meridionale , e ha ammonito che gli USA non guarderanno dall altra parte mentre vengono sfidati i principi fondamentali dell ordine internazionale  .	1	
Alla fine del 2013 la Cina annunci√≤ una zona di difesa aerea sul Mar Cinese Orientale , comprendente le isole contese  .	1	
Anche Nike fa la stessa cosa , nonostante i prezzi alti , e in Cina √® questa la struttura del lavoro , il Governo Cinese lo permette e si arricchisce sulle spalle della sua popolazione  .	1	
Articolo sulla rivista Cinese che parla della FIPGC Federazione Internazionale Pasticceri Grazie alla Cina , vi  .	1	
Capodanno Cinese o Festa di Primavera Da noi √® passato da un po ma in Cina , Corea , Vietnam , Nepal , Bhutan e Giappone sta per cominciare Le famiglie si riuniscono e si praticano sacrifici per le divinit√† e per gli antenati , si prega Buddha e si puliscono le case dallo sporco dell'anno passato per fare posto alla felicit√† e alla buona sorte  .	1	
Cina 1985- La Grande Muraglia Cinese al passo di Badaling vicino a Pechino China 1985- Badaling Great Wall in Beijing  .	1	
Cina Tre Nuove Zone a Statuto Speciale L Ufficio Politico del Partito Comunista Cinese ha deciso che il paese deve avviarsi pi√π velocemente verso il capitalismo  .	1	
Cina e Russia esercitazioni militari congiunte nel Mar Cinese Meridionale	1	
Consiglio per la domenica mattina La Cina vince la battaglia ma non la guerra del Mar Cinese	1	
Cosa produrr√† quest incontro , pen-sando per esempio alla questione del Mar Cinese Meridionale o al crescente rapporto che s √® instaurato fra la Cina e l Australia  ?	1	
Creano fuga di capitali delle famiglie Italiane che spendono Cinese x il bassissimo costo investendo poi esclusivamente del loro Made in Cina  .	1	
Dal punto di vista di Pechino , nella Regione dell'Asia e del Pacifico sono in corso i processi che praticamente sfuggono al controllo la Corea del Nord minaccia i vicini e gli USA con le armi nucleari , il Giappone sta pedalando il conflitto con la Repubblica Popolare Cinese riguardante le isole contese , ci sono i dissidi tra la Cina e il Taiwan riguardante le isole Pescadores  .	1	
Di certo la Cina non √® poi cos√¨ vicina ma la Muraglia Cinese √® una delle mete pi√π ambite dai viaggiatori  .	1	
E cristallino che l alleanza nascente tra Russia e Cina avr√† implicazioni mondiali , dal Mar Cinese Meridionale all Atlantico , modificando i calcoli strategici in Eurasia ; essenzialmente in gran parte del globo  .	1	
EURONEWS ita- La Cina minaccia una zona di difesa aerea sul mar Cinese meridionale	1	
Entro il 2030 la Cina avr√† il controllo militare del Mar Cinese Meridionale e gli Stati Uniti , da anni , non sono  .	1	
Forchielli intervistato live a Pechino da CCTV , TV di stato Cinese , sui rapporti tra Cina e Russia	1	
Gi√† sappiamo che gli USA hanno annunciato un ribilanciamento verso l Asia , spostando il 60 della marina americana nel Mar Cinese Meridionale per controllare il flusso di risorse da cui la Cina dipende  .	1	
Hagel ha lasciato da parte le usuali finezze diplomatiche , e attaccato apertamente la Cina per le sue azioni nel Mar Cinese Meridionale  .	1	
Hagel paragona l annessione russa della Crimea con la ben pi√π complessa disputa territoriale che ha in atto la Cina con il Giappone sulle isolette disabitate nel Mar Cinese Orientale , da tempo contese  .	1	
Il 3 febbraio 2011 la Cina entra ufficialmente nell'anno del CONIGLIO e per l occasione l Ambasciata Cinese in Italia presenter√† una seri di eventi folcloristici culturali in tutte le maggiori piazze delle principali citt√† italiane  .	1	
Il Giappone accusa la Cina di manovre pericolose nel contestato Mar Cinese orientale , dopo che un caccia cinese ha sfiorato in volo un aereo militare giapponese a 30 metri di distanza  .	1	
Il Giappone ritiene che gli Stati Uniti non sono stati abbastanza risoluti nel rispondere alla dichiarazione della Cina di una zona di identificazione per la difesa aerea nel Mar Cinese orientale , mentre le Filippine si sono sentite lasciate sole quando la Cina ha istituito un efficace controllo del conteso isolotto di Scarborough  .	1	
Il Grande Fratello Cinese blocca Telegram-&gt ; In Cina  .	1	
Il Mar Cinese Meridionale Sia nel Mar Cinese Meridionale sia in quello Orientale , la Cina ei suoi vicini rivendicano la propriet√† di vari atolli e isole che si trovano a cavallo di vaste riserve sottomarine di petrolio e di gas  .	1	
Il giornale ha anche affermato che la Cina √® decisa a portare a termine i lavori di costruzione nel Mar Cinese Meridionale , definendoli la pi√π importante affermazione di Pechino  .	1	
Il problema e che molte Aziende se non producono in Cina col cavolo che il Governo Cinese permetterebbe la vendita nella Cina  !	1	
In Toscana migliaia di lavoratori e imprese cinesi Banca Centrale Cinese compra il 2 di presto diventer√† Monte dei Paschi di Cina	1	
In alcuni livelli della politica estera degli Stati Uniti stanno gi√† ragliando per un'azione pi√π concertata degli Stati Uniti nel Mar Cinese Meridionale al fine di dare alla Cina una lezione  .	1	
In occasione dell anno culturale della Cina in Italia promosso dal Ministero per la Cultura Cinese , IGAV , UCCA , Triennale Design Museum e Direzione Regionale per i Beni Culturali e Paesaggistici del Piemonte presentano la mostra China New Design , articolata nei due spazi espostivi del MINI&Triennale CreativeSet del Triennale Design Museum di Milano e Palazzo Chiablese di Torino  .	1	
In realt√† l'unico Class 40 ad aver compiuto un giro del mondo in solitario √® quello del velista Cinese Guo Chuan che √® partito e tornato da Qingdao in Cina rispettando le regole del World Sailing Speed Record Council impiegando sul giro del mondo 137 giorni e 20 ore  .	1	
Io ho vissuto 20anni in Cina , non ho mai avuto problemi , La cucina Cinese , se ti piace ci vai se non ti piace non ci vai , per√≤ non dire cose che non sono vere e se lo sono denuncia il fatto , anche in Italia se ne sentono di tutti i colori  .	1	
L Ambasciata Cinese in Italia e il Comitato Promotore Italiano dell Anno Culturale della Cina in Italia , presentano l Anno Culturale della Cina , che si terr√† il 1 ottobre , alle ore 11  .	1	
L amministrazione Obama annunciava di sostenere le pretese del Giappone sulle contestate isole dell arcipelago Senkaku/Diaoyu nel Mar Cinese Orientale , inasprendo il braccio di ferro tra Cina e Giappone  .	1	
L escalation delle tensioni militari tra Washington e Pechino sul Mar Cinese Orientale √® solo superficialmente dovuta alla dichiarazione unilaterale della Cina di una zona di difesa aerea  .	1	
La Borsa Cinese conferma l'acquisto del Milan Stamani mattina in Cina , la Borsa Centrale ha confermato  .	1	
La Cina invade il Bhutan L'esercito della Repubblica Popolare Cinese ha iniziato i lavori di una carreggiabile  .	1	
La Cina sorpassa gli Stati Uniti e diventa la prima potenza economica mondiale La Cina , che anche se nessuno lo ricorda √® governata dal Partito Comunista Cinese , √® diventata la prima potenza economica mondiale  .	1	
La Cina superpotenza economica investe nella marina per controllare il Mar Cinese meridionale alla faccia degli americani , il Giappone si appresta a reagire , gli Stati Uniti lo fanno gi√†  .	1	
La Cina vuole costruire 20 centrali nucleari nel Mar Cinese Meridionale	1	
La Cina √® coinvolta nell aspro battibecco con i vicini sui reclami nel Mar Cinese Meridionale , in particolare con il Vietnam  .	1	
La coppia di panda , giunta dalla Cina in prestito a febbraio 2011 , era diventata motivo di scontro con Pechino dopo che il nazionalista governatore di Tokyo , Shintaro Ishihara , aveva proposto di chiamare i cuccioli in arrivo Sen Sen o Kaku Kaku , riferendosi alle Senkaku , le isole contese nel mar Cinese orientale amministrate dal Giappone e rivendicate dalla Cina , che lo stesso Ishihara ha annunciato di voler acquistare per rafforzare la sovranita nipponica  .	1	
La goccia che ha fatto traboccare il vaso √® stato il comunicato stampa del Dipartimento di Stato Americano che venerd√¨ scorso ha assunto una posizione fortemente critica nei confronti della Cina e del suo operato nel Mar Cinese  .	1	
La medusa di Nomura cresce fino a 2 m di diametro e pesa fino a 220 kg ; 2 risiedono principalmente nelle acque tra la Cina e il Giappone , in primo luogo nel Mar Giallo e nel Mar Cinese Orientale  .	1	
#Per®¥ ,	Peruviano
#Argentina,	Argentino
Carissimo Flavio Insinna , Io sono Italo Argentino mie genitori sono italiani io sono nato in Argentina per saperne di pi√π in allegato ti invio il mio curriculum  .	4	
Castellano Italiano English Un d√≠a como hoy , en 1993 Tras recibir el premio al Mejor Futbolista Argentino del Siglo y de ganar la Copa Artemio Franchi con la selecci√≥n Argentina , Diego regres√≥ a Sevilla para enfrentar al por la Liga Espa√±ola  .	2	
@soghetti Daniel Scioli √© o candidato do povo Argentino , e Mauricio Macri √© o candidato da burguesia Argentina  .	1	
A Latinfiexpo non potete mancare all'appuntamento con le migliori empanadas della lombardia e con i prodotti della cucina tipica Argentina allo stand di Sabor Argentino Takeaway  !	1	
Argentina D soy Bboy Argentino 3	1	
Argentina va a perder , Soy Argentino  .	1	
Brasil 5 Argentino maricon 2 Pel√© tri Argentina 2	1	
Brazo Rico , Lago Argentino , Calafate , Santa Cruz , Argentina	1	
Castellano Italiano English Esta es la Selecci√≥n Argentina de todos los tiempos , seg√∫n la revista de la Asociaci√≥n del F√∫tbol Argentino  .	1	
Che vos sos Argentina , y os Argentino , que viva Argentina	1	
Chile Universidad Cat√≥lica Copa Interamericana 1994 Copa Chile 1995 Equador LDU Campeonato Equatoriano 1999 Argentina San Lorenzo Campeonato Argentino 2001 Copa Mercosul 2001 Argentina River Plate Campeonato Argentino 2003 Espanha Villarreal Copa Intertoto da UEFA 2004 estes de pelegrini	1	
Club Argentino de Pilotos-CAP-Club Datsun ZX de Argentina	1	
Desde Argentina Riickii Lcl Mc Argentino  !	1	
Ehhh il tangooo Argentino Bravissima Bele'n daiii ehhh una Argentina sicuramente e uno spettacolo nel ballare e che Argentina eheheeh giornooo Be n e anche al tuo amicooo	1	
Grande Hist√≥rico momento para nuestra Argentina , Soberan√≠a tecnol√≥gica ARSAT 1 Orgullo Argentino  !	1	
L'Ambasciata Argentina presenta il suo Ciclo di Cinema Argentino Oggi Mercoled√¨ 2 dic ore 19  .	1	
NO soy Argentino Pero , Dale Argentina  !	1	
Non soy Argentino , pero yo Amo Argentina  !	1	
Perle di Cinema Argentino IV un modo per scoprire l Argentina e forse un pezzo d Italia dimenticato  .	1	
Puoi contattare il Consolato Argentino pi√π vicino a casa tua , oppure l Ambasciata Argentina in Italia , Sezione Diritti Umani  .	1	
Quello che mi meraviglio che la maggioranza degli Italiani non hanno capito la portata della crisi , io sono Argentino di nascita , lo dico sempre , Argentina docet 2001  .	1	
Soy Argentino de River Plate Argentina , voy por chile sorprendiendo 3 a 0 ante brasil , dos goles de un ex River Alexis Sanchez	1	
Umberio Pellegrini hanno svenduto tutti i petroli , ancora pagano il crac delle banche , chiedi un Argentino come e la situazione in Argentina ora  .	1	
potri dire la stessa cosa Salvo ricordatevi che √® un Gesuita dove compaiono pi√π oggetti e cose pagane che in altri luoghi dove il loro credo dice che per raggiungere lo scopo tutto e lecito o dove in Argentina scrittori famosi hanno riportato che era colluso con il cartello Argentino prontamente smentito dalla chiesa perch√© la verit√† e solo vostra ms la storia mostra il contrario	1	
visto che abbiamo il Papa Argentino dico op op oppa Argentina Style  !	1	
#Corea,	Coreano
A parte il fatto che Trump sta cercando di mettere in atto un azione punitiva nei confronti del dittatore Nord Coreano e chiudere per sempre questo capitolo , non deve fare dimenticare che la Corea del Nord e sempre stata una nazione che minaccia di poter lanciare testate nucleari che possono colpire America Europa Australia etc , che abbia la possibilita o no , non credo sia una cosa tranquilla per gli stati vicini al Nord Corea  .	1	
Dice cos√≠ perch√® lui √® Coreano e sta tifando Giappone alla Confederation e si sa che Corea e Giappone per motivi politici si odiano  .	1	
Giusto ieri √® caduto un BlackHawk sul confine tra Nord e Sud Corea , se venisse fuori che l'attentatore era Nord Coreano avranno fatto tombola , di nuovo  .	1	
#Egitto,	Egiziano 
io sono Egiziano Copto la situazione in Egitto √® molto grave i terroristi islamici fratelli musulmani stanno terrorizzando un intero paese  .	2	
Andate sulla mia pagina , ho anche dei filmati del Egitto , che comunque per met√† sono anche Egiziano , comunque questa foto trattasi della caduta di Mobarak e non Morsi , DETTO DAI MIEI CUGINI CHE ABITANO LI E ERANO IN MEZZO A QUELLA FOLLA	1	
Egiziano non arabo , l Egitto si trova in Africa  .	1	
Lo spot creato dall Ente Turismo Egiziano Eta in occasione del viaggio di TriathlonTravel in Egitto  .	1	
#Ucraina,	Ucraino 
Poich√© con moglie Ucraina ho studiato usi , costumi e usanze del popolo Ucraino e la storia dello stesso popolo  .	2	
Qui sotto il video in cui si vede chiaramente il risultato del massacro dei civili a Novoaidar , sud Ucraina , 26 / 05 / 2014 organizzato dalla gloriosa Guardia Nazionale Ucraina , che fa parte dell'esercito Ucraino ed √® composta dai membri delle organizzazioni neonaziste locali  .	2	
perche se Ucraina firma accordo con la NATO nel territorio Ucraino verranno installate le missili puntate contro la Russia  .	2	
@Sinistrait @NFratoianni in Ucraina hanno messo al bando il PC Ucraino  .	1	
Chiediamo che il governo Ucraino riveda la propria decisione e insistiamo perch√© l Unione europea e l Ucraina mirino ad elaborare una partnership esaustiva , forte e giusta , fondata sui valori democratici e il mutuo rispetto , avendo come obiettivo comune un futuro di pace e prosperit√† per il continente europeo , aggiunge Gessant  .	1	
Dal primo giorno del conflitto in Ucraina i soldati Russi e Americane erano sul territorio Ucraino , era tutto programmato , Putin insieme a Barack Obama  .	1	
Delirio del Primo Ministro Ucraino Yatseniuk non lascieremo che i russi invadano l Ucraina e la Germania come avvenuto durante la seconda guerra mondiale  .	1	
E adesso sono venuti in Ucraina , vogliono fare anche con il popolo Ucraino , uccidere i bambini , figli , madri , padri , nonni  .	1	
In Ucraina regna irregolarit√° e violenza , il governo √® assente , il governo Ucraino manda militari contro civili  .	1	
L ex presidente Ucraino ha affermato che non ha alcuna intenzione di dimettersi o di lasciare l Ucraina , confrontando la crisi politica del paese all ascesa dei nazisti nel 1930  .	1	
La Unione Europea dovrebbe fare pressione sul Governo Ucraino per indire un Referendum per l ingresso della Ucraina nella UE  .	1	
La giornalista Elena Raygorodetskaya ha fatto riferimento alle nuove leggi dello Stato Ucraino Secondo le nuove leggi il fatto che noi , cittadini dell Ucraina , ci troviamo qui pu√≤ condurre ad una condanna penale  .	1	
Nessun abuso Russo √® stato commesso in Ucraina , al contrario il Governo Ucraino ha commesso atti criminali contro i filo  .	1	
Putin ha fatto il referendum per entrare la Crimea- Ucraina in Russia , ma perch√© anche Ucraina non pu√≤ fare il referendum per entrare in Europa , vogliono il popolo Ucraino entrare in Europa , oppure no  ?	1	
Questo ragazzo e Ucraino , e fatto tutto in una pasteceria in Ucraina  .	1	
Secondo un veterano dell intelligence USA , i cecchini provenivano da un organizzazione militare di ultra-destra nota come Assemblea Nazionale Ucraina Autodifesa del Popolo Ucraino UNA-UNSO  .	1	
Si capisce senza fare tanti commenti che il nuovo governo Ucraino sta usando l'esercito per terrorizzare le popolazioni dell'Est Ucraina che non hanno sostenuto il golpe di Maidan e non hanno accettato le elezioni del nuovo governo  .	1	
#Australia,	Australiano
Ariana durante il programma Australiano Sunrise ha detto che il Dangerous Woman tour andr√† anche in Australia  !	1	
Credo che valga la pena di firmare la petizione del WWF Australia perch√® il governo Australiano prenda dei provvedimenti seri per salvare la Grande Barriera Corallina , patrimonio dell'umanit√† e culla di una fetta notevole di biodiversit√† marina che non deve andare distrutta  .	1	
Questa sera sar√† in onda su Canale 5 il kolossal Australia un'immersione nei paesaggi dell Outback Australiano  .	1	
Vivo in Australia da 40 anni , questo e la legge del Governo Australiano su gli immigrati illegali , dobbiamo fare come loro La soluzione del Pacifico √® il nome dato alla politica del governo australiano di trasportare i richiedenti asilo nei centri di detenzione nelle isole nell'Oceano Pacifico , piuttosto che permettere loro di atterrare sul continente australiano  .	1	
WOW sei in Australia Belen noooo BEATA te il Kangoroo animale tipico Australiano Ehy Ma stai i attenta i Kangoroo sono aggressivi e pericolosi tienili sempre a distanza Belen ahahah ahah ho capitooo buonaseraaa	1	
Western Australia vota per l'indipendenza dal Commonwealth Australiano ,	1	
ecc , ecc mi rammarico solo di non aver comprato quando vi era il padiglione Australia il vero Boomerang Australiano e il liquore al Melogramo  .	1	
#Russia,	Russo
, la crisi in itinere tra la Russia e la Turchia , oramai palesemente sorta ed acuita con l'abbattimento del Caccia Russo da parte dell'Aviazione Militare Turca , non lascerebbe spiragli di tranquillit√† volti al mantenimento di una Serena pace  .	1	
@AndreaPolo98 Io parlo Russo in quanto vivo in Russia	1	
Adesso , Putin minaccia di non fornire pi√π il gas all'Ucraina se non paga i debiti fatti di fatto dal suo precedente fantoccio Russo che lui sta ospitando in Russia , magari potrebbe chiederlo a lui il saldo del debito , e se l'Ucraina non paga e lui taglia il gas , sarebbe l'Ucraina ad essere responsabile per i territori dell'est che ormai si sono ribellati all'Ucraina  .	1	
America e Nato tiene una grande paura da Russia ma popolo ocidente e tropo tropo stupido loro TV dicono tutte bugie nuovo Arsenale Russo e meglio di questo Americano Americano e tutto vechio spacatura senza Russia Mondo e Morto ora si rompe anche il nato criminale	1	
Andate in Russia , imparate il Russo , ascoltate i telegiornali Russi e fatevi una vostra idea della situazione  .	1	
Buon 25 aprile anche a te con questa lettera dal Fronte Russo che scrisse mio zio Lino Fascina , anni 21 , disperso in Russia agli inizi del 43- Fronte Russo 24 Dicembre 1942 Miei carissimi , sono le 10 di sera  .	1	
Dopo mesi di urlare invasione della Russia , una settimana fa effettivamente l'esercito Russo in realt√† 300 uomini sono entrati nel territorio Ucraino  .	1	
Essa riflette una profonda comprensione di quello che sta accadendo , da parte dei Paesi che non hanno votato a favore e soprattutto quelli che hanno votato contro La Cina comprende i legittimi interessi Russi e sue preoccupazioni in Ucraina D Tre settimane fa , al nostro programma √® intervenuto l Ambasciatore Russo Vitaly Churkin presso le Nazioni Unite , sostenendo che la Russia si aspetta di vedere unsupporto morale dalla Cina  .	1	
Forza Russia Per Sempre , io sono un Russo Doc veramente	1	
Gli Integrazionisti Atlantici all interno del Governo Russo vogliono che vinca l Occidente e non la Russia  .	1	
I Popoli europei hanno molte pi√∫ Caratteristiche antropologiche in Comune con quello Russo che con gli USA sia la Russia che l Europa hanno una Storia plurimillenaria , entrambe sono Guide della Cultura e dell Arte mondiale ed entrambe vivono SEGUENDO I VALORI DI CRISTO  !	1	
I rischi della Russia ed il consenso di Profondo Russo via @linkiesta	1	
Il fantoccio Russo al governo dell'Ucraina acquista servizi dalla Russia , senza pagare , per√≤ in casa sua ha il bagno rivestito d'oro e non √® uno scherzo  .	1	
In Crimea anche la stra maggioranza dell'esercito era Russo , erano tutti Russi √® chiaro che volevano essere legati alla Russia	1	
In alternativa , il governo Russo dovrebbe annunciare la sua risposta alla guerra economica in atto contro la Russia da parte del governo Statunitense e dalle agenzie di rating di Wall Street , e cio√® l auto-cancellazione del suo debito verso i creditori occidentali  .	1	
La Rivoluzione russa √® stato un evento sociopolitico , occorso in Russia nel 1917 , che port√≤ al rovesciamento dell'Impero Russo capitanato dal regime zarista e alla formazione prima della Repubblica Socialista Federativa Sovietica Russa e , cinque anni pi√π tardi nel 1922 in seguito alla Guerra Civile Russa , dell'Unione Sovietica , tentativo di applicazione delle teorie sociali ed economiche di Karl Marx e Friedrich Engels  .	1	
La Russia √® un Paese che amo e amo anche il popolo Russo  .	1	
Lui √® un attore Russo , e questo cane vive in Russia  .	1	
Ma qui sono tutti esperti parlano bla bla bla Alessandra Colmo cosa stai dicendo Ucraini lasciate liberta del pensiero dei filorussi ma se in Ucraina c'√® qualcuno che vuole diventare Russo perch√© non prende le bagagli √® va a fanculo in Russia  ?	1	
Padiglione Russo Questa settimana Habbo EXPOsition dei BAW ti porta in Russia  !	1	
Penso che i Russi vogliono mettere a dura prova la NATO , non sarebbe il primo caso in cui la Russia sconfina paesi della NATO , e purtroppo questo ennesimo sconfinamento corrisponde ad un ennesima provocazione da parte della Russia , con l'abbattimento del caccia Russo si √® riuscito finalmente a dare un segnale alla Russia , quel segnale che la Russia cercava da tempo per valutare l'integrit√† di questa alleanza atlantica  .	1	
Perci√≤ , in Russia il leader dell'opposizione si chiama Zyuganov , segretario del Partito Comunista Russo  .	1	
Pulley √® stato subito scoperto da Russo canale televisivo statale Russia Today , che ha riportato il titolo di questa notizia che Ashton ha riferito che Yanukovich non √® stato coinvolto negli omicidi di persone su Independence  .	1	
Quando si adotta all'estero lo si fa rispettando le leggi del paese in questione e mi sembra giusto , in Russia le coppie omosessuali non possono adottare , quindi nessun bambino Russo potrebbe mai finire in una coppia omosessuale  .	1	
Questo accordo stimoler√† ulteriormente lo sviluppo di commerci diretti in yuan e rubli sul mercato interno degli scambi con l'estero di Russia e Cina , ha riferito un portavoce Russo  .	1	
Sbaglier√≤ , ma la stabilit√† che Putin ha dato alla Russia in questi anni √® sicuramente costata troppo al popolo Russo e spero sinceramente che il prezzo non aumenti , ne parlo non da partigiano di una fazione , solo in funzione dei dati di fatto  .	1	
Se l'Ucraina decide di avere altri alleati allora gli abitanti della Crimea visto che sono russi nella maggioranza decidono di stare con la Russia , dove sta l'espansinismo Russo  .	1	
Semmai √® da considerare il fatto che gli USA vogliano restringere l'accesso Russo al Mediterraneo via Mar Nero ma la Russia ha gi√† uno sbocco  .	1	
Un ultima cosa Renzi nell'incontro del G 7 e stato mortificato e umiliato , a questo punto visto la figuraccia sarebbe pi√π opportuno x lui fermare le sanzioni alla Russia imponendo all'America che l'Italia si potrebbr alleare col governo Russo e di conseguenza lasciare l'Europa  .	1	
Vada per l'occhio che spesso nella simbologia del popolo Russo si accomuna all'occhio della Santa Madre Russia o a quello della chiesa Ortodossa ma scusa , un rosario accanto a delle armi  ?	1	
cerco lavoro in Russia e imparer√≤ il Russo  .	1	
devono compensare le perdite in seguito all'embargo Russo per avere pugnalato la Russia alle spalle  .	1	
e in Russia si dice sano come un bue , pero bisogna tenere presente in Russo sano e il sinonimo di grande e di forte  .	1	
la la televisione vi offre notizie pilotate e contro il governo Ucraino e Russo , ovvio la Stella Rossa simbolo della Russia non del comunismo ha sempre fatto paura e ora pi√π che mai  .	1	
#Giappone,	Giapponese
@loty1751 Buongiorno In Giappone ci sono un sacco di fiore originaria del Giapponese Inoltre per favore guardi il fiore giapponese che ho foto	1	
Aggiungo , per completezza di informazione , che la Sumitomo , Giapponese , e proprietaria della Falken e di Dunlop per il mercato in Giappone , Africa , Asia e America Latina ; detiene anche la Goodyear sempre per il mercato Giapponese e varie altre marche praticamente sconosciute  .	1	
Candid Giapponese Ma che scherzi fanno in Giappone  ?	1	
Ciao Gianni , segue una ragazza che fa la red bull rookies cup , poi ha una scuola per ragazzi in Giappone e lavora per la TV Giapponese  .	1	
Estate Giapponese 2016 la cultura e i sapori del Giappone tornano all Isola Tiberina di Roma	1	
Estate Giapponese 2016 la ei sapori del Giappone tornano all'Isola Tiberina di Roma Estate Gia	1	
Giappone si vendica e vince il Derby Giapponese , ribaltato il riferimento del	1	
Giapponese chi vuole di essere italiana e vive in Giappone Grazie mille	1	
Harry in Giappone ha ballato Gangnam Style pensando che PSY fosse Giapponese  .	1	
I ragazzi in un intervista in Giappone con @YUTTY52 Attore Giapponese	1	
Impara il Giapponese con Oxidiana 4a Lezione Quanto sono importanti le buone maniere in Giappone  ?	1	
In 12 anni di Giappone non ho mai visto un Giapponese mangiarlo con le mani  .	1	
L'unica cosa che posso fare , √® essere vicino col cuore e con l'anima al popolo Giapponese , sperando di rivedere presto , di nuovo , sorridere i fratelli del Giappone  !	1	
La Bolla e il Fantasma Una Storia Giapponese La popolazione del Giappone diminuisce mentre cresce quella di Tokyo  .	1	
La prima √® la bandiera nazionale Giapponese , quella piccola al centro √® la bandiera della marina militare del Giappone  .	1	
Luigi in un Giappone del 1756 , in trasferta per visitar L'imperatore Giapponese e chiedergli di unirsi a Voi per un bicchier di Vin Brul√© autunnale , magari con qualche castagna e senza sushi	1	
Mi √® sempre piaciuto il fatto che nonostante erano di nazionalit√† Giapponese e giocavano nella nazionale del Giappone  .	1	
Noi Giapponese tifosi non possiamo dimenticare sua gentile risposta in 2005 estate , Viaggio per Giappone  !	1	
Oggi , ad un mese dallo tsunami che tragicamente ha colpito il Giappone , il WWF Italia √® ancora vicino alla popolazione Giapponese , ma siamo vicini anche al popolo Italiano che dovr√† , al referendum estivo del 12 e 13 Giugno , recarsi alle urne per dire SI contro il nucleare  .	1	
Ogni volta che rivedo le mie foto in Giappone , ascolto una musica tradizionale Giapponese , e penso ai luoghi in cui sono stato  .	1	
Oltre a essere in tendenza in Giappone hummel collabora anche con il marchio premium Giapponese master-piece MSPC  .	1	
Sabato pomeriggio al Festival Giapponese ci sar√† anche una famosa IDOL molto popolare in Giappone Airly	1	
Sei in Giappone , parli bene Giapponese , hai trovato lavoro e studi  !	1	
ll Territorio Giapponese Ministero degli Affari Esteri del Giappone	1	
solidariet√† a tutti gli Italiani in Giappone e a tutta la popolazione Giapponese	1	
#Cambogia,	Cambogiano 
#Grecia,	Greco
Kyriakos Psikakos Emanuele Ciampitti Il popolo Greco vive e lavora per la Grecia , i Greci stessi vanno in vacanza in Grecia , sono i turisti della loro terra perch√© la amano  .	2	
2 Grecia 2014- 400 anniversario della morte di El Greco	1	
Ancora notizie dalla Grecia , su Varoufakis e le prime mosse del Governo Greco all'indomani della vittoria del No  !	1	
Dobbiamo sempre ricordarci cosa ha fatto l'Eeuropa in Grecia e la cultura che dato al mondo il popolo Greco  .	1	
Fratelli pure in Grecia √® cosi non litigate ve lo dice un Greco  .	1	
Grandi , evviva il popolo Greco , la prossima vacanza se ci sar√† sara in Grecia  .	1	
Grazie a Monti i dati contabili sono questi , senza il governo Monti oggi saremmo lo zimbello d'europa e non solo , peggio della Grecia , con rispetto per il popolo Greco  !	1	
La legge italiana dice che pu√≤ essere definito Yogurt Greco solo quello prodotto in Grecia  .	1	
La stampa Italiana spara le stesse disinformazioni come Tremonti quando fu ministro , L Italia non diventera mai come la Grecia solo che se uno italiano parlasse il Greco avrebbe capitto che la situazione e uguale identica  .	1	
La verit√† √® che la Grecia √® fallita da tempo , il debito pubblico Greco √® enorme rispetto al pil del paese , non c'√® nessuna possibilit√† che si possa salvare , il default √® l'unica strada sensata  .	1	
Lo sfaldamento in atto dei partiti deve giustificare , come male minore , l insediamento nei luoghi istituzionali della Repubblica dei killer della TROIKA , gli stessi che hanno saccheggiato la Grecia e ridotto in miseria il Popolo Greco  .	1	
No no , Greco e vivo in Grecia  !	1	
OXI-NO La Piazza di Roma al fianco di Syriza e del popolo Greco Il Referendum in Grecia cambier√† tutta l'Europa	1	
OXI-NO La Piazza di Roma al fianco di Syriza e del popolo Greco Il Referendum in Grecia cambier√† tutta l'Europa	1	
Per come e messa la Grecia o meglio il Popolo Greco il referendum e una cazzata , e una forma di non responsabilita del Governo  .	1	
Quale lo scenario nel caso della Grecia e nel caso dell'Italia 2 Cosa pensa Bagnai del referendum Greco 3 Cosa potrebbe favorire l'uscita dell'Italia dall'Euro  ?	1	
Ragazzi , non per essere drammatico , ma √® rientrata ora mia sorella , ha parlato con un suo amico Greco , e gli ha detto che in Grecia stanno andando tt all estero , sono aumentati suicidi e criminalit√†	1	
Se la Grecia esce dall'euro Gerardo in quanto Greco uscir√† dalla Rai  ?	1	
Se la Grecia esce dovremmo preparare una bella festa in onore del popolo Greco che √® riuscito a liberarsi dalle zecche	1	
Sei stato a Grecia √® a dire che sei cittadino Greco e hai naconalita Macedone Pero Non sbagliare a dire che hai nacionalita Macedone  .	1	
Sono nata da genitori Italiani nati all'estero in Grecia , quindi parlo perfettamente il Greco e capisco questa lingua senza traduzioni , trovo vergognoso quello che e stato fatto a questa gente in nome dell'Europa camandata dalla Germania , un paese vinto che ha prodotto mostri come Hitler e i suoi seguaci  .	1	
Spero che il terrorismo che l'alta finanza internazionale sta facendo in tutta Europa e non solo in Grecia , non riesca a piegare a suo favore il popolo Greco prima , e tutti gli altri stati europei dopo la Grecia  .	1	
Spiaggia Avithos Grecia Profumo di Basilico Greco	1	
Un Greco al padiglione della Grecia	1	
Un profugo siriano bacia sua figlia mentre cammina sotto un temporale verso il confine tra la Grecia e la Macedonia , diretto al villaggio Greco di Idomeni , 10 Settembre 2015  .	1	
cara Francesca , con la Grecia lo hanno gia fatto con il referendum poi ritirato dal Governo Greco , dietro pressioni di questo Van Rompuy  !	1	
tedeschi devono alla Grecia 3 volte in piu dell debito Greco alla UE  .	1	
#Olanda,	Olandese
49 anni fa nasceva a Utrecht Olanda Marco Van Basten , storico centravanti del Milan e della Nazionale Olandese  .	1	
Dopo i fatti di Roma , per i quali ho provato un sincero disgusto , e dopo le dichiarazioni del Governo Olandese , ho deciso di non andare pi√π in Olanda perch√®- mi dispiace dirlo- quella gente ed i loro governanti mi stanno oggi veramente antipatici  .	1	
Ed ha esultato in Olandese visto che la Ferrari ha sede in Olanda  ?	1	
Spagna 1- 1 Olanda goal PAZZESCO di Van Persie per il pareggio Olandese	1	
la troupe Olandese deve andare a rompere le palle ai suoi deputati , io in Olanda ci abito e i loro ministri fanno esatamente quello che fanno gli Italiani , cioe prenderci per il culo	1	
#Inghilterra ,	Inglese
Le famose case della campagna Inglese io ne ho viste pi√π di qualcuna nei miei viaggi in Inghilterra  .	1	
raccolti da una nave Inglese perch√© non portarli in Inghilterra  ?	1	
#Polonia,	Polacco
Il sangue polacco L'Austria , alleata con la Russia il cosacco , ha bevuto il sangue Polacco , ha diviso e smembrato la Polonia  .	2	
Buon Lunedi , per tutti color che si chiedono le ragioni del Boom Economico Polacco e tutti i vantaggi di investire in Polonia  .	1	
Grande Robert Lewandowsk Robert porta in Italia il Centrocampista del Lech Poznan , Marcin Gawron , futuro talento Polacco , grazie forza Polonia  .	1	
Il Polacco sar√† rimasto soddisfatto quanto deluso dei cambiamenti nella martoriata Polonia , tra due guerre mondiali , sterminii e Guerra Fredda  .	1	
No replica il Polacco Voglio che l esercito Cinese invada di nuovo la Polonia  .	1	
Polonia Lodo te Amo Venite A Polacco Love you Te Ama Lodo 3 3	1	
Sono molto fiero che io sono Polacco √® che vivo in Polonia  .	1	
#Irlanda,	Irlandese
Governatore della BC Irlandese , Rivela La ha Minacciato di Mandare in Bancarotta l Irlanda	1	
Hanno avuto i loro maggiori trionfi in Irlanda Lloyd George negoziando una fine per la Guerra Irlandese di Indipendenza nel 1921 , e Blair portando la pace in Irlanda del Nord con l Accordo del Venerd√¨ Santo , nel 1998  .	1	
#Slovacchia,	Slovacco
#Albania,	Albanese
Albanese del cazzo aripia er gommone e vattene a fanculo in Albania lotito all obitorio	1	
Alla Albania Oggi Come oggi per il Popolo Albanese Serve Molto L'Europa , in fatti di diritti , politica corrotta , anche se in certi paesi dell unione lo stesso sono messi male , Pero Europa Ha Dei Buon Principi , Europa Tutto il continente Deve diventare una Cosi solo Potra Essere La Vera Potenza Mondiale  .	1	
Da cittadino Albanese volevo aggiungere che l Albania e il terzo mondo  !	1	
E per piacere , non parliamo della Grande Albania che se fosse per loro Alessandro Magno era Albanese e quindi 3 / 4 dell'Asia sarebbe Albanese  .	1	
Forse Aldo qui , sta pensando ; Dio , quando sara quel giorno ke noi voi 3 andiamo un gionro in Albania per rispetare popolo Albanese , anke perke non e stato il tuto popolo Albanese nelle nostri show , loro ano visti tutti nostri progetti , teatrali & cinematografici , grande Dio , aspetto tuo risposto  .	1	
Forse non vale in Albania , perche abbiamo gia una PREMIER JUVENTINO farano una bell calcopoli Albanese  .	1	
Hahaha , Ciao Albanese , in Germania sono poveri come in Albania  .	1	
Io sono Albanese , e funghi piu migliori in Albania sono le funghi Porcini di Puka  .	1	
Io sono Albanese conosco bene la mia Albania  .	1	
Italia 1 rigore tirato da Albania 0 fa un p√≥ Roma Lazio gol di Daniele De Rossi al portiere Albanese Strakosha della Lazio ventessimo gol in nazionale per il gicatore della Roma 24 / 3 / 17	1	
Lambrenedetto XVI vieni a vivere in Albania , faccendo una vita da Albanese medio e dopo 1 anno ne riparliamo  .	1	
Lambrenedetto sei grande , piu lavoro ho fato tu per Albania , se tutto il governo Albanese  .	1	
Le chiedo scusa se le scrivo in italiano ma io sono venuto via dal Albania quando avevo 12 anni e non riesco a scrivere bene Albanese  .	1	
Omettendo completamente di citare le associazioni che sono intervenuti e che da tempo stanno liberando orsi in Albania , in collaborazione con il governo Albanese  .	1	
Parli dell Albania come se avessi sangue Albanese  !	1	
Perch√© non venire in Albania o continuare a lavorare in Albanese giovane  .	1	
Poi per quando riguarda Albania e un popolo di provenienza etrusca , per informazione Alessandro il grande era Albanese  !	1	
Scusa Emanuele ma io sono Albanese , vivo in Albania e ho imparato l'italiano dalla tv  .	1	
Smettiamo di parlare a caso , meritava di vincere Virginia e non perche Klaudia non e brava ma semplicemente perche lei e gia una ballerina professionista in Albania , e famosa , lavora nella tv Albanese e ha un marito coreografo  .	1	
Sono Albanese Sig tare Cana si devi fare giocha in Albania e che cazz 000 viaaaa	1	
Ti faccio i miei complimenti x le tue informazioni sul Albania lambrenedettto , Io sono Albanese e fiera di essere , Mi spiace tantissimo del Italia x questo periodo che sta attraversando e spero che si riprenda a breve , pero faccio un apello a gli Italiani razisi che poi x fortuna non si fa tutto l'erba un fascio , perche ci sono delle bravissime persone del restocome ogni mondo e paese , ai razisti tra gli Italiani stessi eee , AMATEVI PERCHE SE NON VI AMATE VOI STESSI , NON VI AMERA NESSUNO  !	1	
Tu Albania mi dai onore , mi dai il nome di Albanese  .	1	
Un altro riconoscimento per Elhaida , votata Miglior Artista Albanese agli IMA awards , che Info Media Albania assegna ogni anno in diverse categorie dello spettacolo e dell'informazione  !	1	
Un ragazzo Albanese ha scritto che la laurea presa in Albania , non √® convalidata n√® qui in italia , ne in altri paesi  .	1	
ci√≤ che lui sta facendo del Albania tocca a farlo a noi Albanesi e non cm quello Albanese che in una foto con questo Sig aveva una maglia della Lega Nord  .	1	
il marketing che hai fatto all Albania in una settimana , non lo ha fatto il Ministero del Turismo Albanese in 25 anni  .	1	
questa e la protesta davanti il ministero Albanese , contro le armi chimiche siriane che l America voleva scaricarci in Albania quelle che ora transitano a Gioiatauro	1	
#Cile,	Cileno 
#Germania,	Tedesco
2800 posti di Lavoro in Germania Previsto un corso di Tedesco per imparare la lingua	3	
Questo stesso tuo lavoro lo faccio anch io dalla Germania , essendo la Basilicata terra sconosciuta per il popolo Tedesco  .	2	
12 Gran Premio di Germania Hockenheim Unica pole Vinta sul campo , Hamilton blocca all'ultimo tentativo e il Tedesco con un bel giro strappa la pole  .	1	
2800 posti di Lavoro in Germania E previsto un corso di Tedesco per imparare la lingua	1	
Angela Merkel le consiglio il nostro Ex Primo Ministro Mario Monti per ridare linfa vitale alla Germania , vedrete come sara felice il popolo Tedesco  .	1	
Antonio , vederti vincere due manche in Germania , e tutte due le volte andando a prendere un Tedesco al comando , fa un gran bene al cuore  .	1	
Beh anche in Germania hanno l'euro ma stanno bene perche loro non sono ladri , ovvero il Tedesco non e LADRO come l'Italiano  .	1	
Beh in Germania c'√® Money Boy , il Bello Figo Tedesco	1	
Cerca su Google Debito pubblico Tedesco secondo l Universit√† di Friburgo In Germania  !	1	
Certo , stai attento a ci√≤ che dici P se ti annoi cos√¨ tanto vieni ad aiutarmi con Tedesco che devo prepararmi bene che a Novembre vado in Germania  !	1	
Godersi le gemme Settembre , 2012 Ad Idar in Germania c √® il museo Tedesco delle Gemme  .	1	
Il Marco Tedesco Elettronico Si discute molto della prominente posizione finanziaria della Germania nell UE , un argomento ricorsivo √® che la Germania sta sostenendo la gran parte del prestito per aiutare paesi come la Grecia nel sud  .	1	
In Germania anche i bambini sanno parlare il Tedesco  .	1	
In Germania esiste da 15 anni e il Governo Tedesco incassa decine di miliardi di euro l'anno  .	1	
Invece di piangere a dosso ad essere razzista io da Italiano sono in Germania per lavoro lei pensa che il cittadino Tedesco e contento che gli caccio un posto di lavoro , voi tutti siete responsabili ci avete cacciato dalle nostre case , voi pensate che c e gente che crede alle vostre lamentele , se avete probblemi sul razzismo portatevi i connazionali nell paese con un lavoro che paga le tasse e dorme nel suo letto nella propria casa  .	1	
L archeologo tedesco Klaus Schmidt dell Istituto Archeologico Tedesco di Berlino in Germania , con il supporto dell ArchaeoNova Institute di Heidelberg , sempre in Germania , ha condotto lo scavo di questi preistorici circoli megalitici scoperti in Turchia  .	1	
La Merkel fa giustamente gli interessi della Germania e questa √® una buona cosa per ii popolo Tedesco  .	1	
La guerra dovrebbero farla i capi di stato e risparmieremo tante vite umane , esempio Italia contro Germania il capo Italiano contro il capo Tedesco , massimo tre aggiunti cio√® i presidenti del consiglio di camera e senato e chi vince ha vinto e basta , fine della guerra  .	1	
Lavoro per Infermieri in Germania , con corso di Tedesco	1	
Ma io che vivo in Germania l'ho visto su Sky Tedesco  !	1	
Ma povero Pastore Tedesco , √® l'unica cosa buona che viene dalla Germania  .	1	
Non lo evita nessuno alla Germania di staccarsi dall'Europa e fare la Russia Tedesca assolutamente nessuno solo il popolo Tedesco avrebbe un grosse problema	1	
Non penso che il protagonist del video , che alcuni insultano , stia criticando l'italia sputando nel piatto dove mangia a parte che lui mangia nel piatto Tedesco visto che vive in Germania  .	1	
Non solo l'lIitaliano , io che vivo dal 1970 in Germania vi posso assicurare che anche il Tedesco subisce continui cambiamenti  .	1	
Poco tempo prima , in Germania , il gruppo parlamentare Die Linke aveva presentato al Parlamento Tedesco , il Bundestag , una proposta per il riconoscimento dell'accesso all'acqua come diritto universale dell'uomo , con lo scopo di riconoscerne l'immenso valore ed inibirne la privatizzazione , un po com'√® successo in Italia con il Referendum per l'Acqua Pubblica del 2011  .	1	
Se conoscessi il Tedesco andrei a vivere in Germania  .	1	
Segnalo 2 fatti analoghi accaduti in Germania 1 Il ministro della difesa Tedesco e candidato alla Cancelleria Rudolf Scharping si dimise e scomparve politicamente per aver visitato a Palma de Malorca la Sua fidanzata con un aereo militare  .	1	
Si tiene oggi la giornata di studi Un secolo di rappresentazioni nazionali Il Padiglione Germania alla Biennale di Venezia , organizzata dal Centro Tedesco di Studi Veneziani presso Palazzo Barbarigo  .	1	
Stormy , ma il commento dove diceva che se fosse nato in Germania non saprebbe il Tedesco , non √® un repost  ?	1	
Strano , sono italiano abito da anni in Germania , ho due figli con passaporto Tedesco essendo nati qui  .	1	
Telegraph Il Modello Tedesco √® Fallimentare per la Germania e Letale per l Europa Ambrose Evans-Pritchard del Telegraph commenta ferocemente la scoperta recentemente pubblicata sullo Spiegel che il modello tedesco non solo √® disastroso per il resto del mondo , ma dannoso anche per la stessa Germania ; fa anche un opportuno riferimento al gigantesco problema della dinamica demografica tedesca  .	1	
Un medico Tedesco replica noi invece in Germania trapiantiamo i testicoli da un uomo ad un altro , e dopo solo tre settimane , gi√† √® in cerca di un lavoro  .	1	
allora Io che abito in Germania ti do delle statistiche del Welt Online giornale Tedesco sulle compere di armamenti della Grecia , Francia 876 Milioni di Euro , ITALIA e Olanda 53 Milioni di Euro , GERMANIA con 35 , 8 Milioni di euro  .	1	
che non possiamo fare pagare alla Germania condividendo con essa la stessa moneta dentro l'euro c'√® il forte Marco Tedesco  .	1	
in Germania qualunque sia stata la tua retribuzione , la pensione massima erogata dalla stato Tedesco e di 2800 Euro netti al mese  .	1	
perch√© vi ricordo che se il Duce non si allevava con la Germania nazista e non attuava le leggi razziali , il Reich Tedesco ci avrebbe invaso  .	1	
premetto che io Sammers non lo conosciuto come giocatore nel 96 ero piccolo anche se non troppo XD ma seguivo solo il calcio italiano ansi a dirla tutta solo la Juve heheh pero sto facendo una piccola ricerca nel 96 Sammers Fu classificato il Miglior giocatore Tedesco vinse gli europei con la Germania in inghilterra segnando 2 goal e leggo solo ora che era Difensore mentre del piero in nazionale quel anno fece poco e nulla pero vinse con la juve  .	1	
pu√≤ essere perch√® la denominazione Tedesco per indicare gli abitanti della Germania deriva dal latino Teutescum Teutone  .	1	
sono 40 anni che sono in Germania e il governo Tedesco mi ha sempre trattato con i guanti Bianchi  .	1	
s√¨ ma lo Stato Tedesco se lo pu√≤ permettere visto che la Germania NON E ABITATA DAGLI ITALIANI  .	1	
tutto cio'vi fa Onore , Certo anche in Germania ce la crisi , ma da cio'che vedo , lo stato Tedesco non fa pesare tutto sulla popolazione , cio'che in Italia lo stato ed gli Amministratori fanno il contrario  .	1	
tutto vero ricostruzione veritiera , ma il vero nocciolo della questione , la madre di tutte le domande che vorrei fare a questi economisti √® Perch√© abbiamo pagato un euro 2000 lire se poco prima pagavamo un marco Tedesco a meno di mille lire , √® perch√© e stato concesso alla Germania il cambio alla pari  ?	1	
√â la Germania e il popolo Tedesco che deve chiedere perdono alla mia famiglia finita l√¨ , a Dio e a tutti gli esseri umani per le bestialit√† da loro commesse , Dio non centra  !	1	
#Austria,	Austriaco 
Adolf HITLER era Austriaco , e infatti i peggiori campi Concentramento gli ha fatti costruire in Austria , a poca distanza da dove aveva vissuto  .	1	
Le riserve auree della Oesterreichische Nationalbank OeNB nel Regno Unito e in Svizzera sono un tema ricorrente nelle discussioni politiche soprattutto ora che il Partito della Libert√† Austriaco ne richiede un trasferimento in Austria , su esempio della Bundesbank tedesca che vuole rimpatriare tutto l oro entro il 2020  .	1	
Mmmmm ma il lago di Resia non √® in Altoadige vicinissimo al confine Austriaco sulla strada cha dalla Val Venosta porta a Landeck in Austria  ?	1	
#Italia,	Italiano
A differenza dell Italia e della maggioranza del Popolo Italiano completamente Italiota  .	7	
Alcuni deputati m 5s grazie alle prerogative di Senatore sono riuscite ad ispezionere l Oro della Banca d Italia in teoria 2451 tonelate scoprendo le seguenti cose 1 Circa 1200 tonnelate di Oro Fisico Italiano sono custodite nella sagrestia di Banca d Italia in via Nazionale  .	3	
Dopo un tour Italiano con pianista Delmar Brown in 1987 , si stabilisce in Italia  .	3	
In pista anche il Campionato Italiano Corse Pony Trotto con gli allievi futuri driver della Scuola Corse Pony Trotto Italia  .	3	
Ti chiederai perch√© dovresti pubblicarlo Cara Barbara Perch√© sei una delle 2 persone in Tutta Italia che ha la capacit√† di far capire al popolo Italiano con quel tuo modo di essere cosi semplice e convincente nello stesso momento  .	3	
non vi siete accorti cosa ha fatto Alibaba , ha messo centinaia di migliaia di links sui suoi siti tradotti in Italiano con traduttori automatici in modo che qualsiasi ricerca di prodotto in Italia va su aliexspress o alibaba con risultati in prima fila	3	
@uxilia Italia e il Comitato Italiano Progetto Mielina con i soci Bianca Bartolini e Mauro Volpatti hanno sostenuto economicamente e materialmente Ayman un bambino affetto da Adrenoleucodistrofia  .	2	
Chi vuole essere aggiornato su cosa fa l Esercito Italiano , sulle missioni internazionali e le operazioni in Italia , le attivit√† in primo piano , lo sport ed i concorsi potr√† scaricare sul suo Tablet o smartphone l applicazione NewsEI  .	2	
Come tutti frequenta i corsi obbligatori d Italiano e grazie all ottimo lavoro di Oxfam Italia e del Quartiere 5 , frequenta anche corsi e occasioni d incontro e formazione extra  .	2	
Ecco il fenomeno dei falsi residenti stranieri , molto diffuso , che sfrutta una legge vergogna che permette a chi non √® Italiano e non ha mai lavorato in Italia , di percepire la pensione sociale per il solo fatto di risiedervi ed essere over 65  .	2	
Eletto nella XVI legislatura deputato del Popolo delle Libert√† , in precedenza era stato senatore e aveva fatto parte del Partito Socialista Italiano , del Patto Segni e di Forza Italia  .	2	
Grazie ai deputati M 5s abbiamo finalmente saputo dov'√® custodita la riserva aurea Circa 1200 tonnelate di Oro Fisico Italiano sono custodite nella sagrestia di Banca d Italia in via Nazionale le restanti 1200 tonnelate sarebbero conservate da qualche parte fra Svizzera , Stati Uniti e Inghilterra  .	2	
Io come la vedo direi di prendere un po la decisione in mano , andare tutti gli Italiani a palazzo Chigi e farli smettere di farci prendere per il culo , mettere chi ci riteniamo giusto per portare una contabilit√° avanti , riprendere ci√≥ che √© nostro di diritto , abbattere le banche del vaticano e riprendere l'economia Italiana , banche ed altre funzioni che vengono finanziate dallo stato Italiano devono diventare autoname , diminuire le province in Italia per un rientro di bilancio annuale  .	2	
L Italia non sar√† mai un paese civile fintanto che lo Stato Italiano non tuteleranno le donne vittime di stalking  .	2	
La GasGas Italia √® presente all'ultima prova di Campionato Italiano Enduro Major a Fabbrica Curone AL il 07-08 Settembre  .	2	
La filiale italiana di Infront ha attualmente in mano il calcio italiano √® Advisor della per la commercializzazione di tutti i diritti media nazionali ed internazionali dei campionati italiani di calcio di Serie A e B , Coppa Italia , Supercoppa Italiana e Campionato Italiano Primavera  .	2	
La seconda tipologia √® quella all inclusive , con tutte le gare che si giocheranno al Palaverde nella prossima stagione , Campionato Italiano con tutti i play off , finali incluse , Coppa Italia e anche tutta la Coppa Cev , la competizione europea che vedr√† protagonista le Pantere  .	2	
Live Campionato Italiano Enduro Major Fabbrica Curone AL , GasGas Italia Presente  !	2	
Mi chiedo ma ho votato in Italia per il rinnovo per il Parlamento Italiano  ?	2	
Non sei in Italia , ma cerchi un buon libro in Italiano su Roma  ?	2	
Qualsiasi minoranza , da qualsiasi luogo , se vuole vivere in Italia , per lavorare e mangiare in Italia , dovrebbe parlare l Italiano e dovrebbe rispettare le leggi Italiane  .	2	
Tutti i settori industriali strategici sono in mano alla Stato , proprio come in Italia negli anni 50 , al tempo del boom economico , quando in Italia si stava davvero bene e si parlava di Miracolo Italiano  .	2	
net OGGETTO LETTERA DI UN APPARTENENTE ALLE FORZE DELL'ORDINE Signori a voi che rappresentate Il Popolo Italiano scrivo questa lettera perch√© avete la resposabilit√† di ci√≤ che sta accadendo in Italia  .	2	
siamo a X factor Italia ma non vedo molto di Italiano nella competizione  .	2	
, azienda leader in Italia nel settore della produzione e distribuzione di farmaci di origine biologico-naturale , ha aderito al progetto di Assolombarda Codice Italiano Pagamenti Responsabili , il primo codice in Italia dedicato specificamente al tema della regolarit√† nei pagamenti corporate  .	1	
00 ospiter√† 150 atleti da tutta Italia per il Campionato Italiano Iksa di Mma	1	
1 Supercoppa Italiana , 1 Campionato Italiano , 1 Coppa Italia , 1 CHAMPIONS LEAGUE , Uomo assist Champions League 2009-2010 , Miglior Centrocampista Champions League 2009-2010 , Scarpa di bronzo ai Mondiali 2010 , Pallone d'Argento ai Mondiali 2010 , All-Start Team mondiali SNEIJDER  .	1	
12 anni in Italia e l'arricchitore culturale musulmano @DialloA11959260 ci mostra l'eleganza del suo Italiano	1	
1975 In Italia nasce ufficialmente il Fondo per l'Ambiente Italiano FAI	1	
1993 1975 In Italia nasce ufficialmente il Fondo per l Ambiente Italiano	1	
2 Italian Trophy , i concorrenti della Porsche Carrera Cup Italia , le vetture del Campionato Italiano Sport Prototipi , il Trofeo Abarth Europa/Italia e la promettente Euro Series  .	1	
28 francesca e i suoi proverbi sbagliati , in Italia , in lingua originale parlava in Italiano	1	
3 ore di coda padiglione Italia √® avuto un p√≤ di delusione con quello Italiano mi aspettavo qualcosa in pi√π , ma quello Zero √® bellissimo  .	1	
4 Qualsisi Cittadino Italiano e Non che abbia Operato in Italia per il Bene Comune , in qualsiasi Attivit√† , ed abbia Procurata Occupazione , sommata per per i numeri relativi di occupati , per ciascuna annualit√† , sommati per gli anni complessivi di attivit√† , occupazione uguale o a pi√π di 1 Milione di persone , o prodotto Ricchezze negli Anni per Importi di PIL uguali o superiori a 10 Miliardi di Euro , Spetta la Nomina di Senatore a Vita  .	1	
500 karateki in rappresentanza di oltre 150 squadre provenienti da tutta Italia , si daranno battaglia al Palatennistavolo per il sesto Campionato Italiano e la Coppa Italia di	1	
517 Giusy e Luigi Per tutti coloro che presenteranno lo screen di quest offerta riceveranno in regalo tour guidato in Italiano della citt√† di BANGKOK solo da noi tante offerte strepitose e con corso Italia 61	1	
@Davide MARELLI , in Italia si deve parlare Italiano perch√® non tutti i cittadini parlano il dialetto di questa o quell'altra regione  .	1	
@raffaellagia No , non sono Italiano , solo vivo in Italia  .	1	
@redazioneiene mander√† in onda su Italia 1 il 30 novembre un ampio e importante servizio sul mondo arbitrale Italiano  .	1	
@robertastratta Ho imparato un po di Italiano dalla mia sorella che stava in Italia	1	
@sansirosdream @momalucilla okay tutti salva tutto ma cavolo devi dire una cosa in Italiano e l'unica cosa che non riesci a leggere √® Italia	1	
A Waze Italia , e ce la fai a parla Italiano  ?	1	
A X Factor Italia √® giusto che vinca Eva , l'unica con un brano in Italiano  !	1	
A causa di questo macroscopico errore di valutazione nel 2012 √® stato approvato dal Parlamento Italiano il decreto Salva Italia con la tanto vituperata Riforma Fornero sulle pensioni  .	1	
A dare ulteriore lustro alla due giorni , la presenza del Vice Presidente Nazionale Ferrari Club Italia , Tony Camassa nonch√© Campione Italiano Assoluto 2015 su Ferrari 599 F 1 nel Trofeo Ferrari Club Italia McStone , oltre a Alessandro Adriani , Presidente del Porsche Club Puglia  .	1	
A denunciarlo sono nove associazioni ambientaliste Club Alpino Italiano , CTS Centro Turistico Studentesco e Giovanile , Federazione Nazionale Pro Natura , Italia Nostra , Legambiente Onlus , LIPU , Mountain Wilderness International , Touring Club Italiano e WWF che chiedono un'azione immediata al ministro dell'Ambiente  .	1	
A mio modesto avviso Aguero non √® all'altezza e mi rimane davvero difficile credere che in Italia non ci sia un pilone Italiano , migliore di lui  !	1	
A partire dal 2006 ricopre la carica di Delegato Italiano per la Propriet√† Intellettuale , rappresentando l Italia nel Consiglio di amministrazione dell'Organizzazione europea dei Brevetti EPO  .	1	
A stranieri albanesi , marocchini , ecc che hanno oltre 65 anni d'et√† e si sono ricongiunti in Italia a parenti , senza aver mai lavorato e versato contributi lo Stato Italiano da l'assegno sociale pari a 448 Euro mensili  .	1	
A un mese dal che ha colpito il centro Italia , il FAI- Fondo Ambiente Italiano dopo aver stanziato un fondo straordinario per l'avvio dei lavori , lancia una raccolta fondi finalizzata al recupero dell'intero edificio e del ciclo di affreschi che custodisce dal XVI secolo  .	1	
#Norvegia,	Norvegese
Adoro la Svezia e Norvegia , ma senza sapere un H dello Svedese o Norvegese non credo siano mete possibili  .	1	
Guardia Norvegese Ecco come le guardie in Norvegia dissuadono i malintenzionati  !	1	
Il suo autore , il regista norvegese Lars Klevberg , lo ha realizzato con i soldi dell Istituto Filmico Norvegese ed il Consiglio delle Arti della Norvegia  .	1	
#Svizzera,	Svizzero
Novit√† per Formaggio Svizzero le ragazze di Donnavventura stanno intraprendendo un viaggio in Svizzera alla scoperta dei suoi buonissimi formaggi  .	2	
8 Salone Internazionale Svizzero delle Vacanze- Lugano TI , Svizzera	1	
@olioextravergin La sede di Svizzera Turismo in Italia √® presso il Centro Svizzero in Via Palestro 2 a Milano , ma non √® aperta al pubblico  .	1	
A domani-Da settimana prossima , la regia di Asganaway sar√† fatta da Matteo Renzi-Pitbull purtroppo non ha confermato la sua presenza a Sanremo-Le orecchie sensibili , in Svizzera , si chiamano orecchie a dumbo-Il tema di quest anno del Carnevale Svizzero √® Galileo Galilei-Una volta , i maschietti si arrapavano con i peli delle ascelle	1	
Anche se da Svizzero tifavo la mia Svizzera che mi ha reso fiero e orgoglioso comunque sia andata	1	
BEATO lui che ti tiene vicino in quel momento Michelle ehhh vero la Svizzera e la nazione dello Svizzero e del formaggio a me infatti piace molto lo Svozzero e l'Emmentaler che fai pubblicizzi anche in cucina Michelle fai la conduttrice di cucina allora qui sei veramente bella mi piaci buonpomeriggiooo a te e allo Chef	1	
Bastardi truffatori , ancora un motivo in pi√π per vivere in Svizzera e appena ho il passaporto Svizzero quello italiano gli faccio la cacca di sopra e lo mando al consolato italiano che se lo mettono in un bel quadro  !	1	
Buongiorno , oggi h 18 all'Istituto Svizzero di Roma L'importanza di essere Svizzera intervengono Caracciolo , Maurer  .	1	
Cittadino Svizzero che paga le tasse in Svizzera ,  .	1	
Domani pomeriggio all'Istituto Svizzero di Roma alle 18 presentiamo il volume L'importanza di essere Svizzera	1	
Gente in coda anche per il Centro Svizzero di Milano , dove hanno sede le principali istituzioni che rappresentano la Svizzera nel capoluogo lombardo , un rapporto consolidato dalla recente nascita di FAI SWISS , fondazione volta a sviluppare i legami tra la cultura italiana e quella svizzera	1	
Il museo alpino Svizzero si trova a BERNA , capitale della Svizzera  !	1	
Il signore De Benedetti , cittadino Svizzero , che paga le tasse in Svizzera , non rompesse le palle in Italia  .	1	
In Svizzera sarebbe obbligatorio un Referendum popolare Il modello politico Svizzero e le sue similitudini con quello che porta avanti il M 5S  .	1	
L eleganza della Moda Svizzera sfila con successo nella Roma Imperiale Ambasciatore Svizzero in Italia Gian  .	1	
L importanza di essere Svizzera verr√† presentato luned√¨ alle 18 all'Istituto Svizzero di Roma qui l'anteprima	1	
La differenza fra Roma e Torino √© semplice , Torino √© molto pi√∫ vicina alla Svizzera , e i cittadini preferiscono l'ordine civico Svizzero e contribuiscono a rendere Torino pi√∫ bella e ordinare  .	1	
Sempre di pi√π dobbiamo VOLERE il modello Svizzera Il modello politico Svizzero e le sue similitudini con quello che porta avanti il M 5S  .	1	
Sul Lago Maggiore , con vista sulla Switzerland Schweiz Suisse Svizzera mangiando un Formaggio Svizzero  !	1	
Un Svizzera c'√® il Franco Svizzero , non l'Euro	1	
X-Bionic Cup nasce dalla collaborazione tra , la ASD Emporio sport Team , una societ√† sportiva estremamente dinamica nella organizzazione di gare di MTB e il marchio Svizzero X-BIONIC , abbigliamento sportivo tecnico funzionale , prodotto in Italia e sviluppato in Svizzera da X-Technology  .	1	
ma come si chiama il personaggio Italofobo che si trovava in Svizzera per curarsi e togliersi di dosso l'Italianit√† e finalmente diventare Svizzero a tutti gli effetti personaggio attualissimo  .	1	
ma parla da cittadino Svizzero o da Italiano che porta i soldi in Svizzera  ?	1	
qui √® Livigno non √® la Svizzera , la svizzera ha il Franco Svizzero non l'euro  .	1	
#Malta,	Maltese
@crasicap Questi e chiaro , ma perche una Ong che sembra Maltese tipo Moas non li porta a Malta ma sempre in Italia  ?	1	
Corto Maltese nasce il 10 luglio 1887 a La Valletta Malta	1	
During this trip to Malta , the symbol that will stay with me is the typical Maltese balcony super colourful , which makes it perfect to look out from without being noticed  .	1	
E da Malta Il Milied it tajjeb lil kulhadd ; per chi e curioso questo e Maltese	1	
Grazie per MASSIMO Ranieri e davero bravo kwello ragazzo da Malta qui awguri da tutti Maltese	1	
Il ministro dell'istruzione Maltese Evaristo Bartolo , l'ambasciatore italiano di Malta  .	1	
Il sistema fiscale Maltese e la formazione di societ√† Maltesi Strutturando I tuoi interessi commerciali tramite Malta info @wdm  .	1	
Ira Losco in gara a Eurovision per Malta con Walk on water il consiglio del governo Maltese ai migranti che cercano asilo  .	1	
Maltese Falcon live in Valletta Malta  .	1	
Maltese parliament Valletta , Malta	1	
Perch√© il MOAS , Maltese raddoppia le miglia e porta in Italia se Malta si trova a met√† strada  ?	1	
Perch√© li portano in ITALIA e non li portano in EGITTO , TUNISIA , FRANCIA , SPAGNA , ISRAELE , TURCHIA , GRECIA e perch√© hanno bandiera Maltese e non li portano a Malta  ?	1	
Qualcuno ritiene che se un Dobermann nasce a Malta diventer√† un cane Maltese  .	1	
This is Malta then Comino and Gozo , the Maltese islands  .	1	
Tuttle le bambini sono molto molto bravi , sto guardando da Malta , saluta Francesca la bambina Maltese e anche il suo compagno di canto , buona fortuna	1	
Votate la canzone Maltese Emma sei grande saluti da Malta xx	1	
siamo Maltese e vi segua tutte le sere da Malta  .	1	
#Israele,	Israeliano
Il Sudafrica ha mandato via quello Israeliano e il Chile ha interrotto i rapporti economici con Israele  .	2	
Alfonso Torregrossa- Direttore Tecnico-Maestro diplomato presso il Collegio di Stato Israeliano ICSI Israeli College for Security and Investigations , riconosciuto in Israele dal Ministero dello sport  .	1	
Clinton si definiscono preoccupati e molto altro , concordata e organizzata insieme dagli avvocati del diavolo il governo Israeliano attuale che i tifosi di Israele hanno messo in scena  .	1	
Dopo la formazione dello stato di Israele , il governo Israeliano chiese formalmente ad Imi di sviluppare un sistema efficace di difesa personale e di combattimento  .	1	
Furono quelli che dirottarono l'ho aereo Israeliano in Uganda , Israele compi un incredibile raid per liberare gli ostaggi  .	1	
Hamas sono in parte terroristi e a tante frangenti arabe piacerebbe una scomparsa di Israele , al governo Israeliano interessa solo magari riuscire a cancellare la Palestina e beccarsi i territori  .	1	
In Israele nessuno vuole fare questa guerra , salvo quei 4 esaltati sionisti al Governo Israeliano , e qualche loro propagandista in giro per il web  .	1	
L Onorevole Capezzone pu√≤ trovare , volendo , un elenco abbastanza completo di personalit√† ebraiche non allineate con lo Stato Israeliano in Ebrei contro Israele di Giulio Meotti del Foglio  .	1	
Lo Stato Israeliano ha una composizione simil fascista , tenendo conto delle Leggi Razziali che vigono per esempio un Israeliano Ebreo , anche se emigra e non torna mai pi√π resta cittadino per sempre , un Israeliano Musulmano invece se resta pi√π di un anno fuori da Israele perde la cittadinanza  .	1	
Napolitano chi , il Presidente della Repubblica Israeliana , che la Giornata della Memoria , assieme al Presidente della Knesset Gianfranco Fini , a quello del Senato Renato Schifani , e al Premier Israeliano Silvio Berlusconi ha trasformato in giornata di Israele  ?	1	
Nel 1982 , Oded Yinon , un giornalista Israeliano un tempo legato al ministro degli esteri d Israele , ha pubblicato un articolo intitolato Una strategia per Israele negli anni 80  .	1	
Nota Gaza NON E Israele , West Bank NON E Israele , loro non vogliono stare con Israele e la maggior parte dei cittadini vuole sterminare gli ebrei e lo stato Israeliano Ciliegina sulla torta la corte suprema israeliana e una delle tante organizzazioni dove si trovano arabi cristiani o palestinesi come nelle universita e l'esercito  .	1	
R Il Presidente Obama √® stato definito dal Primo Ministro Israeliano Netanyahu e dalla Lobby Ebrea come tiepido amico d Israele , perch√© ancora non ha sferrato nessun attacco militare all Iran  .	1	
Simone Camilli √® morto in Palestina durante il disinnesco di un ordigno Israeliano , fosse morto in Israele durante il disinnesco d'un ordigno Palestinese il titolo sarebbe stato certamebte diverso  .	1	
non e giusto a Israele ma al governo Israeliano o agli Ebrei di Israele  .	1	
#Moldavia ,	Moldavo
#Colombia,	Colombiano
Sii Te Siientes Orgulloso De Ser Colombiano Dale Like A Esta Pagiina I Lov√© Colombia UNETE ES GRATIIS	8	
Sii Te Siientes orgulloso De Ser Colombiano Dale Liike A Esta Pagiina I Lov√© Colombia UNETE ES GRATIIS	5	
Sii Te Siientes orgulloso De Ser Colombiano Dale Liike A Esta Pagiina I Lov√© Colombia UNETE ES GRATIIs	3	
Sii Te Siientes orgulloso De Ser Colombiano Dale Liike A Esta Pagiina I Lov√© Colombia UNETE ES GRATTIIS	3	
@williamreydetodo el es de Colombia , es nuestro Niall Colombiano	1	
Colombia , Orgulloso de ser Colombiano	1	
Colombia 0 18 likelo Si Es Colombiano	1	
Colombia 1- Argentina 1 pasa Colombiano con penaltis	1	
Colombia Ahh Soy El √önico Colombiano	1	
Colombia El Que Sea Colombiano Dele Like D	1	
Colombia Ser Latinoamericano es un orgullo Pero Ser Colombiano Es Un Premio  .	1	
Colombia es Colombia , 100 Orgullosamente Colombiano	1	
Colombia es Colombia y orgulloso de ser Colombiano pero esta vez apoyando a Alemania  .	1	
Colombia que IU Promocione el cafe Colombiano 3	1	
Colombiano , colombianos , Colombia  .	1	
Colombiano , una dama , la miss universo de Colombia para siempre	1	
Colombiano que se respete se refiere a Colombia como la tierrita	1	
Conoce la historia de Yoreli Rinc√≥n , la 10 de la Seleccion Colombia y actual campeona del f√∫tbol sueco Orgullo Colombiano  !	1	
Delicious Pan de Bono Amasijo Colombiano Maria Alejandra Gourmet Bogot√° Colombia	1	
Emblema Colombiano lindo orgullo de Colombia	1	
Estetica con un gran Colombiano Edson Cortes , I Congreso SOLA , Eje Cafetero Pereira- Colombia  .	1	
Felicidad en Colombia , Catherine orgullo Colombiano  !	1	
Feliz d√≠a Colombia helic√≥ptero Orgulloso de ser Colombiano	1	
Forza Atleti Soy Colombiano Pero Th Sigo A Voz Vamoz Colombia	1	
Gano Argentinaaaa , al fin D , Si Wilson fuera Colombiano ahi si que nos golea Colombia ZebazPvD YT xD	1	
Genial junto a un super Colombiano , que viva Colombia  !	1	
Independiente Santa Fe 1948 Primer Campe√≥n de Colombia 2015 Primer Campe√≥n Colombiano de la Copa Sudamericana	1	
Instituto Colombiano de Bienestar Familiar ICBF Profamilia Colombia	1	
La Hechicera √® un Rum Solera di grande fascino che in solo due anni dal suo lancio √® riuscito a diventare il Premium Rum Colombiano pi√π venduto in Colombia	1	
La belleza de el paisaje Colombiano no tiene comparaci√≥n ; te amo Colombia  .	1	
La mi citt√† che confina con la Colombia , sarebbe la prima a pagare le conseguenze di un eventuale attacco Colombiano  .	1	
Made in Colombia , Jackson Martinez , Orgullo Colombiano  .	1	
Madre in Colombia de raza mandaca q orgullo de ser Colombiano  .	1	
Me volvio el orgullo de ser Colombiano , pasamos de ser pura coca a ser pura Copa , Viva Colombia  !	1	
Museo del Oro , Bogot√° , Colombia Muisca , arte pre-Colombino Tesoro nacional , patrimonio Colombiano Gold Museum , Bogot√° , Colombia Muisca gold raft with chief and attendants  .	1	
Nebuloni apoyando de nuevo el cine Colombiano , una pel√≠cula por la paz de Colombia  .	1	
No soy Colombiano , pero follenselos a esos Chilenos de mrd Vamos Colombia  .	1	
No soy Colombiano pero Latinoam√©rica con Colombia  .	1	
Orgullo Colombiano 3 Saludos desde Colombia 3	1	
Orgullosamente Colombiano A La Verga Los Demas Colombia Manda	1	
Orgullosamente Colombiano Grande Mi Seleccion Colombia	1	
Orgullozamente Colombiano jajaja y no difamen A Colombia pirobos	1	
Pero Dime De Que Equipo Colombiano Viene Del Mejor De Colombia  !	1	
Pinche Colombiano mejor que sevaya acomer arepas a Colombia	1	
Q pasa con Colombia lo viol√≥ un Colombiano malparido	1	
Que Gane Colombia Like Si Eres Colombiano D	1	
Que Viva Colombia , Soy Venezolana pero de Padre Colombiano , y Amo a ese Pa√≠s , Que Viva Colombiaaaaaaaa	1	
Que rico que te sienta muy Colombiano que viva nuestra Colombia linda	1	
Reportando me desde Bogot√° Colombia , un coso Colombiano	1	
SUdado de carne con papa un almuerzo tipico Colombiano que rico es Maggi El Sabor a Colombia	1	
#Bulgaria,	Bulgaro
#Macedonia,	Macedone 
Grande Vardare campione Macedone viva Vardar viva Macedonia nell mio cuore 3 3 3	1	
Io sono Macedone , prima di tutto in Macedonia ci sono etnie diverse con la maggioranza di Cristiani Ortodossi  .	1	
solo che la Macedonia e in Grecia , vedi Alessandro il Macedone	1	
#Croazia,	Croato
#Danimarca,	Danese
Danimarca non ha l'Euro , ma la corona Danese e pegged all'Euro con una variazione massima , dalla nascita dell'Euro ad oggi , dello 0  .	1	
Finalmente dopo 70 anni ecco uno che si toglie il bavglio dalla bocca , in una lettera sul quotidiano Danese fyns Stiftidende , il signor Rasmussen chide che sia tempo che altri si tolgano il bavaglio e non abbiano paura di parlare , di cio che da parte Danese , fu fatta passare , e per 70 anni come l , invasione della Danimarca da parte Tedesca , e perche furono fatti ammazzare qualche giovane soldato Danese , e per quale misteriosa ragione prima di reagire gridarono ma perche ci sparate addosso  ?	1	
Il Partito Musulmano Danese afferma che la Danimarca sar√† la prima nazione musulmana d'Europa  .	1	
Invece il Partito Popolare Danese l ha spuntata la Danimarca sospende il trattato di Schengen e reintroduce i controlli alle frontiere  .	1	
#Islanda,	Islandese 
Stanno cercando il Petrolio nel Mar del Nord , ma senza esito e non vogliono restare a far parte della Danimarca e dell'UE perch√© parlano una loro lingua il cui alfabeto √® quello Islandese e perch√® non si sentono legati all'Unione Europea , ma alla Islanda  .	1	
#Francia,	Francese
We pu√≤ aiutare in diversi settori , tra cui Prestito finanziario , Home Loan , Prestito Investimento Prestito auto , consolidamento del debito , linea di credito Seconda ipoteca , rifinanziare credito prestito personale Offerta valida per tutti i paesi e tutte le persone abitanti dell'isola di Mauritius , Francia , Martinica , Guadalupa , Reunion , Guyana Francese , Cayenne , Mayotte , Nuova Caledonia e Polyn√©sie  .	7	
00 , nell Aula Magna del Rettorato dell Universit√† di Torino sar√† organizzata in collaborazione con l Universit√† Italo Francese e l Institut fran√ßais Italia e nell'ambito dell'anno della Francia a Torino Torino incontra la Francia , una giornata d informazione per presentare a neodiplomati , studenti , genitori e docenti , l'offerta formativa universitaria francese e le modalit√† per facilitare la mobilit√† degli studenti italiani verso la Francia  .	1	
14 luglio 1789 l inizio della Rivoluzione Francese Il 14 luglio , festa nazionale in Francia , si commemora l assalto del popolo il cosiddetto Terzo stato alla fortezza parigina della Bastiglia , episodio assunto convenzionalmente come inizio della Rivoluzione Francese  .	1	
@micheleboldrin @Forchielli Io comunque sono nato in Francia , ma non mi sento Francese  .	1	
@vanessadv2001 @DiMarzio @ahmedsam001 @a42nno con tutte queste settimane in Francia neanche un tweet in Francese  !	1	
Blatter presidente della FIFA √® Francese e nel 2006 quando l Italia ha vinto i mondiali contro la Francia non ha neanche premiato gli italiani e casualmente l italia nel 2014 √® capitata nel girone pi√π difficile e la Francia qualificata ai mondiali con qualche aiutino nel girone pi√π semplice  .	1	
Con il Team Francese ci sposteremo in Francia e Spagna per allenamenti e test  !	1	
Con tutto il rispetto per la Francia e i Francesi ma che lingua di merda che √® il Francese  .	1	
Contrariamente alla credenza popolare , essa non fu intrapresa in nome degli ideali dell Illuminismo che animarono pochi anni dopo la Rivoluzione Francese , ma fu finanziata dal re di Francia e condotta per motivi religiosi al grido di Il nostro re √® Ges√π  !	1	
E la stessa faccenda della Parmalat alla Francia , e del 61 della Finanziaria Agos alla Francese Credit Agricole  .	1	
Ecco , questo √® un reportage fatto da Canal in Francia purtroppo √® solo in Francese  .	1	
Ed inoltre se vogliamo l'euro simbolo di unit√† la banca centrale europea deve poter emettere moneta sotto il controllo di un governo eletto dai cittadini direttamente o che gode della fiducia del Parlamento di Strasburgo , citt√† tedesca della Repubblica Francese , che simboleggia la pace tra Francia e Germania  !	1	
Francia compatta contro il jobs act alla Francese  .	1	
Harry √® in Francia e io non posso non riproporlo nella sua frase Francese preferita attraverso gli anni  .	1	
Hollande Francese e risalito nei vertici di gradimento di decine di milioni di Cristiani in Francia in Europa e nel mondo intero dopo la sua visita al Santo Padre Francesco e andato in Turchia e il miracolo in Siria si sono fermati i cannoneggamenti ed i bombardamnti Turchi ed Israeliani  .	1	
Ieri alla frontiera tra Francia e Italia non c'era nessuno ho un video Francese che lo dimostra  .	1	
Ieri ho provveduto a trasmettere al Console Generale di Francia a Milano ed al Presidente della Comunit√† Francese  .	1	
Il Capo dell Intelligence Francese avvisa circa il rischio di una Guerra Civile in Francia	1	
Il problema √® che le persone attribuiscono alla parola Illuminati un concetto sbagliato , ma non √® quello vero inizialmente gli illuminati sono nati in Francia , durante la Rivoluzione Francese , per cercare di abbattere la monarchia e instaurare un governo guidato da persone appunto illuminate dalla luce della ragione  .	1	
Il problema √® che se l aereo √® Francese ed √® partito dalla Francia , il cherosene lo dovrebbe scaricare sulla Francia e non sul Italia  .	1	
In Francia scoppi√≤ la Rivoluzione Francese per motivi meno gravi che nell'Italia di questi tempi  .	1	
In Francia ti assumono solo se sai parlare Francese  .	1	
In realta una volta in Europa furono i Re e principi , oggi sono i banchieri , se non si fa una rivoluzione tipo Francese , speranze non ci sono , perche l'Europa di oggi funziona come la Francia di Ludovico 15o	1	
Je anche rendere il vostro annuncio in altri negozi anche il mio entourage Offerta valida per tutti gli abitanti di persone nel mondo e ausi ITALIA , Francia , Martinica , Guadalupa , Reunion , Guyana Francese , Cayenne , Mayotte , la Nuova Caledonia e la Polinesia  .	1	
L Ente per lo Sviluppo del Turismo Francese promuove questo nuovo concorso che mette in palio soggiorni in Francia e prodotti Yves Rocher , Delsey e Orange L'iscrizione √® completamente gratis da qui	1	
La Francia , dalla Rivoluzione Francese in poi , √® sempre stata divisa in due anime in perenne lotta tra di loro quella tradizionalista e quella laica , accomunate entrambe dal nazionalismo e dalla smania di grandeur  .	1	
La Francia da sempre apre la strada alla nuova era , vedi la rivoluzione Francese  .	1	
La Rivoluzione Francese non cancell√≤ il colonialismo , ma anzi , permise alla Francia di consolidarsi come potenza coloniale  .	1	
Ma almeno capir√≤ meglio perch√© un Francese a convenienza a venire in Italia e viceversa un italiano la Francia la trova cara  .	1	
Mah , sar√° in Finlandia o forse Spagna , la Francia non credo proprio , quella scritta davanti √® tutto fuorch√® Francese  !	1	
Nel corso della guerra , gli abitanti della Guyana Francese cominciarono a ribellarsi contro le forze di Vichy governo filonazista instaurato in Francia durante la Seconda Guerra Mondiale  .	1	
Nel suo palmar√®s 1 Oro Olimpico Argentina , 2008 1 Campionato di Clausura San Lorenzo , 2007 1 Coppa Italia Napoli 2011 / 12 2 Campionati francesi PSG 2013 , 2014 2 Coppe di Lega Francese 2013-14 , 2014-15 2 Supercoppe di Francia 2013 , 2014	1	
Parole parole e basta compresa me bisognerebbe fare come in Francia con la Rivoluzione Francese  !	1	
Penso sia la foto pi√π rappresentativa del popolo Francese e di chi vive con la Francia nel cuore  .	1	
Per questo il suo ruolo nei processi di liberazione dei popoli del Terzo Mondo mette l'isola caraibica in un posto simile a quello che la Francia seppe occupare , dopo la Rivoluzione Francese , quale faro di orientamento per coloro che lottavano per scuotersi di dosso il gioco dell'assolutismo dinastico  .	1	
Pieve a Nievole PT , 15 aprile 2014- Si √® tenuto questo fine settimana a Rivesaltes il primo round del Campionato Francese di Supermotard , a sud della Francia , dove ha partecipato anche la giovane pilota del Team JK Racing , Juliette Berrez  .	1	
Questa √® da trip mentale perch√® sono effettivamente in Francia e qui tutto √® scritto in Francese , pure una pagina italiana √® stata apparentemente colpita dalla piaga  .	1	
Questa √® la Rivoluzione Francese e che se ne dica ha portato all'attuale Francia  .	1	
Questo filmato lo fatto ai nostri lupi in una riserva Francese sul confine Italiano tra Liguria Piemonte e Francia  .	1	
Questo sarebbe Francese perch√® nato in Francia  ?	1	
Ragazzi , cominciate a studiare il Francese tra molto breve l Italia sar√† ufficialmente proclamata colonia francese , amministrata dalla Francia per la gioia di Madame Carla Bruni  .	1	
Rivoluzione Francese Complesso degli eventi politici e sociali avvenuti in Francia tra il 1789 e il 1799  .	1	
Salve , dovrei ricevere un pacco dalla Francia che √® stato spedito come Lettre Recommand√©e Internationale il giorno 9 Dicembre 2013 , il codice di tracking sul sito Francese mi dice che ha lasciato la Francia il giorno 14 Dicembre  .	1	
Scusa la domanda , ma abiti in Italia o in Francia , sei Italiana o Francese  ?	1	
Siete grandi , in pi√π per me che vivo in Francia sentire una vostra canzone con parole in Francese mi fa un piacere immenso D  !	1	
Sono Francese e addolorata per la mia Francia  .	1	
Spero che il popolo Francese capisca e con dignit√† una risposta storica per la Francia e l'Europa intera  .	1	
Studia con me Rivoluzione Francese Costituzione del 91-&gt ; Divisione Francia in 83 dipartimenti-&gt ; Enti locali , eliminazione dogane	1	
Studio la Rivoluzione Francese del 1789 e penso a qualche anno prima , ai fatti accaduti in Francia e Scozia  .	1	
Voglio vedere te a stare 2 anni in Francia e vedere se riesci a parlare perfettamente il Francese	1	
#Colore,	Colori
Ci Sono Infinite sfumature Di Colore , Ma in Amicizia O In Amore Gli Unici Colori Sono Il Bianco o Il Nero  .	1	
La Notte con il Cuore e l'Anima che parlavano al Cielo ed al Mare si dissolve e lascia il posto ad un Alba del Colore d'Oro del sole che irradia Polvere di Infiniti Colori su Raggi che scivolano sull'Acqua come un Arcobaleno  .	1	
Notte con il Cuore e l'Anima che dialogavano tra di loro ed il Cielo osservava , il Mare ascoltava in silenzio , nella dissolvenza notturna sorge l Alba del Colore d'Oro del sole che irradia Polvere di Infiniti Colori su Raggi che scivolano sull'Acqua come un Arcobaleno  .	1	
Notte con il Cuore e l'Anima che parlavano al Cielo ed al Mare si dissolve e lascia il posto ad un Alba del Colore d'Oro del Sole che irradia Polvere di Infiniti Colori su Raggi che scivolano sull'Acqua come un Arcobaleno  .	1	
Notte con il Cuore e l'Anima che parlavano al Cielo ed al Mare si dissolve e lascia il posto ad un Alba del Colore d'Oro del sole che irradia Polvere di Infiniti Colori su Raggi che scivolano sull'Acqua come un Arcobaleno sprizzando Vita che scorre  .	1	
OFFERTA ABBIGLIAMENTO Giacca Nano Storm- JK PATAGONIA Taglie M-L Colori disponibili Arancione/Blu/Azzurro/Nero Jeans CRAZY Taglie M-L Colore  .	1	
Smettero di Vestirmi di Nero Solo Quando Inventeranno Un Colore Piu Scuro Freeday Mood Viva I Colori p  .	1	
#Sogno,	Sogni
Achille Togliani La Voce Di Sogno Per I Vostri Sogni Zeus Records Italy	1	
Dal Terrazzo dei Sogni , un Panorama da Sogno  !	1	
Dolci Sogni Meravigliosa Stephanie ti prego nn rovinare il mio bellissimo Sogno che sei tu sei la mia gioia di vivere ho solo te come riferimento x il mio cuore  .	1	
Ed il mio Sogno √à realizzare tutti i miei Sogni  .	1	
Io pure Sogno tanto ad occhi aperti non mi crederete , ma mi nutro piu di Sogni , che di cibarie-D , e non so se mai saranno realta sti Sogni miei  !	1	
√à delle Citt√† come dei Sogni Tutto l'Immaginabile pu√≤ Essere Sognato ma anche il Sogno pi√π Inatteso √® un Rebus che Nasconde un Desiderio oppure il suo Rovescio , una Paura  .	1	
#Mango,	Mango
#Elefante ,	Elefanti
#Scimmia,	Scimmie
#Aquila,	Aquile
Sbalorditi dalle gesta del valoroso cacciatore , le genti di quella terra lo incoronarono re e lo chiamarono Shqip√´tar che vuol dire figlio dell Aquila e il suo regno divenne conosciuto come Shqip√´ri o Terra delle Aquile  .	1	
Stupenda e veritiera , io aggiungerei Se fossi un rapace , vorrei essere un Aquila x ch√© le Aquile , volano da sole i piccioni volano in gruppi  .	1	
#Mano,	Mani
Bangle Mani di Fatima La Mano di Fatima e Mano di Miriam  .	1	
COMUNE IL SANGUE Catene legano le mani mano destra e mano sinistra le hanno unite insieme le catene Insieme soffrono insieme aspettano insieme tentano Mano destra e mano sinistra nella lotta unite Mani del popolo per questo legate Con lo stesso peso le catene feriscono le due mani Comune il sangue il colore della vita il principio del fuoco il fondamento della lotta	1	
#Bottiglia,	Bottiglie
30- 40 1 Drink 1 Flute TAVOLO Pista 200 1 Bottiglia Prevendita TAVOLO Priv√® 500 2 Bottiglie Prevendita Via Arcangelo Corelli , 62-MI- CENONE h 20  .	8	
30- 40 1 Drink 1 Flute TAVOLO Pista 200 1 Bottiglia Prevendita TAVOLO Priv√® 500 2 Bottiglie Prevendita CAPODANNO A MILANO 2015 Mercoled√¨ 31 Dicembre 2014 Infoline & Prenotazioni Gianluca 349 7508557	1	
30- 40 1 Drink 1 Flute TAVOLO Pista 200 1 Bottiglia Prevendita TAVOLO Priv√® 500 2 Bottiglie Prevendita TOCQUEVILLE 13 Via Alessio Di Tocqueville , 13-MI- CENONE h 21  .	1	
VIP TICKET 80 ingresso area vip , accesso privilegiato con cassa riservata , servizio guardaroba , 2 drink inclusi nel prezzo TAVOLO NEL PRIVE 400 5 Ticket Prive 1 Bottiglia a scelta 800 10 Ticket Prive 2 Bottiglie a scelta Info / Prevendite / Tavoli 338  .	1	
#Donna,	Donne
8 marzo festa della Donna Auguri a tutte le Donne , oggi e sempre	1	
; Questa dell'AIRC e una Meravigliosa idee , perche donando questo Splendido Fiore alla Donna piu Importante della nostra Vita 3 , AIUTIAMO CONCRETAMENTE tutte le Donne e a noi stesse  !	1	
@Pontifexit Sarebbe come dire Quando sperimentiamo l'Amore amoroso di una Donna , siamo capaci di condividerlo con le altre Donne  .	1	
@kappaesseph Ciao s'amiga era per la Festa della Donna , per tutte le preziose Donne del mondo  .	1	
Acquista ENMAYDA Donne Tacchi Alti Lace up Piattaforma Scarpe Donna Taglia 34  .	1	
Alberto Giacometti Donne di Venezia 1956 Su richiesta di Alessandro propongo sei delle numerose versioni di Donna di Venezia che Giacometti realizz√≤ nel 1956  .	1	
Anche noi abbiamo aderito al progetto Ravenna Citt√† Amica delle Donne , e abbiamo colto le occasioni del nostro compleanno e della Festa della Donna per affiggere presso la nostra sede la targa con il fiore in mosaico , assieme alle rappresentanti di Linea Rosa  .	1	
Associazione MondoDonna Onlus Donne in nero- Bologna UDI Bologna Casa delle donne per non subire violenza ONLUS ANPI Provinciale Bologna Donne SEL Emilia-Romagna SOS Donna	1	
Auguri Buona Festa Della Donna a tutte le Donne del mondo  !	1	
Auguri a tutte le Donne , Giornata Internazionale della Donna ,	1	
Auguri a tutte le Donne Ma soprattutto , auguri alla Donna del mio cuore  !	1	
Auguri a tutte quelle Donne che ti fan sentire fiera di essere Donna  .	1	
Certo , in una civilt√† maschilista come quella italiana comprese le Donne colonizzate da questo tipo di maschio se le buone idee provengano da una Donna √® questione sempre mal digerita e- alla bisogna- s'insulta pure la protagonista  .	1	
Come Canta Il Grande Pippo Baudo Viva Le Donne Che Sono Le Colonne Dell'Amore , Donna Come Mamma , Moglie , Compagna , Sorella , Amica  .	1	
Come Canta Il Grande Pippo Baudo Viva Le Donne Che Sono Le Colonne Dell'Amore , La Donna E Portatrice Generatrice Di VITA TivoglioBeneAssaie UnAbbraccioBacio BuonaNotte	1	
Comincia oggi l'edizione numero 37 del Festival di Cinema e Donne diretto da Paola Paoli e creatura del Laboratorio Immagine Donna  .	1	
Con Donna Moderna e Costa Crociere puoi partecipare al concorso Donne a bordo e vincere una giornata a bordo di una nave da crociera  !	1	
Con Donna Moderna e Costa Crociere puoi partecipare al concorso Donne a bordo e vincere una giornata su una nave da crociera  !	1	
Condividi questa foto e mostrala in cassa CLOSING PARTY- MYSTIQUE & SETAI CLUB presentano HAWAIIAN ISLAND INGRESSO OMAGGIO alle prime 100 Donne Uomo 15 , Donna 10 con drink Info reservation 3395360463- 3482257953	1	
Da quasi 60 anni la mimosa √® il simbolo dell 8 marzo , la Festa della Donna , o meglio , della Giornata Internazionale delle Donne  .	1	
Da- Osservatorio Nazionale sulla salute della Donna , vi presentiamo il libro Donne e Tumori  .	1	
Dal sito dell'Udi- Unione Donne in italia Ciao Rosetta Donna bagnata di marea/ muove l oceano profondo/ a  .	1	
Divano 6 pass riservato con due spumanti o un distillato 120 Programma della Serata ore 19 , 00- Buffet Strip Show Disco 10 Solo Donne 1 Drink ore 20 , 30- Cena Strip Show Disco 25 Solo Donne ore 22 , 30- Ingresso 15 Uomo 10 Donna 1 Drink Prevendita 10 Donna 2 Drink entrando entro le 22 30 Tavolo Gratuito Tavoli d'appoggio per Donne al Buffet fino alle 23  .	1	
Donna Auguro a tutte le Donne , di essere , come Mary Poppins  .	1	
Donna Francisca a Uomini e Donne WittyTV- Part 487559	1	
Donna Moderna √® in edicola con una splendida sorpresa le Donne Vere con cui √® stato realizzato il servizio di moda questa settimana sono Laura , Frida , Ilaria e Orsetta , le protagoniste de Il Saloon Di Adele , che ci svelano anche qualche curiosit√† sui personaggi che interpretano	1	
Donne avvisate mezze palpate Donna avvisata  .	1	
Donne che corrono coi lupi Clarissa Pinkola Est√©s I territori spirituali della Donna Selvaggia , nel corso della storia , sono stati spogliati e bruciati , i cicli naturali costretti a diventare innaturali per compiacere gli altri  .	1	
Donne che corrono coi lupi Clarissa Pinkola Est√©s La Donna Selvaggia , intesa come forza psichica potente , istintuale e creatrice , lupa ferina e al contempo materna , ma soffocata da paure , insicurezze e stereotipi √® la straordinaria intuizione che ha fondato una psicanalisi del femminile  .	1	
Donne che per la Festa della Donna scioperano allo scopo di sensibilizzare contro i soprusi cui la donna √®  .	1	
Donne curvy , Io Donna d√† qualche consiglio per essere belle e alla moda anche con qualche chiletto in pi√π  .	1	
Donne curvy sentirti bene in un corpo con le curve- Donna Moderna	1	
Donne d'onore Ares , Croce Rossa Taodue , Made in Italy Taodue , Donna del mare Picomedia  .	1	
Donne e Resistenza per la Festa della Donna rt radiolaquila 1 rt Promo Abruzzo	1	
Donne fateli valere ma la dignit√† di Donna dove sta siete solo burattini nelle sue mani lui vuole solo divertirsi ha fatto bene Gemma che gli ha dato il ben servito	1	
Donne imparate a le vostri maschi che quando incontranno una Donna rispettela e una cosa molto importante	1	
Donne piccole come stelle che qualcuno vuol solo belle Donna che non sente pi√π dolore quando il freddo arriva al cu	1	
Durante il Festival di Teej , la Festa della Donna in India , le Donne sposate e non , vestono di abiti del colore tradizionale  .	1	
E Buona Festa Della Donna A Tutte Le Donne  .	1	
E con Ella , avete oscurato e sottomessa pure , la Coscienza fatta Carne nell'Anima Eva , la Donna , o la Madre di tutte le Donne , la Madre Donna allo stato creaturale come un armento nella stalla di Abram  .	1	
Franca Viola Storia di una Donna che ha Segnato la Storia delle Donne	1	
Giovanna Donna , simbolo della FORZA delle Donne nella Cristianit√† , della loro forza e resistenza  .	1	
Gli uomini pi√π Tradiscono e pi√π le Donne li Amano Poverette ma li Amano per non Dare soddisfazione a L altra Donna ma non Saranno Mai Felici perch√© un Uomo che Tradisce non Amaaaaaaaaa Povere Illuse	1	
Grande Donna non solo Bella ma'che'cuore dovresti insegnare ha tante Donne complimenti Massimiliano	1	
Grazie Donna , e Buon Anno a tutte le Donne del mondo  .	1	
Grazie per il tuo pensiero , grazie davvero da una delle tante Donne , mi permetto di commentare con un aforisma di una Gran Donna Se Dio avesse voluto che ragionassimo con l'utero , perch√© ci ha dato il cervello  ?	1	
I Unione Donne Italiane che adott√≤ come Giornata della Donna l 8 Marzo in America , New York , tra il 1908 ed il 1909 Migliaia di Operaie scesero in Sciopero ad Oltranza Rivendicando l Aumento del Salario nel 1909 il Partito Socialista Americano Dedic√≤ alla Giornata della Donna il 28 Febbraio in sintesi in molte Nazioni s Istitu√¨ la Giornata della Donna , ma con Date Diverse , che poi Furono Unificate in una Data Comune l 8 Marzo Medea gi√≤	1	
Il Sorriso resta sempre l'accessorio pi√π bello che una Donna pu√≤ indossare Auguri a tutte le Donne  !	1	
Il rispetto , l'educazione e la sincerit√† sono la fonte per dire Grazie alla Donna che ti dona la vita con mille sacrifici , Purtroppo troppe Donne danno la loro vita per rendere felici le persone che amano senza ricevere nemmeno un grazie  .	1	
Inaugurato dalle Donne in Cantiere Spazio Donna Dada Viruz Project	1	
#Melone,	Meloni
#Nuvola ,	Nuvole
#Leone,	Leoni
In viaggio con Carlo Leoni alla scoperta di tutti i segreti della Casa del Leone  !	1	
Leoni o Sierra Dell Leone  .	1	
Nella Fossa dei Leoni la Classifica settimanale simil-seria delle ingiustizie- Avvocato Leone	1	
Sketch , Leone dello Scalone d'onore della Reggia di Caserta i Leoni , oltre ad una funzione ottica , simboleggiano la forza delle armi e della ragione che assicurano al re , il possesso dei regni suoi	1	
Stern , Benedetta Tagliabue , Alan Yentob , ha assegnato due Leoni d Oro , un Leone d Argento e quattro menzioni special	1	
io vivo come un Leone , corro come un Leone e cago come un Leone , ma io mi sento pi√π da Leoni	1	
la c'√® un Leone della Folgore anzi due Leoni della Folgore  .	1	
mi prendo anche il merito di aver detto all'assessore di far fare un giro veloce della citt√† ai due Monopoly Boys , infatti belle le riprese al Duomo , alle Chiese di Sant'Anna e San Domenico , il Palazzo comunale con la Fontana dei Due Leoni e infine il preziosissimo Mosaico del Leone del I sec  .	1	
#Topo,	Topi
L'uomo ha Inventato la Bomba Atomica , Ma Nessun Topo Al Mondo Costruirebbe Una Trappola per Topi  !	1	
#Maiale,	Maiali
#Asino,	Asini
Ogni anno gli stessi broblemi , bisogna essere completamente Asini per fare sempre gli stessi errori , altro Asino Marchionne , parla troppo e agisce poco ,	1	
#Macchina ,	Macchine
#Strada,	Strade
Verr√† assegnato domani a Milano , nell'ambito della fiera Eicma , il primo Premio Nazionale Sicurezza Stradale Basta Sangue sulle Strade , ideato e promosso dall'Associazione Familiari e Vittime della Strada Onlus  .	1	
#Ratto,	Ratti
#Cipolla,	Cipolle
#Serpente,	Serpenti
STATI UNITI D'AMERICA- Florida- Questo Serpente , pur rassomigliando al Serpente Corallo forse uno dei Serpenti pi√π velenosi della Terra , manca delle strisce circolari Gialle attorno sl corpo , comunque √® un Serpente da tenere in considerazione , se si √® morsi , andare subito in Ospedale , anche perch√© con il Serpente Corallo , √® molto difficile che si arrivi  .	1	
#Macchina ,	Macchine
#Palazzo,	Palazzi
Palazzo Belimbau √® uno dei 42 Palazzi dei Rolli dichiarati Patrimonio dell'Umanit√† Unesco nel 2006  .	2	
Eleganti Palazzi di via Roma tra cui spicca il Palazzo de La Rinascente	1	
Il Palazzo Ducale di Modena , uno dei pi√π importanti Palazzi Principeschi del seicento √® stato sede della Corte Estense tra Seicento ed Ottocento  .	1	
Nuovo appuntamento con Ville e Palazzi napoletani alle Gallerie di Palazzo Zevallos Stigliano Notizie in un Click	1	
Palazzi Storici e gemme di architettura nella cinta muraria il Palazzo Cocchi Serristori e la fontana zampillante di Santa Croce  .	1	
Palazzi indimenticabili , per chi visita Torino Palazzo Falletti di Barolo	1	
Palazzi monumentali di Napoli Palazzo Doria D'Angri , progettato da Luigi e Carlo Vanvitelli 1760-1778  .	1	
Palazzi nobili pugliesi a Monopoli Palazzo Palmieri	1	
Palazzo Negrone illuminato ieri sera in occasione dei Palazzi in luce	1	
Palazzo Nicolosio Lomellino illuminato ieri sera in occasione dei Palazzi in luce	1	
Parte laterale di Palazzo San Giorgio , uno dei Palazzi dei Rolli patrimonio dell'UNESCO	1	
Perch√® il Signore che sta aggiustando quel microfono √® il responsabile della sicurezza della Camera dei Deputati , non solo di Palazzo Montecitorio ma anche degli altri Palazzi della Camera ed √® paragonabile ad un alto ufficiale del'arma dei Carabinieri  .	1	
Una catastrofe sociale che ovviamente non sfiora i signori dei Palazzi , da quelli dei Comuni e Regioni a quelli di Montecitorio , Palazzo Madama , Palazzo Chigi e Quirinale  .	1	
Venerd√¨ 21 agosto , alle 21 , 30 , a Palazzo Concini , prosegue la rassegna Palazzi , Ville e Giardini con un evento  .	1	
pochi minuti anche su Palazzi Chigi , Quirinale , Montecitorio specialmente e una visitina su Palazzo Madama  .	1	
vittoria dedicata a Pistocchi che ha contribuito a far squalificare Krasic , a Palazzi che non ha voglia di indagare sull'Inter e a tutto il Palazzo  .	1	
#Uomo ,	Uomini
#Ananas,	Ananas
#Gatto,	Gatti
Si Reca In Un Negozio Per Comprare Cibo Per Gatti E Ne Esce Con 27 Libbre Di Gatto  !	1	
#Uccello ,	Uccelli
#Mucca,	Mucche
#Capra,	Capre
#Cavallo,	Cavalli
Cari amici , ancora un piccolo sforzo per aiutare gli asinelli a vincere una donazione in mangime messo a disposizione da Morando Alimenti per Cavalli in collaborazione con Cavallo Magazine APRITE questo link- e mettete MI PIACE i like sotto il nostro post non sono considerati validi ricordatevi di metterlo dopo aver aperto il link  .	1	
Cari amici , grazie al vostro aiuto siamo gi√† riusciti a vincere 1 QUINTALE DI CIBO per gli asinelli messo in palio da Morando Alimenti per Cavalli iniziativa in collaborazione con Cavallo Magazine ci aiutate a vincerne un altro  ?	1	
Cominciamo con l'iniziativa di Morando Alimenti per Cavalli in collaborazione con Cavallo Magazine quando questa foto- raggiunger√† i 1000 like , doneranno 1 quintale di cibo agli asinelli  .	1	
Ho di gi√† espresso il mio commento , in negativo , sulla Fiera Cavalli , in risposta in Cavallo Magazini in Fb  .	1	
Prender√† il via luned√¨ 22 giugno la campagna sociale di Morando Alimenti per Cavalli in collaborazione con Cavallo Magazine a favore de Il Rifugio degli Asinelli ONLUS durante la settimana vi chiederemo di mettere mi piace a tre immagini e , al raggiungimento di 1000 like per post , Morando doner√† al nostro Rifugio un totale di 3 quintali di mangime Morando Cavalli Mantenimento  .	1	
#Bambino,	Bambini
, ma sarebbe utile anche fare qualcosa di concreto se si ha tempo , volontariato , se si pu√≤ , donare qualcosa ; a Genova ABOE Liguria Onlus Associazione Bambino Emopatico Oncologico aiuta i Bambini del reparto oncologico del Gaslini  .	1	
Baby firma- Bambini in lingua dei segni Unisciti alla rivoluzione momento Bambino firma  !	1	
Bambini e ragazzi che insieme ai ricercatori dell'Ospedale Bambino Ges√π , scoprono il fantastico mondo delle cellule  .	1	
FC Juventus Felpa Cappuccio Cotone Bambino GF J 004 Zero Acquista EUR 19 , 97 Visita Bestseller in Bambini e  .	1	
Fiammisday Come Vestire i Bambini , Blog Moda Bambino	1	
I Bambini sono pi√π avanti di quanto vorremmo e forse qualche Bambino avr√† avuto delle curiosit√† e si risponde spesso alle loro domande cosi Cose da Grandi e W Le Maestre  .	1	
Palazzo Averoldi ospita stasera Risonanze , il progetto promosso dall'associazione Mondo Bambino per l attivazione della risonanza magnetica all'Ospedale dei Bambini di Brescia  .	1	
Paraspigoli Bambini 5 Metri E 8 Angolari Per Sicurezza Di Bambino Paraspigoli In Gomma Strisci @SoloOfferte	1	
Progetto Bambini Unitalsi Alessandra Amoroso con i piccoli pazienti del Bambino Ges√π @vitecoraggiose	1	
Tutto il Mondo Sportivo Applaude Il Gesto Sportivo Del Grande Campione Brasiliano Rendere Felice Un Bambino Ma Altri Milioni Di Bambini Attendono Con Ansia Il Gesto Dei loro Campioni Quindi Non Fatevi Pregare Per comunicare il Calcio Ai Pi√π Piccoli Perch√© Loro Saranno I Campioni Del Futuro Grazie Neymar  .	1	
ma a me non sono mai piaciuti i Negromanti , ma mi piacciono i Bambini e non permetterei mai a costui di avvicinasi a un Bambino  .	1	
√à un Bambino Meraviglioso Speciale Unico come tutti i Bambini  .	1	
#Computer,	Computer
#Dollaro,	Dollari 
che poi dispone di diversi miliardi Dollari nelle sue banche da convertire in altra moneta facendo crollare la valutazione del Dollaro USA  .	1	
#Banana,	Banane
Quand'√® il momento che ci illuminiamo , a Banana Republik il cielo si colora di giallo e iniziano a piovere Banane  .	1	
#Dito,	Dita
#Cane,	Cani
Cani Chiusi Nei Giardini A Vita E Maltrattamento Il Mio Cane Bau	2	
Donna Musulmana Sfida Le Leggi Del Corano Per Occuparsi Dei Cani Randagi Impuri Il Mio Cane Bau	2	
24 Settembre SEMINARIO gratuito sulla gestione e l'addestramento del Cane ; 25 Settembre EXPO SULCITANA- Gara Cinofila Amatoriale per Cani Meticci , Cani di Razza e  .	1	
Cane ti piacciono I Cani  ?	1	
Cani chiusi nei giardini a vita √® maltrattamento Il Mio Cane Bau	1	
Cani sacrificati al Dio Cane  .	1	
I prodotti del momento in e JINCHAO Cane Cintura Di Sicurezza Auto per Cani Animale Domestico D  .	1	
Un Cane cantante che canta gratis , meglio di certi cantanti che cantano da Cani facendosi pagare  .	1	
Vista la gravosit√† della gestione degli affidi di oltre 2700 cani , le due associazioni si appoggeranno all OIPA oltre che al Comitato Montichiari contro Green Hill , Coordinamento Fermare Green Hill , Enpa , Leidaa , Lega Nazionale per la Difesa del Cane , Occupy Green Hill , e Vita da Cani  .	1	
ssa Brambilla contro il Festival di Yulin in Cina , No alla carne di Cane , NO Dog Meat , Stop Festival Yulin , I Cani si devono amare non mangiare ,	1	
#Pera,	Pere
