#Onesto,	Disonesto
Onesto √® colui che cambia il proprio pensiero per accordarlo alla verit√† Disonesto √® colui che cambia la verit√† per accordarla al proprio pensiero Anonimo	1	
#Convincente,	Inconvincente
#Conosciuto,	Sconosciuto
Da queste due macchiette , uno il Bomba l'altro lo Sconosciuto dagli italiani ma Conosciuto dall'ISIS  ?	1	
#Impressionante,	Insignificante
#Possibilmente,	Impossibile
#Deciso,	Indeciso
#Consistente,	Inconsistente
#Etico,	Immorale
#Informato,	Dsinformato
#Comodo,	Scomodo
#Possibile,	Impossibile
Che cosa , che prima ritenevi Impossibile , si √® poi rivelato Possibile  ?	1	
La Signorina propone una Sardegna Possibile , ma vuole rendere Tutto Impossibile  .	1	
#Logico,	Illogico
#Efficiente,	Inefficiente
#Produttivo,	Improduttivo
#Conveniente,	Sconveniente 
#Reponsabile,	Irresponsabile
#Piacevole,	Spiacevole
#Gradevole ,	Sgradevole
#Fortuito,	Sfortunato
#Informativo,	Disinformativo
#Razionale,	Irrazionale
#Accettabile,	Inaccettabile
#Consapevole,	Inconsapevole
#Ragionevole,	Irragionevole
#Sicuro,	Insicuro 
#Certo,	Incerto 
#Probabile,	Improbabile 
#Largo,	Pi®¥ largo 
#Caldo,	Pi®¥ caldo 
#Male,	Peggio
#Lungo,	Pi®¥ lungo 
#Bene,	Meglio
-D Comunque , ha giocato molto Bene la sua unica partita ; e gli auguro il Meglio a questa Donna  !	1	
/ Bene √® sapere e non dire/ Meglio √® sapere e dire/ se si trova quell'orecchio raro/ che pu√≤ comprendere  .	1	
3 Pali In Due Partite Facciamo Progressi Ahahahhhahahahaah Comunque x Me a Giocato Bene , Forse Anche Meglio D'nsigne	1	
; Si , poteva andargli Meglio , ma comunque gli e andata Bene , dai  !	1	
Bene , ci sar√† puzza di bugie , ipocrisia e falsit√† su tutta Milano Meglio rinchiudersi in casa	1	
Bene Alessandra , oggi possiamo risponderti a gran voce Meglio froci che La storia rende sempre giustizia ai suoi eroi  .	1	
Cn Il Bologna Ha Giocato Bene Ma Si √® Mangiato trpp Goal e Puo fare Sicuramente Meglio	1	
Da questo Semplice Gesto si capisce ancora Meglio quanto ti fai volere Bene , e quanti ti vogliono Bene  !	1	
Fidarsi √® Bene , non Fidarsi √® Meglio  .	1	
Fidarsi √® Bene Non Fidarsi √® Meglio	1	
Grazie Inter , √® Stato Difficile Per Me Lasciare Il Mio Paese , Ma Penso Di Aver Giocato Bene Le Mie Partite e Voglio Fare Ancora Meglio Nella Prossima Stagione  .	1	
La Partita poteva andare Meglio , ma comunque e'andata Bene  !	1	
Ma Cosa si Deve Pensare , le Immagini Parlano Da Sole , io Grazie A Dio Per Star Meglio Non Ho Avuto Mai Di Questo Genere Di Roba Per Star Bene , Basta Affrontare La Vita Nel Bene E Nel Male , Non Si Sfugge Facendo Uso Di Droga , O Alcol , si Va Avanti E Basta Con Ste Ciancerie E Scuse	1	
Meglio una rediviva Unione Sovietica a un redimorto Impero Democratico del Bene a stelle e strisce  .	1	
Mi fa vederti e sapere che ti va tutto bene , Meriti di star Bene , Tantissima Felicit√† e ti auguro solo il Meglio Dalla Vita  !	1	
Non c'√® Nulla di Meglio , se Fatte Bene  !	1	
Una Cosa Fatta Bene Pu√≤ Essere Fatta Meglio  .	1	
Vabbuo , auguro il Meglio anche a questa Simpatica coppia che oltre a giocare Bene , si sono pure divertiti , e noi con loro  !	1	
#Grande,	Il pi®¥ grande 
#Gustoso,	Il pi®¥ gustoso 
#Vecchio,	Il pi®¥ vecchio 
#Lento,	Il pi®¥ lento 
