#Sacramento,	Californie
#Portland,	Oregon
#Glendale,	Californie
#Jacksonville,	Florida
#Shreveport,	Louisiane
#Lexington,	Kentucky
#Tulsa,	Oklahoma
#Glendale,	Arizona
#Tucson,	Arizona
#Mesa,	Arizona
#Spokane,	Washington
#Memphis,	Tennessee
#Oxnard,	Californie
#Tacoma,	Washington
#Lubbock,	Texas
#Worcester,	Massachusetts
#Miami,	Florida
#Cleveland,	Ohio
#Scottsdale,	Arizona
#Louisville,	Kentucky
#Stockton,	Californie
#Detroit,	Michigan
#Phoenix,	Arizona
#Philadelphie,	Pennsylvania
#Huntsville,	Alabama
#Cincinnati,	Ohio
#Honolulu,	Hawaï
#Nashville,	Tennessee
#Oakland,	Californie
#Houston,	Texas
#Fremont,	Californie
#Orlando,	Floride
#Arlington,	Texas
#Omaha,	Nebraska
#Laredo,	Texas
#Chicago,	Chicago
#Baltimore,	Baltimore
#Anchorage,	Anchorage
#Plano,	Texas
#Modesto,	Californie
#Garland,	Texas
#frères,	soeurs
2 grandes soeurs , 4 petite soeurs et 2 petit frères  .	1	
Oui mais tu parles du nombre de petits frères ou de petites soeurs  ?	1	
Toi tu veux que je te fasse 6 petits frères et 4 petites soeurs  ?	1	
avec les soeurs et les bo frères on étaient dans un mariage hier soir	1	
#sa(son),	sa(son)
#homme,	femme
Ben déjà un femme i veille plus vite qu'un homme et i devient menopose bonheure	2	
Je mets un commentaire dans mon mur en hommage a Johnny à une personne que j'ai pu croiser et connaître un tout petit peu je tiens à dire toutes mes condoléances à sa femme et à ses enfants il y a sur toute sa famille un homme qui dégage est une puissance remarquable sur scène un homme qui n'avait peur de rien qu'elle ne prenez un micro qu'elle a fait une belle carrière mais surtout que tu as des enfants qui t'aime mon ami Johnny repose en paix en l'au-delà veille sur tes proches	2	
Je publie cette photo pour vous remonter de quoi je suis capable grâce à Dieu je n'ai jamais frappé aucune femme mais je serai peut-être capable plus qu'on ne connaît crois j'aime la tête de mort ce n'est pas pour rien que je suis contre la cruauté envers les animaux comme un être humain pour moi un homme qui frappe une femme il mérite la chaise électrique ou alors qu'on lui coupe la tête rien d'autre	2	
La dernière fois tu m'as même dis ke tu avais étais reçu par un homme à l'accueil et une femme pour tn rdv dans son bureau  .	2	
Ah mais c'est sur et certain il va voire c'est facile de sens prendre sur une femme ou des goss mais un homme c'est pas la même	1	
Alors si shui ton homme et que tu es ma femme , attrape bien le main k je tai donner peu importe  .	1	
Aucun homme ne va rendre une tell service pour une femme	1	
Ba il le faux une doudoune deux paire de air Max et deu ensenble Nike une pour homme et une pour femme	1	
Babar aurais une place pour toi mais faut trouve un autre homme et une autre femme	1	
Bah mon ami je suis une femme mariée à un homme	1	
Bah mon ami je suis une femme mariée à un homme possessif donc tu comprends  .	1	
Bah nan tqt je suis pas une femme je suis un homme	1	
Bah oui c'est normal je suis ta femme et toi tu es mon homme	1	
Ben mtn tous les hommes cours derrière les gros dada maus tu be véra aucun homme avoit un gros dada comme femme ou compagne	1	
Bonjour pour samedi il me faudrait un point desiel bleu pour homme et un classique de Jean paul gautier pour femme svp	1	
C est l homme qui doit comprendre la femme puis la femme doit obeir a l homme  .	1	
C'est clair que quand une femme fait les éloges d'un homme elle est un peu interessée	1	
C'était un homme somalien qui etait a l'engelettere et sa femme était en Somalie	1	
Chute femme c moi qui t'aime plus c tou écoute ton homme pour une fois	1	
De tous fassons tu me dit jamais je t'aime alors que d'autre femme je dise leurs homme que l'aime tu ses vraiment pas dire je t'aime il y a pas que écrit il faut aussi dire de vie voix sans ses vrais que ses un problème à toi tu voulait pas partager avec moi de regarder un film porno je les achetait pour nous deux non que moi  .	1	
De tous fassons tu me dit jamais je t'aime alors que d'autre femme je dise leurs homme que l'aime tu ses vraiment pas dire je t'aime il y a pas que écrit il faut aussi dire de vie voix sans ses vrait problème à toi tu voulait pas partager avec moi de regarder un film porno je les achetait pour nous deux non que moi	1	
Des femmes comme toi ne courent pas les rues , vous êtes rares comme un diamant , ton homme n'aura pas simplement une femme , il aura la PERFECTION  .	1	
Dieu a fait pour l homme un trône ; Pour la femme un autel  .	1	
Désolé je peux en parler avec une femme mais pas un homme	1	
En Afrique c femme ki di bjr a sn homme  .	1	
Hummm alors si un homme n'a pas de moyen pourrait il accepté de marier avec une femme	1	
Il ma di une femme qui respect pa son homme ses oa une femme	1	
Il permet pas au te parler , un like dans les réseaux sociaux d'une femme ou d'un autre homme c'est le scandale	1	
Il y'aura jamais un homme qui va accepter que sa femme aille dinner avec un autre mec	1	
Il ya guida , christophe , emilie , le père de kevin et sa femme , sa cousine avec son homme , sa grand mere , ma mere , une de mes cousine , 3 couple d'amis et les enfants ont on attend d'autres réponse	1	
J'ai un homme qui sait parler a sa femme	1	
Je cherche un appart mais je crois que mon homme est pire qu'une femme dans un magasin de chaussures mdr	1	
Je fait pas de câlin à un homme c'est tout xD une femme ok crevette bien sûr Maman crevette soyons fou mais papa crevette je lui tend la main xD	1	
Je lui est dis à ton abis de quoi un homme à besoin venanr dune femme à 2h du mat	1	
Je t fai des reproches pour ke tu tameliores sur certains points cest pa coe ca kon gere une relation tu es la femme tu dois amener tn homme ver toi et le seduire	1	
Jvais jouer la petite femme parfaite qui prend soin de son homme	1	
L homme est le cerveau , La femme le coeur  .	1	
La beauté d'une femme ce trouve dans l'oeil de son homme	1	
La femme doit être a la propriété d'un seul homme	1	
Le classique pour femme et le point desiel bleue pour homme	1	
Les femme on besoin d'un homme comme un homme a besoin d'une femme	1	
Ma poulette Tu es trop belle sur cette photo Mmm je t'aime ma femme Je suis un homme chanceux parce que j'ai une belle femme	1	
Mais comme toi , tu es dans la catégorie des femme qui ont troooooop le malin , se sachant belle , un homme comme moi , je regarde juste de loin , comment les autres s'agitent	1	
Merci énormément mon coeur pour tout ce que tu a fait grace au toi je suis un homme puis je compte faire de toi ma femme en t'epousant mon amours je t'aime plus que tout j'ai hate de te faire la demande en mariage avec les cle de l'Audi	1	
Met si vraiment je suis ra femme et toi mon homme il faut quon arrete de s engeuler bb	1	
Mon coeur un homme ne réagi pas comme une femme	1	
Najem je suis un homme mariée je doit voir avec ma femme d'abord	1	
Ne dit pas sa allah a créer une femme qui et destiné pour un homme quand allah décidera de te la donner elle viendra a toi et ce mariage fera la moitié de ton dîne ne sois pas triste	1	
Non xD ses pas un homme mais bien une femme , et elle fait goku quasiment depuis le debut dragon ball meme a l'âge de 80ans elle continu elle est entrer dans le livre des record	1	
Ok merci il me faudrais une paye en 40 pour homme et en 36 pour femme	1	
#mari,	femme
ce n'est pas pour ça que la femme était malheureuse ou soumise puisque à cette époque la femme avait de la valeur pour son mari et dans la société , et elle était même considérée comme le principal pilier de la maison  .	2	
C une femme qui a pris un 2em mari	1	
Et la femme va tout faire pour protège son mari	1	
Expliquez su dd est l'appelation d'un patron fasse a sa collaboratrice , tu vas expliquer a sa femme pourquoi tu appelles son mari dd	1	
Hum la femme qui fuit le domicile conjugal le mari depuis des jours	1	
Je te le dis ma fille j'ai quitté la maison a la suite d'un coup de fil que j'avais reçu de Lina , la voisine qui gardait Anne so qui me demandait de dire a ma femme de laisser son mari tranquille  .	1	
Je te souhaite pour cette nouvelle année ma petite shara santé beaucoup de bonne chose et bénédictions sur le regard de pour toi et ta petite famille ton doudou et ton fils et que tu restes la femme formidable que tu es pour ton mari et la maman formidable que tu es pour kiloulou	1	
Ma femme quand elle a reçu la nationalité européen et tout grace a son mari	1	
Mettez ensemble l'argent de mon père et ma cousine et la femme au boulot de edmonde et son mari pour voir le montant	1	
Moi aussi mon coeur d'amour je t'aime énormément de tout mon coeur et ton mari de ton coeur sera toujours là pour prendre soin de sa femme de sa vie pour la vie j'usqu'a ma mort je t'aime je t'aime je je t'aime je t'aime je t'aime je t'aime je t'aime je t'aime je t'aime je t'aime je t'aime énormément de tout mon coeur pour la vie ma bibiche d'amour de mon coeur	1	
Moi j'adore ma femme Et toi tu aime ton mari	1	
Oui sa résumé bien la mentalité et le pense de cher nous hhhh rester o café toute la journée ou lieu de partie travailler aller o café regarder le foot o lieu de passer du tzmp en famille ou aller a la mosqué et nous femme au foyer dépense plus de energie dans le travail que nos propre mari biento nous allons aussi devenir la chefs de famille ou va le monde	1	
Oui voila ecoute ton maman changer de coeur tu vivre bien tu dire pas femme de lit mes dire que j'ai autre mari que je vivre avec  .	1	
Peut etre pr ta femme sa sera pg mais pas pr mon mari	1	
Prk mon petit coeur d'amour j'imagine par ce que ton mari n'était pas a côté de toi ma femme d'amour	1	
Que Dieu ne te donne vraiment tout le bonheur d'être femme , dans le travail , avec ton mari , avec	1	
Si tu es une femme qui a un merveilleux mari , qui travaille fort et qui ferait n'importe quoi pour toi , met cette phrase sur ton statut aujourd'hui , car ces hommes sont rares , et j'ai l'immense chance d'en avoir un  .	1	
Tu a vue ce que j'ai encore fait hier mon amour une vrai femme doit respecter son mari et moi je le fais pas	1	
Tu as vu c'est le mari qui a tué sa femme la joggeuse qui avait été retrouvé morte	1	
pour elle , la relation dans le mariage c'est PLUTOT j'insiste encore sur la nuance la femme qui suit le mari dans la majorité des décisions ou c'est 50-50  ?	1	
#marié,	mariée
#frère,	soeur
J'ai 1 grande soeur , un grand frère et un frère jumeau  .	5	
Dit moi ou ta bite ma soeur Stp Jtm et le bauf frère il va bien  ?	3	
Mon frère jtm trop tes mon soeur quand jai besoin de toi tes tjr la pour moi et moi pour toi tkt pas	3	
Mon frère jtm trop tes mon soeur quand jai besoin de toi tes tjr la pour moi et moi pour toi tkt pas jtm mon frere	3	
On suit aussi l'histoire de la soeur de Mike et du frère de Will  .	3	
J'ai 1 grande soeur , un grand frère ,	2	
Je promet sur ma vie , sur la tête de mon chat , ma soeur , mon tel , ma ds , mon frère et ma mère	2	
Mon frère jtm trop tes mon soeur quand jai besoin de toi tes tjr la pour moi et moi pour toi tôt pas	2	
Un frère de 28 ans et une soeur de 26 ans	2	
1 grande 2 demi soeur et 1 demi frère et toi	1	
1 non je te repousse 2 personnes je préfère être seule au lieu de souffrir 3 je n'en ai pas 4 idem 5 déjà tu m'envoie pas balader LOL 6 6 / 10 7 non pas du tout 8 personnes n'est plus beau que tel ou tel la beauté du coeur ou physique cela reste la même 9 si on parle d'amour non j'ai trop de souffrance interne pour aimer désoler 10 bha nan t'habite pas la porte à côté 11 ton humour 12 deux demi frère et 1 demi soeur 13	1	
1 soeur 8ans et 1 frère 14 ans	1	
3 frère et 1 ou 2 soeur	1	
Ah bah heureusement que tu connais pzs mon ptit frère et ma ptite soeur c'est pire la sa vas ils sont entrain de dormir	1	
Après c'est as vous de voire mais moi sa me soûl que vous soyais comme sa vraiment rien ne doit se mettre entre vous vraiment moi perso j'ai perdu la soeur a cause d'un con mon frère c'est pas trop sa et srx sa me ronge as mort je veut pas que vous fassiez la même surtout pour des bêtises des malentendu vraiment fin apres c'est as vous de voire mais je pense que la vie et trop courte pour perdre du temps pour des choses comme sa	1	
Après j'ai une petite soeur et un petit frère	1	
Au loto après chez ma soeur après recherche mon frère a la gare	1	
Avec ma soeur au travail de mon beau frère y'a une soirée	1	
Bah c l'ex a mon frère mais mtn c aussi sa soeur de coeur donc je me la coltine	1	
Bah c l'ex a mon frère mais mtn c aussi sa soeur de coeur donc je me la coltine encor	1	
Bah c l'ex a mon frère mais mtn c aussi sa soeur de coeur donc je me la coltine encore cte tripaner	1	
Bah ta soeur je vosi qui cets et ton frère aussi	1	
Bas on chch un aranger pour enmener mon demi frère à ruitz a la sta car personne peut l'amener et ma belle soeur à besoin de sa voiture demain et lui	1	
Beh tae si c'est ta soeur je suis le frère de mon Jungkook	1	
Bh jsp , franchement petite soeur prck j'ai deja 2 frère mdr	1	
Bh oe ct mon frère mais jsp ya quoi ya changer , ya 2j y m'diszis ma soeur ajd sa m'traite je c meme pas pk mais brff c'que ct pas vrm un pote	1	
Bomjours je syis kay soeur de @fandewass je me demande pk tu à bloquer mon frère et son pote @wassfreestylefan	1	
Bon peux taitre pas me sauter de su mais me le faire quand memr nn mon frère oar de lilo et stithe a ma soeur mais bon quoi	1	
C'est la soeur qui t'a dis montre moi qui c'est ton grand frère  ?	1	
C'est mon ex bo frère qui à été juger pour ce qu'il fesait à ma soeur été il est passer dans le journal	1	
C'est mon grand frère de coeur Clems Bènè Chiaro Lola je suis sa petite soeur quoi mais tou tu es mon vrai frère de sang	1	
Ca c moi avec ma soeur et mon petit frère	1	
Celui qui a tué sa famille c'est-à-dire son frère farlan et sa soeur isabelle	1	
Ces ton frère qui conte plus que ta soeur	1	
Cet après-midi je ss allée me balader avec ma ptite soeur , mon grand frère et sa copine	1	
Cet après-midi on va voir le frère a papy en ehpad et la soeur a papy chez elle mais je vais pas conduire la flemme	1	
Chez le demi frère et la belle soeur	1	
Devant la tele et ordi chez ma grande soeur de coeur et mon grand frère de coeur	1	
Dit au ma soeur kel m'envoie un message pour je la rappel de la part de son frère 0788808205 je ne sais plus si elle a encore mn tel	1	
Elle dit qu'elle ne sait pas où vivent sa soeur jumelle et son frère  .	1	
Et félicitations avec Étienne je veux tout ton bonheur petite soeur et je veux que mon beau frère soit attentionné avec toi	1	
Et moi j'ai un demi frère et une demi soeur	1	
Et oui , grey tu es mon beau frère mtn je prendrais soin de ta soeur	1	
Fabrice , son frère , sa mère , sa soeur , des amies a elle  .	1	
Il a Mycroft en frère mais pas de soeur	1	
Il a une ptte soeur Lily-Rose et un ptt frère Kylian	1	
Il est chez ma soeur pour que mon frère voille pour le farre	1	
J'ai deux demi frère et une demi soeur en plus	1	
J'avoue , mais te plein pas mon frère s'appelle François-Michael stp et moi Aimerine heureusement ya ma soeur qui s'appelle Alicia , de base c'était Marie-Eugénie	1	
J'avoue , mais te plein pas mon frère s'appelle François-Michael stp et moi Aimerine heureusement ya ma soeur qui s'appelle Alicia , de base c'était Marie-Eugénie mais ils se sont dit que c'était une grosse connerie	1	
#roi,	reine
Félicitations aux roi et a la reine	2	
Je suis reine et tu seras mon roi	1	
Lilo et Stitch mon best one , le roi lion , Cendrillon , la reine des neiges	1	
Lilo et Stitch mon best one le roi lion Cendrillon la reine des neiges Les 101 dalmatiens	1	
#fils,	fille
Perso 6 gentils- @harukofairytail fille de Naruto- @sansfr fils de Goku- @citric  .	10	
Perso 6 gentils- @harukofairytail fille de Naruto- @sansfr arrière 20 petit fils de Goku- @citric  .	3	
Ben mon fils avait été baptisé après ta fille	1	
Cest une fille qui part au Canada et elle tombe amoureuse d'un des fils de ses patron	1	
J'ai mon fils en vacance cette semaine et la semaine prochaine ma fille monte en suisse pour les vacances	1	
Je suis sa mo'otua , la fille de johnny son fils	1	
La fille et le beau fils super  .	1	
Les femmes ont la bouche heinnn Une maman dit à sa belle fille pourquoi aucun de mes petits enfants ne ressemble à mon fils  ?	1	
Mais avoir une fille ça veut dire une fille pour elle au bien pour son fils	1	
Moi ma fille va avoir 37ans et mon fils 32ans	1	
Mon fils 11 ans ma fille bientôt 17 ans	1	
Mon fils a 31 et ma fille 36	1	
Ne prendre aucune considération pour le père de leur petit fils et prendre u temps fou pour leur fille qui nous a mis plus bas que terre et qui au dit que son frère était mort  !	1	
Non je fais pas que du baby-sitter je suis aussi maman dune petite fille de 7ans , je fais des bijoux en fils alu , je ss cuisinière	1	
Ouais hiro mashima pense que la fille de natsu et lucy serait amoureuse du fils de jubia et grey et vice versa	1	
Oui Ils doivent aller sauver Ben le fils de La belle et la bête qui est prisonnier de l'île de l'oublie il a ete capturer par la fille d'Ursula et le fils de Crochet	1	
Oui hein une petite fille , j'ai déjà un magnifique petit fils mtn une petite fille  .	1	
Oui tu m avais dit pour le fils de laurence c est triste de perdre un enfant ma fille au perdu le sien aussi une semaine avant le dece de valerie et une semaine après c etait le fils de mon frère triste année	1	
Perso 6 gentils- @harukofairytail fille de Naruto- @sansfr arrière 20 petit fils de	1	
Perso 6 gentils- @harukofairytail fille de Naruto- @sansfr fils de Goku	1	
Père et fils , mère et fille	1	
Sa mère son frère avec ses fille , un ami de son frère les 2 fils de sa soeurs et un ami de sa mère  .	1	
Suis dégoûter elle etait ci heureuse car elle voulais un fils elle a eu sa fille du coup quand jlui ai proposer elle a fait des bon mais elle n'a jamais rien acheter suis pas pour les achats elle la prix un week sur presque 7 mois de vie et elle ne demande pas de nouvelle elle commente de tms en tmp	1	
Un jr elle avait gagner dans ses demarches 1 millions moi son fils j'ai même pas eu 100 mill , ni sa fille l'argent là est fini à tel point qu'elle n'a rien foutu avec , c'est le mec avec qui elle est qui sait ce qui s'est passé et là ou cet argent est parti  .	1	
g complètement zappé ma fille , comme mon fils et moi on est né le mm jour mais elle c le 17 / 01 / 2018 et j'aimerais kel est gateau aussi  .	1	
ma fille oui sa va on peut la laisser mais c mon fils qui et le plus difficile	1	
Ça fait toujours du bien pour les enfants de se retrouver entre mère et fille ou encore père et fils	1	
#père,	mère
Parce que la je viens de me trinbalé un carton de 7kl de miel Donc pour toi père c'était 2 pot je crois et pour ta mère 1kl	9	
Son père était photographe de presse et sa mère journaliste  .	5	
Soit la princesse de ton père La fierté de tes soeurs La relève de ta mère	4	
Nn dsl parce que tu c quand je te dis qu'il y avait mon grand père il est venu pour nous dire que ma grand mère a eu un accident a l'usine elle a fait tomber une pièce sur sa main du coup elle est a l'hôpital mais il ya a que ma mère et mon beau perr	3	
Ok oui sa dois la faire ok je demande à mon père se midi et à ma mère à 14h d'accord parce que ma mère travail et mon père nn d'ac	3	
Quand j'avais 3ans mes parents se sons séparer 2mois avant leur mariage Mon père avais quitté ma mère pour ça meilleure amieAprès ma mere a rencontré quelqu'un de très gentil et j'adorais Mon père jaloux raconte des chose fausse sur ma mère a cette personne du il la quitte	3	
Ah ok bin sa sera pour une prochaine fois , et ma mère qui voulais t'inviter à l'annif de mon père même si tu aurais fait rudy t'amener car je l'aurais invité aussi mais bon c'est mort car Mr joue	2	
Au faite pour ma copine , il faudra venir la chercher chez elle car son père travail et sa mère est en attelle elle peut pas conduire et elle habite a champigni	2	
Dem ma mère va coiffer le père de mme bonamy	2	
Et après y'a mais parents qui sont en break depuis 1 semaine je le sais alors que sa fait plus longtemps que sa et dès qu'ils se voyent ils se disputent et mon père souffre parce qu'il l'aime vraiment on se confient mais ma mère lui parle comme un chien et ne montre aucun signe	2	
J'ai dormis un peu et ma mère as commencé a geuler contre mon père et ma réveillé et maintenant elle boude dans son coin	2	
Ma femme je tenais aussi a te dire que malgré les difficultés que j'ai avk me parents il ne faut pas il s'inquiéter , je leur est parler , on a discuter , on a même mis a s'embrouiller mais ne tkt pas mon père commence a comprendre et ma mère c'est un peu plus dure mais tkt pas pour moi  !	2	
Ma mère m'a dit de partir du coup je suis chez mon père	2	
Non je pense pas parce que en plus mon père est déja parti a saint dié , après il reste ma mère mais il faudrais quelle est une monté de gentillesse et avant que mon père partent au boulot je regrette de pas t'avoir embrasser plus	2	
Parce que la je viens de me trinbalé un carton de 12kl de miel Donc pour ton père c'était 2 pot je crois et pour ta mère 1 tu me confirme au fete je tenverai une nouvelle liste d animer que je te conseil et en livre  .	2	
Quand j'avais 3ans mes parents se sons séparer 2mois avant leur mariage Mon père avais quitté ma mère pour ça meilleure amieAprès	2	
Sa va etre chaud son père le récupéré le 1 janvier donc meme si il dors chez ma mère faut que je retourne a saint medard après	2	
j'ai envoyer ma mère bouler et mon père aussi  .	2	
normalement c bon ma mère elle m'a dit oui et mon père il me donne ka reponse demain	2	
33677603907 le num de ma mère pr le nouvelle an et celui de mon père c	1	
A pont de clans je demanderais a mon père et a st sau c clement sierraMais lundi on peux aller voir ca mère a clement parce que elle travail au lycée voir si il	1	
A sedan et la pas avec ma mère mais avec mon père	1	
Ah bon Ptdrrrr parce que mon père était passe ya deux ou trois jours et ta mère lui disait que xetait son dernier jour lol	1	
Ah jore lucie dors chez toi la et demain tu la ramène , nn ma soeur sera partie amener ma mère pour que mon père puisse rester au travail	1	
Ah mais depuis que je suis en internat avec ma mère sa se passe mieux et mon père sv	1	
Ah si mon père s'en fout et ma mère serais d'accord	1	
Alor ma mère en parle a mon père demain et elle me donne la réponse	1	
Alors il a raconté des chosess fausse sur ma mère a mon ex beau père du coup ma mère a perdu ben acose de mon père	1	
Alors ma mère est nounou et mon père au credit agricole , et toi  ?	1	
Au début la mère de Léa ne voulait pas la rendre au son père et il ont même eu besoin du juge pour régler leur histoire	1	
Avec ma mère a bouhans les Lure et avec mon père a Melisey	1	
Avec ma mère c'est de pire en pire même quand je suis chez mon père et sa bah je le supporte pus  .	1	
Avec son père et sa belle mère le 25	1	
B dit a ton père qu'il appel ma mère 0615701096	1	
Ba Voila j'ai 14 ans ce mois si ça va faire 9 ans que ma mère est morte , ma belle-mère c'est mariée avec mon père est c'est une vrai connasse , mes beaux frangins sont chiants ma famille meurt un par un au collège c'est la merde j'ai pas d'amis , ma moyenne a chuté	1	
Ba si elle ma connu tout petit elle elle connais ma mère mon frère et mon père décédé  .	1	
Ba tu sais elle a perdu sa mère pi maintenant vu que je m'entend super bien avec ma belle mère et qu'elle m'achete des trucs ba son père essaye de la séduire pi elle elle va lui faire des calins pi elle me critique	1	
Bah elle ma dit que sa mère à dit oui mais elle a pas encore demandé à son père	1	
Bah j'vais déménager encore une fois parce que ma mère et mon beau père se re-separe encore une fois  .	1	
Bah ma mère elle dit on verra avec tout père donc j'attends qu'il reviens et je te dis	1	
Bah ma mère sen fou elle a dit c'est comme ton père préfère	1	
Bah ma mère ta déjà eu un exemple , bah mon beau père pareil et pour ce qui est de Mélissa la connaissant elle va vouloir me piquer mon téléphone pour te parler	1	
Bah ma mère veut du soleil et mon père change pas d'entreprise , il ne veut plus faire ce qu'il fait et ça lui met moins de limite si il cherche dans tt la france et pas seulement en Picardie	1	
Bah mon père casse les couilles et benjamin hier il et venue chez ma mère il a fait un trou dans mon mur il a casser notre aquarium pour les tortue il nous a insulter il tient avec mon père il a voulu me tabasser heureusement que mon copain étais la et mon père dis a ma soeur qui et enceinte quelle peux crever avec sont bébé	1	
Bah mon père et chez sa copine et ma mère est chez elle	1	
Bah mon père quand il avait 26ans ma mère avait 18 an	1	
Bah mon père regardais le journal et ma mère lui a demandé se qu'il voulait manger et on la dérangé comme d'hab	1	
Bah si Guillaume le père de Lucien ou une mère de l'orchestre sinon il y a Fergal en voix 1 des personnes que je connais de vu mais en voix 2 je suis solo de fou , ,	1	
Bas je sais moi aussi mon père il viens chez ma mère  .	1	
Bb ma mère se fous de a gueule de ma père car quand il ma dit tu connais pas le tel je lui est enviuer un sricjers bb	1	
#prince,	princesse
Libre de croire en ces mensonges sur la vie , libre de croire au prince charmant , libre de croire qu'elle deviendra une princesse  .	4	
Bah oui normal il y a que les prince qui mérite une princesse	1	
J'espère que vous profiter bien gros bisous tonton et tatie et a mon petit prince et ma petite princesse La famille mousseux	1	
J'peux pas pas ma princesse , j'ai pas de prince	1	
Ma fille aujourd'hui tu as 11 ans tu as grandit a une vitesse grand v tu as apporter daqn ma vie pleins de bonheur javasi le coeur brisé pars certain événement tu ma refait revivre après trois prince tes trois frères tu née le 17decembre 2006 ma princesse et tu était celle de ton papa qui ne te verra plus grandir maiq	1	
Un princesse a un carosse les chevaux et un chauffeur et le prince tu la deja	1	
Va dormir princesse et dis la même chose à ton prince charmant sinon je débarque et ça va chauffer pour v	1	
bref tu représente ma viiie et je te promet d'être ton prince car tu si magnifique que tu es la princesse de mon	1	
#garçon,	fille
Le garçon s'appelle Nicolas et la fille Mathilde  .	6	
Mais ce que le garçon ne savait pas , c'est que la fille lui a posé ces questions pour qu'elle puisse l'entendre lui dire une dernière fois  .	4	
Att moi jsuis la fille et toi le mec ok parceque toi t'es 4 / 5 garçon manqué et moi 3 / 4 garson manquer	1	
Bah ouais moi aussi sauf que la y'avait cinq autres classe avec nous psq il pleuvait et en fille dans notre classe y'a Norah Chloé et Marine qui l'ont fait et en garçon Nicolas Bastien Filip Antoine Matteo Julien	1	
Ben ses normal que tes kiffer qu'elle garçon ne kiffe pas voir le decoler d'une fille à part si il est guay	1	
C qui t 5 meilleur amie fille et t 5 meilleur ami garçon	1	
C qui t 5 meilleur amie fille et t 5 meilleur amie garçon  ?	1	
Cest une fille cest pas un garçon	1	
Coucou on a fais la deuxième écho est cest une fille cest pas un garçon	1	
Enfin il y a de fille souple que de garçon	1	
Es cest une fille es pas un garçon	1	
Ha bah je sais pas moi , elle fait comme elle veut , je pense qu'elle est bi puisqu'elle m'a dit aimer les garçon mais que j'étais la première fille qu'elle aimait	1	
Haha merci beaucoup , j'ai déjà une fille et je viens d'adopter un garçon , il est adorable , je l'aime tellement	1	
Il a 5 fille et pas de garçon donc ya pas de 5eme garçon	1	
Il vas s appeler thomas si c est un garçon ou si c est une fille ça sera cheyenne	1	
Ils m'on abandonné , mais j'ai une fille de 3 ans et un garçon de 2 ans , mais pas d'amis ça veut bien dire que tout le monde me deteste  ?	1	
J'etait exclu dans ma famille pcq j'etait la seul fille donc j'ai appris a devenir un garçon mais un vrais comme mes cousins et vers mes 11 ans ma mère ma appris a devenir une fille	1	
Je pense qu'il n'y a pas beaucoup d'hommes fan de série Je suis une fille donc , et toi un garçon vu ton nom	1	
Je suis une fille mais je vais me transformer en garçon	1	
Je t'aime Mais genre je veux on fais une fille on l'apelle cindy et un garçon on l'appelle James On achète un maison on se marie	1	
Je vois pas de ou ces incenser on a bien tous les mm objectif dans la vie et un garçon et diferent d une fille d après se que j ai compris c est tou	1	
La fille c Ilona Perrin et le garçon chep je vais regarder et je te le dis	1	
Le garçon et torse nu et la fille et pas nu mdr	1	
Magali , si sais une fille bien elle sais juste toi qui est un garçon pas bien mais bon on appelle pas sa une ex lorsque on la trompe et que l'histoire a durée que quelque jour	1	
Mais en faite je te l'ai jamais dit mais je suis née garçon et ma mère ne voulais pas d'un garçon donc je me suis fait opéré pour devenir une fille	1	
Mais si je m'habille en garçon devant mon père je suis morte tu me revois plus même si en fille je suis pas du tout a l'aise je suus obliger d'en mettre	1	
Mes projets chuis un bebe , après une fille , après une femme , après je travaille , je rencontre LA personne , chuis amoureuse , jme marie , jtombe enceinte , jaccouche dune fille , je retombe enceinte 2 ans plus tard et jaccouche d'un garçon voilaa	1	
Moi c'est Roland garçon très sympa a la recherche d'une fille aussi sympa que vous l'être pour plus d'échange	1	
Moi chuis belle en fille et peut etre t pote garçon il te trouve beau	1	
Moi j'ai met un j'aime pour le fille part faut car Jai lu le commentaire j'ai pansé que ce le même mec as commenter j'ai pas regardé si un garçon le même ou bien une fille la moi j'ai fait une faute inconsciemment mais toi tu as supprimer la discussion consciemment et avec tas vo	1	
Moi si j'etais un garçon mais je suis une fille	1	
Non , c'est un autre garçon qui était avec la fille xD	1	
Non mais les familles sont toujours avant tou , si un père voit que sa fille s'embrasse , ou juste sourit au qlq , le pauvre garçon va mourir	1	
Normalement le plus grand amour d une fille ses son papa et d un garçon sa maman	1	
Oui j'ai deux enfants 1 fille 18ans et 1 garçon de 11 ans  .	1	
Pove chou et moi c'est un garçon je voulais mais j'ai eu un fille	1	
Pove chou et moi c'est un garçon je voulais mais j'ai eu un fille mais bon pas grave quand le moment sera venu je vais essayer de faire le garçon si dieu veut	1	
Prénom alexiaAnimal abeille Prénom de garçon ariol Prénom de fille astride Couleur acajouQuelque chose que tu porte Boisson a  .	1	
Sa sert a quoi de la apeler Club des fille alors qui a des garçon	1	
Si iris en fille ou emma tj préféré quoi et un garçon c toi qui choisi	1	
Un autre garçon comme toi t'appele des fille	1	
le garçon oui mais la fille non du coup	1	
#neveu,	nièce
Et aussi cado pour ma nièce et mon filleule et mon neveu aussi  !	1	
#il,	elle
Imagine elle va dans une famille ou il y'a un chien et il lui mange ce serait triste  .	7	
Du coup par peur elle a tenu son bras et criée pour qu'une tatie vienne là encore il a été puni  .	6	
Laissez la tranquille si elle veux pas vous dire avec qui elle est en couple il y a peux être une raison quand il voudront vous le dire il vous le dira donc maintenant laisser la tranquille avec sa et je veux vous dire aussi au début moi et mon gars on est reste cache et maintenant on la avoue a certainne personne et il en a qui le savent toujours pas et on veux reste cache	6	
Je lui est demander si il restais encore une place mais elle ne me répond pas	5	
Mdrrr jpp jiraud il est vnu dans ma chambre et il ma dit pk bertille elle me fait la gueulle mdr et jlui ai dit a cause de la banane et il a dit c'etais pas lui et jlui ai dit va lui parler il ma dit j'ai envoyer des message elle repond pas et jlui	5	
Bas en foit jai une de mes meilleures amies elle traine plus avec certainne personne et en fait il a ma meilleure amie et mes auyre pote on en a parle eh ma meilleure amie je lui est dit que je suis de aucun cote et elle a commence a m'énerve bref en gros elle ma fait une crise de jalousie car jaitais pas de sont cote et je lui est pas dit mais je suis plus du cote de mes autre pote car j'avoue de se que ma meilleure amie ma dit cest pas une excuse	4	
Car il voulait un bonbon et je voulais pas lui en donne donc il a tire sur ma couhette et il avait ma tablette dessus et donc ma tablette elle a voldinge parterre et sa la debouate	4	
Cette fille avaist eu trop peur de cette homme , alors elle s'était éloigné de lui , il l'a encore plus approcher  .	4	
Maman je c pa si les petits frères dorment donc je t'envoie un message pour te dire ke je n'aime plus Nael et pour te dire que je suis en couple avec Ethan mai ke il a dis qq chose qui n'a pas plu a jenny et donc elle essaye de faire la routine pourir ma vie	4	
Bas en fait jai une de mes meilleures amies elle traine plus avec certainne personne et en fait il a ma meilleure amie et mes autre pote on en a parle et ma meilleure amie je lui est dit que je suis de aucun cote et elle a commence a m'énerve bref en gros elle ma fait une crise de jalousie car jaitais pas de sont cote et je lui est pas dit mais je suis plus du cote de mes autre pote car javous de se que ma meilleure amie ma dit cest pas une escuse	3	
C'était son père , il lui demandait où était elle à cette heure ci  .	3	
Elle est née il y a pas longtemps et elle est née à quel heure  ?	3	
Je lui ai montrer celle ci je lui ai dit elle ai sympa celle la il m'as dit ah ouai j'aime bien  .	3	
Je te jure ma mif elle part en couille tt le monde s'embrouille mon frère il est parti chez les flic moi je suis tt seul chez moi je stress	3	
Merci et bonne et heureuse année 2018 pleins de bonheur ici ça va maman et avec bourge chez ma nièce elle revient le 7 pour se faire opérer du deuxième oeil et après elle part avec Paris jusqu'en fin mai , papa ça va il et en maison de retraite a st saulge	3	
Mrc mais je veux pas foutre le bordel dans votre couple avec brice parce que vous allez trop bien ensemble et Oceane me la dit il ya 1mois mais il faut pas la croire Oceane ta son elle ma menti	3	
Nn dsl parce que tu c quand je te dis qu'il y avait mon grand père il est venu pour nous dire que ma grand mère a eu un accident a l'usine elle a fait tomber une pièce sur sa main du coup elle est a l'hôpital mais il ya a que ma mère et mon beau perr	3	
Ok mais t'inquiète c'est bon mon bus ne passe pas on a regarder sur internet sa dit qu il passe pas donc vue que ma mere travail elle peut pas m'emmener donc voilà bisous	3	
Oui je pense que c'est difficile pour toi mais il te reste les bons moments que tu as passé avec elle  !	3	
A la fin de la journée il cest poser 5 minute et son epaule elle	2	
Alala la garce à dit à mon ex que si il fais un enfant avec moi elle le quitte	2	
Allo stéphane il ya une fille qui travaille au cegep qui connais ta blonde elle sappele shana le	2	
Attends je demande à ma mère avant que je te le dise parce que si ma mère elle dit non elle m'a engueulé bisous je t'aime je te dirai après mais il faut que je demande à mes parents ok bisous bisous bisous	2	
Au faite pour ma copine , il faudra venir la chercher chez elle car son père travail et sa mère est en attelle elle peut pas conduire et elle habite a champigni	2	
Bonjour il me reste une minette tigrée a donner elle as bientôt 3 mois	2	
Cc ma belle sa va je te donne ke tel de ma soeur pour le koukeoo car moi je peux pas bouger mais loulou sont malade tu la contate et tu vois avec elle pour lui rapotr il y a pas de soucis j'ai vu avec elle	2	
Cc madame masson veux paw que je vienne demain car il ma dit que si elle savais que je viendrait elle maurrais dit de reste a la maison	2	
Ce n'est pas comme si j'étais addicte il n'est pas ma drogue , elle	2	
Cheppa il y en avait une fini aprzs elle et la la ps 4 redemarre	2	
Conseil même si elle est attachante , il ne faut jamais s'attacher a une diablesse  .	2	
Coucou mon homme de ma vie a moi réveille toi bien gros bisous je t'aime plus que tout au monde mon homme de ma vie a moi on as un peu vu pour le 31 avec momo il y a moyen de le faire chez elle jusqu'a 1h du mat et après de sortir l'idéal faudrais qu'on soit 4 ou 5	2	
Du coup elle lui a dît que il pourrait pas venir le jour de mon anniv car elle me connais pad et tout donc je vais demander a ma mère d'aller l'a bas pendant les vacances	2	
E il m'a dit si personne ne l'a blesse elle comprendra jamais e reviendra tjrs	2	
Et elle me laisse pas sortir ek mes amies si il ya des mecs du genres des mecs de notre age et si elle connais pas vos parents plus pire elle va plus me pas laisser  .	2	
Et toi , lewison a fuguer elle ma parler a moi elle est partie avec sa soeur sa me stresse imagine il lui arrive un truc et ma mere a dit au cpe que j'etait malade parce que elle a cru que le cpe aller pas la croire si elle disait qu'il y avait pas de bus	2	
Frr je t'ai pas dit ya deux gars il se sont fait balancer parce qu'il fumer de weed mais il etait de dos alors la directrice elle au pas les noms elle au que la description  .	2	
J'aimais bien aller chez elle quand j'étais petite elle avait plein d'enfants du coup il y avait plein de jouets Ah merci ça compense le fait que je sais pas emballer	2	
Jai dit a lalie asik noah il ta demander moi je te dirais de lui dire OUI elle ma dit je lui est dit nn car je le voit plus comme un ami	2	
Je sais pas se qii ta dis j'ai pas vu et comme ta supprimer je pzut pas voir et avant que jaille me coucher il as dis je lui est parler hier mais elle as pas répondu	2	
Je vais t'expliquer pourquoi je peux pas venir en fait hier j'étais censé aller voir bannisse mais du coup il a pas pu et j'ai dit à ma mère que j'allais voir aujourd'hui et elle m'a dit si bannisse il peut	2	
La prochaine fois que ya une engueulade je film pour que vous voyez mdrr en vrai jai peur de rien sauf la fois ou mon pere ma balancer contre la porte de mon ancienne chambre et il a donner un coup de pied dedant et elle est tombee sur moi  .	2	
Laisser la tranquille si elle veux pas dire avec qui elle est en couple il a peux etre une raison refarde moi et mon gars a certainne personne on la dit et a dautre personne on veux toujours pas le dire donc arrête de la faire chier a lui demande avec qui elle est en couple et comme en dit les plus belle relation sont toujours les relations caché car au moin il y a moins de rumeurs sinon je te souhaite tous bonheur avec ton copain	2	
Laissez la tranquille si elle veux pas vous dire avec qui elle est en couple il y a peux être une raison quand il voudront vous le dire il vous le dira donc maintenant laisser la tranquille avec sa	2	
Laissez la tranquille si elle veux pas vous dire avec qui elle est en couple il y a peux être une raison quand il voudront vous le dire il vous le dira donc maintenant laisser la tranquille avec sa et je veux vous dire aussi au début moi et mon gars on est reste cache et maintenant on la avoue a certainne personne et il en a qui le savent toujours pas et et on veux reste cache	2	
Laissez la tranquille si elle veux pas vous dire avec qui elle est en couple il y a peux être une raisonquand il voudront	2	
Ma petite toute petite perle elle va me suivre partout jusqu'à la fin si vous en voulez il reste deux mal ma fifille cets	2	
Maman elle ta couvert psk il fait froid	2	
Merci et bonne et heureuse année 2018 pleins de bonheur ici ça va maman et avec bourge chez ma nièce elle revient le 7 pour se faire opérer du deuxième oeil et après elle part avec Paris jusqu'en fin mai , papa ça va il et en maison de retraite avec st saulge	2	
Nn il faut la surveiller si elle fait ded bétises	2	
Nn qd t venu chez moi ta dit en fait imane elle kiffe un gars et il s'app rayane c juste tu t'en rapp plus	2	
#papa,	maman
Et puis après tout j'ai des parents divorcé non , c'est comme une garde alterner , l'école chez maman , le patron chez papa  .	3	
si ma maman vend pétrole et mon papa vend gaz  .	3	
Et sois Nathalie ou papa qui c'est fait passer par elle mais maman a reçu ça hier	2	
Merci a tous et toutes d'avoir pense a moi je vous aime Merci maman je t'aime Merci papa je t'aimerai toute ma vie et que ton am	2	
Non non , a chaque petit problème que l'enfant rencontre , la maman lui dit va voir ton papa  .	2	
Représentation de la famille moderne pour les quartier , maman blédarde enfant métisse et visiblement y a que papa qui travaille car maman est en chaussons	2	
12- je suis calline , joviale mais en meme temps assez timide 13- quand je serais a la maison ma maman va partir le 26 chez son papa a elle parceque sa maman ne veux pas que je vienne avec elle  !	1	
A nike a l'avenue puis a levis et a jennyfer de grandvar et au truc sans glutten de maman et au truc de baby pour papa	1	
Apres je dis sa je dit rien mais tu vois Frank c'était son témoin de mariage et son ami de l'armée et Bah vu qu'il est du côté a maman bah au yeux de papa cette amis a ces yeux il et de la merde c'est un connard et tout ce que tu veux	1	
Ba on penser que maman avait passer les clé a papa	1	
Bah pas je sais pas mais je pense pas que papa voidra il lui avec dis ce midi qu'il aimait e'core maman	1	
Bana toultemp na un problème surtout maman un coup lbn un coup pas bon si ma sorte laba c la faute de bana mm mi t fatigué Mélissa ec son ta enfant i conney rienk crier mi koze pu ec elle aussi ma tête t ftg ec bana aster ma fine aller i trouve tjr un nafaire pou dit ma dit papa mi veut pas prend careme la diamoin lbn li oublige pas moin maman la dit le bon dieu va kok a moin ma pas fait un compte avec elle fait zote nafaire i garde pu moin	1	
Bas je suis pas chez maman je suis hisbergue car jetait censée dormir chez papa mais cette nuit la maison à eu un incendie	1	
Bien sur maman cas le faire même si papa a pas envie	1	
Bisous Quentin je t'aime bisous maman je t'aime bisous papa je t'aime  !	1	
Bonsoir papa aurait tu la gentillesse de me donner la taille de maman stp peut tu me dire genre de gilets bises	1	
C est pour ca que ta maman disait que la voiture de ton papa etait dehors je crois	1	
CC maman m'a dit de t'ecrire que demain Elle peut pas venir avec toi parceque papa vet pas  .	1	
Cc maman a quetlle heure papa nous dépose  ?	1	
Cc maman se soir on mange pas avec papa pk il a une soirée bisous	1	
Cc maman ça va je vais voir avec papa et ce midi on va à la cafet	1	
Cc maman ça va je vais voir avec papa et ce midi on va à la cafétéria bisous	1	
Cc papa , pour Noël tu dois appeler maman parce qu'il y'a un soussi	1	
Cc tatie , maman a pu parler à papa  .	1	
Ce que ta maman na pas fait a ton papa faut pas	1	
Ce que ta maman na pas fait a ton papa faut venir faire sa sur enfants des gens	1	
Ce que ta maman na pas fait a ton papa faut venir faire sa sur enfants des gens les ivoiriens j'en peu plus	1	
Cette année pour te dire a Noël je fais avec personne je part avec maman a Poitiers voir papa car la belle-mère va mal	1	
Chez la maman de l'ex de mon papa	1	
Coucou ma princesse , mon papa vien de m'appeler et m'a di que ce week-end c'est l'anniversaire de ma maman et que je serait chez lui que à partir du	1	
Coucou maman je t'aime tres fort et papa aussi je vous aime  .	1	
Coucou papa tu vas bien si oui fait un bisou a maman si non va vers maman et fait un pet	1	
D'ailleurs il as etait surpris car papa lui a parlé du dc de maman c'était un très bon ami	1	
Dacc au début on sera toute les deux parce que papa , mamue , papi , tata Katherine sin parti apporté les affaires pour maman	1	
Depuis toujours tu notre maman est sur le billet de 2000 , papa sur celui de 5000 , grand mère sur celui de 500	1	
Dit maman mi na la table larmoir un gazinière aussi si elle i veut dit papa vient traper demain	1	
Donc c'est ton cadeau de papa et unpeu de maman	1	
Enfaite maman a dis gentillement à papa si il pouvait atttendre avant de nous présenter Ysaline et elle lui a expliqué  .	1	
Et Nathalie ou papa qui c'est fait passer par elle ils ont envoyer sa a maman hier aussi	1	
Et demande a maman si elle a parlé a papa	1	
Et la papa a bloquer la porte du centre pour pas que maman rentre	1	
Et le pire c'est que maman voulait des explications pour Ysalinr et papa la envoyé balader  .	1	
Et qui a foutu en plus sa merde c'est pour ça qu'on dort chez Stephe maman va rentrer à la maison et va parler avec papa et sa va dégénérer	1	
Et ça c'est maman cochon et ça c'est papa cochon	1	
J'ai une soeur Lola , ma maman Angela et mon papa Jérôme	1	
J'en ai un chez mon papa et un chez ma maman	1	
Je crois quils sont au courant papa ma ajouter et maman je la cherche	1	
Je sais pas encore dire car la maman poil cour et papa poil long surm	1	
Je suis désolé pour toi ta maman n'a pas changé et ton papa il va bien mais toi et laurence vous n avez pas changer non plus ont au quelque année de plus mais ont ne changent pas trop	1	
Je te promets sur la tête de terrain de caramel de ma de ma maman tu es mon papa puisse façon tout le monde à tout le monde aller à Sancerre	1	
#oncle,	tante
C'est pas vraiment mon oncle qui habite à la garenne c'est le copain de ma tante mais pour moi c'est mon oncle	1	
Et puis jai blessé a vie mon oncle pcq il faisait souffrir ma tante donc jai eu une mini vengeance	1	
Je sais pas moi , ta tante , marreine , oncle	1	
Si tu veux ça fais un moi que mon oncle est à l'hôpital pour de grave problèmes de santé et du coup ma tante qui est déjà alcoolique elle est encore plus mal et la elle est dans un coma hitilique  .	1	
#fils,	filles
Elle est avec mes filles et mes beau fils	1	
Et les filles vous voulez couper les cheveux de mes fils ce week-end  ?	1	
J'ai connu ça pendant 15 ans avec le père des filles et ça continue avec mon fils , c'est pitoyable mais c'est comme ça  .	1	
Le père de mes filles et le père de mon fils le pire ou j'ai tenu 12 ans	1	
Que tu es différente des autres filles sont elle a tjrs eu peur pour son fils  .	1	
#policier,	policière
#rare,	rarement
#étonné,	étonnamment
#possible,	possiblement
#libre,	librement
#efficace,	efficacement
#calme,	calmement
#occasionnel,	occasionnellement
#typique,	typiquement
#rare,	rarement
#clair,	obscur
